INSEE_COM,annee,nb_mutations,NbMaisons,NbApparts,PropMaison,PropAppart,PrixMoyen,Prixm2Moyen,SurfaceMoy
01001,2024,4,4,0,0,100,290575,3258,96
01002,2024,2,2,0,0,100,267500,1942,140
01004,2024,133,70,63,47,53,194332,2323,83
01005,2024,47,16,31,66,34,228481,2711,85
01007,2024,24,24,0,0,100,223065,2322,95
01008,2024,10,10,0,0,100,239000,2431,100
01009,2024,10,9,1,10,90,234210,2084,117
01010,2024,10,10,0,0,100,242510,2437,98
01011,2024,1,1,0,0,100,209000,1384,151
01012,2024,2,2,0,0,100,71250,1029,76
01013,2024,3,3,0,0,100,118000,1912,71
01014,2024,17,9,8,47,53,199952,2471,93
01015,2024,5,5,0,0,100,203560,1706,116
01016,2024,3,3,0,0,100,203770,2141,96
01017,2024,13,12,1,8,92,104308,1154,95
01019,2024,1,1,0,0,100,150000,1705,88
01021,2024,9,7,2,22,78,277627,2811,100
01022,2024,21,21,0,0,100,197651,2013,99
01023,2024,1,1,0,0,100,276300,2047,135
01024,2024,28,25,3,11,89,239011,2318,100
01025,2024,31,30,1,3,97,190972,1874,104
01026,2024,10,10,0,0,100,203533,2157,92
01027,2024,17,11,6,35,65,280812,3195,87
01028,2024,7,7,0,0,100,269857,2520,106
01029,2024,11,11,0,0,100,170455,1570,108
01030,2024,10,8,2,20,80,230252,2537,91
01031,2024,31,12,19,61,39,135869,1667,75
01032,2024,23,16,7,30,70,310777,2789,113
01033,2024,206,74,132,64,36,214460,2576,83
01034,2024,93,51,42,45,55,167930,2005,86
01036,2024,23,22,1,4,96,223335,2073,111
01037,2024,3,3,0,0,100,110667,1545,101
01038,2024,8,8,0,0,100,168275,1621,110
01040,2024,2,2,0,0,100,349950,2518,139
01041,2024,10,10,0,0,100,153400,1665,92
01042,2024,3,3,0,0,100,333138,2643,129
01043,2024,52,40,12,23,77,390978,3428,118
01044,2024,7,6,1,14,86,298729,4062,96
01045,2024,1,1,0,0,100,265000,3487,76
01046,2024,4,4,0,0,100,294750,2534,121
01047,2024,10,10,0,0,100,341822,2953,115
01049,2024,26,22,4,15,85,335851,2900,121
01050,2024,6,6,0,0,100,217505,1950,115
01051,2024,3,3,0,0,100,106000,1140,81
01052,2024,1,1,0,0,100,326500,2744,119
01053,2024,521,106,415,80,20,151840,2083,73
01054,2024,16,16,0,0,100,306256,2777,114
01056,2024,5,5,0,0,100,93128,1364,73
01057,2024,6,6,0,0,100,133333,2048,73
01058,2024,14,13,1,7,93,179081,1976,93
01060,2024,10,10,0,0,100,144968,1196,140
01061,2024,6,5,1,17,83,242150,1970,138
01062,2024,9,9,0,0,100,341733,3084,116
01063,2024,4,4,0,0,100,308125,2354,142
01064,2024,15,15,0,0,100,217911,2257,101
01065,2024,13,11,2,15,85,264546,2311,117
01066,2024,1,1,0,0,100,96400,1555,62
01067,2024,1,1,0,0,100,262000,1317,199
01068,2024,6,6,0,0,100,147633,1286,124
01069,2024,10,6,4,40,60,187921,2650,71
01071,2024,48,27,21,44,56,537799,5160,106
01072,2024,24,22,2,8,92,291358,2721,104
01073,2024,16,16,0,0,100,189406,2129,95
01074,2024,27,19,8,30,70,215540,2269,92
01075,2024,10,9,1,10,90,312787,3212,114
01076,2024,2,2,0,0,100,130500,1395,92
01077,2024,4,4,0,0,100,211625,1884,114
01078,2024,13,9,4,31,69,412087,4001,104
01079,2024,7,7,0,0,100,236857,1877,131
01080,2024,5,5,0,0,100,132562,1594,87
01081,2024,5,5,0,0,100,194500,1792,118
01082,2024,7,6,1,14,86,263714,3016,84
01083,2024,7,7,0,0,100,271657,2471,111
01084,2024,10,10,0,0,100,267050,2386,113
01085,2024,4,4,0,0,100,329715,2361,138
01087,2024,5,5,0,0,100,207000,2106,107
01088,2024,6,5,1,17,83,297950,3206,95
01089,2024,23,21,2,9,91,206618,2308,89
01090,2024,4,4,0,0,100,292626,2469,122
01092,2024,23,22,1,4,96,264913,2753,95
01093,2024,49,24,25,51,49,243823,2713,94
01094,2024,9,9,0,0,100,175668,1644,109
01095,2024,5,5,0,0,100,151200,1653,95
01096,2024,5,5,0,0,100,239352,2350,102
01098,2024,13,11,2,15,85,183258,2015,91
01099,2024,12,12,0,0,100,270417,2444,116
01101,2024,1,1,0,0,100,120000,667,180
01102,2024,3,3,0,0,100,225005,2253,102
01103,2024,30,15,15,50,50,521926,4900,110
01104,2024,7,5,2,29,71,171429,2255,76
01105,2024,12,10,2,17,83,337641,3400,105
01106,2024,3,3,0,0,100,121000,1804,67
01107,2024,1,1,0,0,100,147000,1312,112
01108,2024,16,14,2,12,88,135095,1568,96
01109,2024,33,24,9,27,73,410026,4143,99
01110,2024,3,3,0,0,100,192667,1276,154
01111,2024,1,1,0,0,100,220000,1692,130
01112,2024,3,3,0,0,100,185000,2184,85
01113,2024,7,7,0,0,100,275429,2824,100
01114,2024,4,3,1,25,75,345313,3612,98
01115,2024,10,9,1,10,90,224929,1997,112
01116,2024,7,7,0,0,100,178143,1451,126
01117,2024,1,1,0,0,100,129000,1142,113
01118,2024,17,16,1,6,94,322615,3249,104
01123,2024,8,8,0,0,100,302110,2154,136
01124,2024,7,7,0,0,100,203556,1943,101
01125,2024,8,8,0,0,100,203220,1719,118
01127,2024,3,3,0,0,100,173333,1506,119
01128,2024,4,4,0,0,100,175375,1577,111
01129,2024,2,2,0,0,100,221500,1758,121
01130,2024,21,21,0,0,100,216357,2134,113
01133,2024,2,1,1,50,50,192500,1290,152
01134,2024,14,12,2,14,86,215328,2111,103
01135,2024,23,15,8,35,65,518865,4825,107
01136,2024,9,9,0,0,100,281478,2019,152
01138,2024,33,23,10,30,70,167801,1954,86
01139,2024,9,9,0,0,100,169389,1366,127
01140,2024,4,4,0,0,100,357500,3231,100
01141,2024,8,8,0,0,100,286996,2347,126
01142,2024,36,24,12,33,67,269574,2780,101
01143,2024,167,39,128,77,23,615064,5989,100
01145,2024,8,8,0,0,100,293438,2615,113
01146,2024,6,6,0,0,100,188883,1721,118
01147,2024,3,3,0,0,100,199400,1738,120
01148,2024,15,14,1,7,93,200039,2182,95
01149,2024,8,7,1,12,88,281268,2646,101
01150,2024,3,3,0,0,100,186103,1639,112
01151,2024,10,10,0,0,100,253400,1997,132
01152,2024,4,4,0,0,100,341250,2737,120
01153,2024,22,19,3,14,86,657260,5073,129
01156,2024,4,4,0,0,100,389186,3634,109
01157,2024,40,38,2,5,95,337529,2936,116
01158,2024,11,8,3,27,73,344327,3862,92
01159,2024,26,23,3,12,88,184098,2106,94
01160,2024,166,17,149,90,10,357007,4829,75
01162,2024,1,1,0,0,100,150000,1852,81
01163,2024,21,19,2,10,90,189595,1932,98
01165,2024,16,16,0,0,100,316073,3151,109
01166,2024,25,20,5,20,80,323908,3188,107
01167,2024,4,4,0,0,100,348698,2537,171
01169,2024,2,2,0,0,100,336300,3148,108
01170,2024,7,7,0,0,100,205286,1956,113
01171,2024,1,1,0,0,100,235000,2423,97
01173,2024,187,45,142,76,24,342607,4533,75
01174,2024,4,3,1,25,75,292475,4885,112
01175,2024,8,8,0,0,100,264594,2292,114
01177,2024,2,1,1,50,50,67642,1370,48
01179,2024,14,14,0,0,100,220330,2237,102
01180,2024,11,7,4,36,64,715577,6141,117
01181,2024,8,8,0,0,100,263999,2209,122
01183,2024,8,8,0,0,100,224353,2409,92
01184,2024,12,12,0,0,100,170583,2535,97
01185,2024,39,33,6,15,85,151811,1749,93
01187,2024,9,7,2,22,78,151308,1968,84
01188,2024,3,3,0,0,100,179667,1896,96
01189,2024,7,6,1,14,86,260571,2005,142
01190,2024,3,3,0,0,100,243643,1368,198
01191,2024,3,3,0,0,100,144667,1460,134
01192,2024,9,9,0,0,100,204889,2267,91
01193,2024,3,3,0,0,100,262333,2773,95
01194,2024,56,31,25,45,55,252764,2944,86
01195,2024,25,23,2,8,92,236655,2282,104
01196,2024,14,13,1,7,93,186743,1996,94
01197,2024,4,4,0,0,100,214250,2298,94
01199,2024,20,19,1,5,95,159400,1664,95
01200,2024,2,2,0,0,100,191000,1567,128
01202,2024,85,44,41,48,52,197966,2262,90
01203,2024,6,6,0,0,100,222423,2214,107
01204,2024,6,6,0,0,100,201497,1910,111
01206,2024,2,1,1,50,50,170500,1688,84
01207,2024,2,2,0,0,100,155000,2595,60
01209,2024,8,7,1,12,88,313899,3086,117
01210,2024,19,2,17,89,11,138588,2424,47
01211,2024,8,7,1,12,88,223425,2241,97
01212,2024,11,10,1,9,91,141936,1398,106
01213,2024,12,11,1,8,92,226097,2647,85
01214,2024,1,1,0,0,100,855420,2940,291
01215,2024,1,1,0,0,100,443000,2786,159
01216,2024,8,8,0,0,100,199332,2206,91
01219,2024,1,1,0,0,100,191630,1843,104
01224,2024,23,18,5,22,78,243478,2306,108
01225,2024,4,4,0,0,100,438812,3392,126
01227,2024,7,7,0,0,100,203986,2107,95
01228,2024,3,2,1,33,67,212280,3225,75
01229,2024,12,12,0,0,100,210904,1960,112
01230,2024,4,4,0,0,100,237625,1688,147
01231,2024,17,17,0,0,100,236734,2251,106
01232,2024,20,18,2,10,90,225602,2046,111
01233,2024,1,1,0,0,100,217750,1502,145
01234,2024,1,1,0,0,100,318000,1590,200
01235,2024,8,7,1,12,88,208075,1942,101
01236,2024,12,10,2,17,83,168233,1588,108
01237,2024,11,4,7,64,36,148746,1852,78
01238,2024,27,24,3,11,89,340671,3235,107
01239,2024,7,7,0,0,100,240370,1919,116
01240,2024,15,15,0,0,100,185289,2257,93
01241,2024,9,9,0,0,100,285897,2497,119
01242,2024,1,1,0,0,100,135000,1500,90
01243,2024,8,8,0,0,100,298912,3096,100
01244,2024,74,43,31,42,58,272511,2888,93
01245,2024,4,4,0,0,100,128750,1246,112
01246,2024,10,10,0,0,100,180605,1904,94
01247,2024,21,5,16,76,24,92905,2714,40
01248,2024,23,15,8,35,65,299840,3491,88
01249,2024,97,53,44,45,55,302801,3275,90
01250,2024,18,18,0,0,100,313750,2991,108
01252,2024,6,6,0,0,100,273500,2745,101
01254,2024,13,13,0,0,100,333538,2888,113
01255,2024,4,4,0,0,100,182875,2021,102
01258,2024,7,7,0,0,100,265569,2082,125
01259,2024,7,7,0,0,100,219286,2061,108
01260,2024,1,1,0,0,100,295047,2049,144
01261,2024,7,7,0,0,100,392501,3039,129
01262,2024,61,29,32,52,48,229064,2681,84
01263,2024,36,29,7,19,81,280814,2828,99
01264,2024,5,5,0,0,100,271079,2365,122
01265,2024,25,18,7,28,72,197736,2032,95
01266,2024,22,11,11,50,50,171019,2017,88
01267,2024,2,2,0,0,100,149000,984,134
01268,2024,2,1,1,50,50,370000,4028,104
01269,2024,32,9,23,72,28,107500,1234,95
01272,2024,14,13,1,7,93,211139,2118,100
01273,2024,18,18,0,0,100,218897,2102,104
01274,2024,7,7,0,0,100,191286,2466,85
01275,2024,26,21,5,19,81,505727,4093,122
01276,2024,13,13,0,0,100,377071,3321,116
01277,2024,3,3,0,0,100,100667,1450,70
01279,2024,3,3,0,0,100,116833,1304,89
01280,2024,3,2,1,33,67,122927,1957,67
01281,2024,49,16,33,67,33,469042,5232,89
01282,2024,3,3,0,0,100,136667,1621,80
01283,2024,154,59,95,62,38,130659,1564,82
01284,2024,6,6,0,0,100,211736,2463,86
01285,2024,6,5,1,17,83,335758,3662,90
01286,2024,7,7,0,0,100,299211,2629,117
01288,2024,35,14,21,60,40,375230,4132,97
01289,2024,69,40,29,42,58,202402,2253,90
01290,2024,9,7,2,22,78,274889,3117,89
01291,2024,5,5,0,0,100,137800,1590,85
01293,2024,3,3,0,0,100,238340,1981,129
01294,2024,11,11,0,0,100,204909,2126,96
01295,2024,6,6,0,0,100,229625,2006,116
01296,2024,1,1,0,0,100,150000,1596,94
01297,2024,9,9,0,0,100,265649,2391,116
01298,2024,1,1,0,0,100,72000,2880,25
01299,2024,4,3,1,25,75,266250,2409,100
01301,2024,22,21,1,5,95,293210,2471,118
01302,2024,1,1,0,0,100,291060,3308,88
01303,2024,26,23,3,12,88,144281,1740,91
01304,2024,30,23,7,23,77,177910,2016,90
01305,2024,34,22,12,35,65,150266,1700,94
01306,2024,12,7,5,42,58,190898,1940,88
01307,2024,7,2,5,71,29,194143,2272,77
01308,2024,11,9,2,18,82,420471,3991,107
01310,2024,1,1,0,0,100,266000,2046,130
01311,2024,2,2,0,0,100,168500,1735,98
01313,2024,110,52,58,53,47,534564,5391,100
01314,2024,17,17,0,0,100,211676,2198,97
01317,2024,6,6,0,0,100,173833,1734,101
01318,2024,11,11,0,0,100,337300,2854,123
01319,2024,4,4,0,0,100,289510,2816,102
01320,2024,25,23,2,8,92,237283,2211,111
01321,2024,8,7,1,12,88,243162,1979,120
01322,2024,38,35,3,8,92,389938,3275,120
01323,2024,10,10,0,0,100,182542,1912,104
01325,2024,3,3,0,0,100,242333,4762,62
01328,2024,6,5,1,17,83,205261,2574,80
01329,2024,2,2,0,0,100,87500,1203,74
01331,2024,3,3,0,0,100,177333,1646,107
01332,2024,9,9,0,0,100,319830,2582,130
01333,2024,30,20,10,33,67,305600,3538,94
01334,2024,7,7,0,0,100,248997,2073,114
01335,2024,2,2,0,0,100,295000,2466,120
01336,2024,8,7,1,12,88,204615,2017,102
01337,2024,7,7,0,0,100,236102,2123,109
01338,2024,11,11,0,0,100,195409,1875,101
01339,2024,13,13,0,0,100,480808,4097,123
01342,2024,7,6,1,14,86,329614,3163,112
01343,2024,15,15,0,0,100,215655,2354,92
01344,2024,55,41,14,25,75,223329,2196,106
01345,2024,26,23,3,12,88,171806,2144,81
01346,2024,7,7,0,0,100,177743,1900,100
01347,2024,15,14,1,7,93,471934,5015,104
01348,2024,30,24,6,20,80,201233,2022,98
01349,2024,4,4,0,0,100,345375,3306,107
01350,2024,18,16,2,11,89,184542,2088,90
01351,2024,10,9,1,10,90,212006,2035,109
01352,2024,7,7,0,0,100,143434,1261,119
01353,2024,16,16,0,0,100,377944,3239,119
01354,2024,156,44,112,72,28,431538,4702,92
01355,2024,8,8,0,0,100,212677,1982,119
01356,2024,2,2,0,0,100,392600,3092,130
01357,2024,7,6,1,14,86,171829,1724,109
01358,2024,3,3,0,0,100,207333,1973,114
01359,2024,2,2,0,0,100,105000,2066,54
01360,2024,23,15,8,35,65,439926,4413,106
01361,2024,29,25,4,14,86,332583,3093,110
01362,2024,8,7,1,12,88,316739,3433,96
01363,2024,12,11,1,8,92,227583,2348,109
01364,2024,7,7,0,0,100,217371,2068,125
01365,2024,12,12,0,0,100,257599,2150,120
01366,2024,6,5,1,17,83,300450,2799,108
01367,2024,12,12,0,0,100,159479,1852,86
01368,2024,9,9,0,0,100,300079,2227,144
01369,2024,6,4,2,33,67,221333,1780,135
01370,2024,31,3,28,90,10,111876,1651,69
01371,2024,7,6,1,14,86,319100,3232,98
01372,2024,2,2,0,0,100,192500,1927,102
01373,2024,8,6,2,25,75,204329,1799,106
01374,2024,28,28,0,0,100,248136,2205,117
01375,2024,10,10,0,0,100,335390,2018,165
01376,2024,40,15,25,62,38,247627,2872,86
01378,2024,19,18,1,5,95,334458,3421,101
01379,2024,8,7,1,12,88,229844,2581,93
01380,2024,5,5,0,0,100,178626,1870,112
01381,2024,11,11,0,0,100,305776,2902,109
01382,2024,2,2,0,0,100,409000,2690,176
01383,2024,8,8,0,0,100,272125,2289,124
01384,2024,20,12,8,40,60,109479,1337,82
01385,2024,8,5,3,38,62,232560,2258,100
01386,2024,14,12,2,14,86,227821,2163,102
01387,2024,1,1,0,0,100,138500,1505,92
01388,2024,10,10,0,0,100,166650,1778,102
01389,2024,11,8,3,27,73,224318,2516,88
01390,2024,16,16,0,0,100,282720,2932,96
01391,2024,4,4,0,0,100,143498,1848,74
01392,2024,6,6,0,0,100,171817,1689,100
01393,2024,4,4,0,0,100,310000,3336,125
01396,2024,11,9,2,18,82,197625,2092,93
01397,2024,13,10,3,23,77,733022,5080,142
01398,2024,16,12,4,25,75,315844,2727,112
01399,2024,26,17,9,35,65,547367,5081,110
01400,2024,1,1,0,0,100,50000,625,80
01401,2024,27,19,8,30,70,619651,5304,118
01402,2024,6,6,0,0,100,200525,2149,96
01403,2024,14,12,2,14,86,176682,2158,85
01404,2024,2,2,0,0,100,150000,3489,43
01405,2024,12,11,1,8,92,221709,2085,109
01406,2024,1,1,0,0,100,197000,2165,91
01407,2024,11,8,3,27,73,242236,2954,90
01408,2024,7,7,0,0,100,160929,1410,111
01411,2024,2,2,0,0,100,151500,1561,91
01412,2024,6,6,0,0,100,264504,3527,92
01415,2024,3,2,1,33,67,188957,2751,68
01416,2024,16,14,2,12,88,111550,1450,79
01418,2024,7,7,0,0,100,325933,4025,83
01419,2024,64,35,29,45,55,498397,4922,101
01420,2024,22,4,18,82,18,118501,1589,71
01421,2024,10,10,0,0,100,167490,1909,91
01422,2024,13,9,4,31,69,187622,2093,92
01423,2024,6,6,0,0,100,442705,3526,126
01424,2024,13,12,1,8,92,447490,3919,113
01425,2024,1,1,0,0,100,390000,1548,252
01426,2024,22,22,0,0,100,203997,1964,113
01427,2024,63,33,30,48,52,277397,3028,92
01428,2024,3,3,0,0,100,483333,2871,161
01429,2024,5,5,0,0,100,210000,2193,93
01430,2024,4,4,0,0,100,173927,1798,91
01431,2024,20,19,1,5,95,204908,2457,83
01432,2024,1,1,0,0,100,450000,1860,242
01433,2024,4,4,0,0,100,199396,1986,102
01434,2024,1,1,0,0,100,199000,1970,101
01435,2024,20,15,5,25,75,558396,5083,110
01436,2024,2,1,1,50,50,511180,6184,80
01437,2024,1,1,0,0,100,218000,2344,93
01441,2024,1,1,0,0,100,120000,839,143
01443,2024,48,34,14,29,71,236611,2681,91
01444,2024,13,13,0,0,100,232950,1896,117
01445,2024,7,6,1,14,86,140729,1676,84
01446,2024,4,4,0,0,100,353938,2748,130
01447,2024,8,8,0,0,100,176750,1713,103
01448,2024,4,4,0,0,100,326212,2736,114
01449,2024,8,8,0,0,100,335975,3156,108
01450,2024,48,42,6,12,88,261275,2785,99
01451,2024,48,42,6,12,88,250555,2412,104
01452,2024,22,15,7,32,68,155371,1625,95
01453,2024,6,6,0,0,100,139648,1453,90
01454,2024,8,6,2,25,75,272475,2687,101
01457,2024,42,31,11,26,74,212204,2301,105
02001,2024,6,6,0,0,100,92350,950,96
02002,2024,7,7,0,0,100,126421,1382,101
02003,2024,11,11,0,0,100,153089,1481,108
02004,2024,2,2,0,0,100,91000,834,95
02005,2024,4,4,0,0,100,234866,1960,124
02006,2024,1,1,0,0,100,162000,1500,108
02008,2024,3,3,0,0,100,93833,1295,84
02009,2024,2,2,0,0,100,115000,954,120
02010,2024,1,1,0,0,100,170000,1429,119
02011,2024,14,14,0,0,100,206550,1959,104
02012,2024,1,1,0,0,100,172500,701,246
02013,2024,2,2,0,0,100,139325,1462,96
02014,2024,10,10,0,0,100,151040,1558,101
02015,2024,2,2,0,0,100,523460,2336,196
02016,2024,2,2,0,0,100,111325,1102,104
02017,2024,1,1,0,0,100,50000,833,60
02018,2024,28,28,0,0,100,118623,1403,85
02019,2024,2,2,0,0,100,106000,1602,64
02020,2024,6,6,0,0,100,121242,888,130
02022,2024,4,4,0,0,100,88500,1233,70
02025,2024,3,3,0,0,100,148667,1392,109
02027,2024,8,8,0,0,100,151469,1165,135
02028,2024,26,26,0,0,100,135515,1463,93
02029,2024,2,2,0,0,100,121000,1255,103
02030,2024,4,4,0,0,100,140225,1278,111
02031,2024,5,5,0,0,100,60578,691,94
02032,2024,2,2,0,0,100,124500,1254,100
02034,2024,2,2,0,0,100,58950,844,79
02035,2024,4,4,0,0,100,193050,1392,151
02036,2024,1,1,0,0,100,27000,509,53
02037,2024,12,12,0,0,100,144348,1316,113
02039,2024,1,1,0,0,100,144000,766,188
02040,2024,1,1,0,0,100,91000,611,149
02041,2024,8,8,0,0,100,168000,1631,99
02042,2024,3,3,0,0,100,157333,2046,79
02043,2024,1,1,0,0,100,80000,1333,60
02044,2024,1,1,0,0,100,43500,580,75
02046,2024,6,6,0,0,100,137658,1139,125
02047,2024,1,1,0,0,100,61000,343,178
02048,2024,2,2,0,0,100,99500,1152,88
02049,2024,4,4,0,0,100,163875,1744,92
02050,2024,4,4,0,0,100,129500,1528,84
02051,2024,3,3,0,0,100,136667,1758,81
02052,2024,4,4,0,0,100,61975,938,70
02053,2024,5,5,0,0,100,95600,1151,88
02054,2024,5,5,0,0,100,150000,1748,91
02055,2024,1,1,0,0,100,71200,975,73
02056,2024,2,2,0,0,100,126900,1383,96
02057,2024,12,12,0,0,100,66107,836,79
02058,2024,3,3,0,0,100,131417,1240,102
02059,2024,26,26,0,0,100,83898,1031,81
02060,2024,1,1,0,0,100,93500,649,144
02061,2024,2,2,0,0,100,77500,796,94
02062,2024,1,1,0,0,100,86000,1365,63
02063,2024,7,7,0,0,100,87786,1010,88
02064,2024,25,24,1,4,96,144406,1749,86
02065,2024,5,5,0,0,100,110450,1016,118
02067,2024,5,5,0,0,100,121660,1146,112
02069,2024,2,2,0,0,100,94000,974,94
02070,2024,4,4,0,0,100,86480,918,84
02071,2024,4,4,0,0,100,133725,1506,88
02072,2024,3,3,0,0,100,140133,868,160
02073,2024,1,1,0,0,100,240000,1967,122
02074,2024,6,6,0,0,100,142435,1288,113
02075,2024,4,4,0,0,100,160275,3363,163
02076,2024,1,1,0,0,100,278150,2060,135
02078,2024,2,2,0,0,100,120450,1356,94
02079,2024,2,2,0,0,100,125000,840,149
02080,2024,3,3,0,0,100,141167,1206,112
02081,2024,2,2,0,0,100,75000,1077,70
02082,2024,1,1,0,0,100,34000,567,60
02083,2024,10,10,0,0,100,118710,1084,116
02084,2024,1,1,0,0,100,197000,1698,116
02085,2024,7,7,0,0,100,173357,1840,95
02086,2024,13,13,0,0,100,147277,1199,125
02087,2024,1,1,0,0,100,50000,714,70
02088,2024,1,1,0,0,100,183550,1073,171
02089,2024,9,9,0,0,100,144606,1869,82
02090,2024,1,1,0,0,100,152500,1386,110
02091,2024,1,1,0,0,100,140000,1077,130
02093,2024,18,18,0,0,100,139600,1460,101
02094,2024,4,4,0,0,100,168000,1765,108
02095,2024,70,70,0,0,100,69603,777,88
02096,2024,2,2,0,0,100,215012,848,250
02097,2024,2,2,0,0,100,69925,899,71
02098,2024,6,6,0,0,100,192520,1827,103
02099,2024,3,3,0,0,100,145768,1951,75
02100,2024,3,3,0,0,100,158833,1360,122
02101,2024,4,4,0,0,100,100750,1085,98
02102,2024,2,2,0,0,100,198948,1393,144
02103,2024,16,16,0,0,100,107488,1100,102
02104,2024,3,3,0,0,100,152742,2109,72
02105,2024,4,4,0,0,100,158000,906,158
02106,2024,6,6,0,0,100,115733,1557,76
02109,2024,3,3,0,0,100,123333,1370,89
02110,2024,20,19,1,5,95,140466,1395,102
02111,2024,4,4,0,0,100,83250,1114,74
02112,2024,3,3,0,0,100,125633,1131,109
02114,2024,13,12,1,8,92,178454,2107,86
02118,2024,1,1,0,0,100,120000,1429,84
02120,2024,1,1,0,0,100,80000,1333,60
02123,2024,3,3,0,0,100,144500,1377,104
02124,2024,6,6,0,0,100,90957,1348,74
02126,2024,5,5,0,0,100,82200,719,118
02128,2024,30,29,1,3,97,169997,1695,103
02129,2024,1,1,0,0,100,30000,429,70
02130,2024,3,3,0,0,100,190667,903,213
02131,2024,21,20,1,5,95,164484,1813,92
02133,2024,4,4,0,0,100,93375,943,95
02134,2024,9,9,0,0,100,102301,1249,79
02135,2024,12,12,0,0,100,98108,942,105
02138,2024,2,2,0,0,100,178300,2672,68
02139,2024,4,4,0,0,100,133425,1213,111
02140,2024,8,8,0,0,100,117500,1447,82
02141,2024,15,14,1,7,93,76933,863,89
02142,2024,3,3,0,0,100,214967,2205,97
02143,2024,2,2,0,0,100,70000,505,150
02144,2024,2,2,0,0,100,122500,1423,102
02145,2024,3,3,0,0,100,178833,1459,124
02148,2024,2,2,0,0,100,193500,1733,113
02150,2024,1,1,0,0,100,75000,1389,54
02151,2024,2,2,0,0,100,105475,1372,70
02153,2024,7,7,0,0,100,143779,1566,94
02154,2024,2,2,0,0,100,129235,914,114
02156,2024,5,5,0,0,100,121600,1252,102
02157,2024,3,3,0,0,100,130000,1652,79
02158,2024,4,4,0,0,100,149975,1666,96
02159,2024,2,2,0,0,100,52500,635,84
02160,2024,7,7,0,0,100,59616,772,75
02162,2024,1,1,0,0,100,280000,1944,144
02163,2024,16,15,1,6,94,197250,1952,99
02164,2024,3,3,0,0,100,128167,1475,90
02165,2024,12,12,0,0,100,81771,934,92
02166,2024,6,6,0,0,100,168064,2750,71
02167,2024,5,5,0,0,100,196600,1502,140
02168,2024,119,60,59,50,50,141730,1813,80
02169,2024,1,1,0,0,100,75000,670,112
02172,2024,2,2,0,0,100,164700,1532,105
02173,2024,134,118,16,12,88,109183,1408,80
02174,2024,7,7,0,0,100,198800,1680,132
02175,2024,1,1,0,0,100,92700,1288,72
02176,2024,2,2,0,0,100,127500,881,144
02177,2024,4,4,0,0,100,145825,1304,107
02178,2024,1,1,0,0,100,237000,1756,135
02179,2024,4,4,0,0,100,81975,771,108
02180,2024,5,5,0,0,100,155740,1513,99
02181,2024,1,1,0,0,100,104500,1045,100
02182,2024,1,1,0,0,100,71000,676,105
02185,2024,2,2,0,0,100,78500,906,84
02186,2024,16,14,2,12,88,170250,1666,108
02187,2024,15,14,1,7,93,182800,2122,86
02188,2024,1,1,0,0,100,40000,625,64
02189,2024,3,3,0,0,100,158350,1446,111
02190,2024,2,2,0,0,100,162500,1712,104
02191,2024,5,5,0,0,100,101520,1306,79
02192,2024,5,5,0,0,100,103400,1164,100
02193,2024,1,1,0,0,100,116000,558,208
02194,2024,2,2,0,0,100,152225,1882,81
02195,2024,3,3,0,0,100,180500,1817,102
02196,2024,1,1,0,0,100,42000,467,90
02197,2024,5,5,0,0,100,111000,1158,94
02198,2024,6,6,0,0,100,153100,1638,99
02199,2024,6,6,0,0,100,105000,1164,86
02201,2024,5,5,0,0,100,156874,1703,96
02203,2024,14,14,0,0,100,152043,1447,102
02204,2024,2,2,0,0,100,56000,778,75
02205,2024,5,5,0,0,100,88277,1055,90
02208,2024,2,2,0,0,100,172000,1672,103
02209,2024,5,5,0,0,100,128800,2127,64
02210,2024,6,6,0,0,100,128481,1487,86
02211,2024,4,4,0,0,100,162475,1984,83
02212,2024,8,8,0,0,100,86832,1128,74
02213,2024,1,1,0,0,100,95000,1439,66
02214,2024,1,1,0,0,100,195900,1180,166
02215,2024,8,8,0,0,100,169956,1630,117
02216,2024,3,3,0,0,100,141467,1576,90
02217,2024,10,10,0,0,100,139540,1501,95
02218,2024,4,4,0,0,100,107737,923,108
02219,2024,1,0,1,100,0,40000,625,64
02220,2024,4,4,0,0,100,128307,894,137
02221,2024,4,4,0,0,100,167750,1762,100
02222,2024,2,2,0,0,100,103950,846,114
02224,2024,3,3,0,0,100,175183,1744,97
02225,2024,2,2,0,0,100,138000,1309,116
02226,2024,11,10,1,9,91,182000,1662,105
02228,2024,5,5,0,0,100,125250,1309,100
02229,2024,1,1,0,0,100,150000,1339,112
02230,2024,1,1,0,0,100,218000,1371,159
02231,2024,8,8,0,0,100,146802,1336,122
02232,2024,1,1,0,0,100,192000,1920,100
02234,2024,1,1,0,0,100,105000,2386,44
02235,2024,3,3,0,0,100,139400,1278,105
02237,2024,11,11,0,0,100,93173,895,104
02238,2024,16,16,0,0,100,123841,1452,88
02239,2024,8,8,0,0,100,162914,1536,104
02240,2024,1,1,0,0,100,128000,877,146
02242,2024,9,9,0,0,100,132611,1427,96
02243,2024,34,32,2,6,94,132012,1805,78
02245,2024,17,16,1,6,94,153197,1784,87
02246,2024,4,4,0,0,100,153500,1258,138
02248,2024,1,1,0,0,100,70000,680,103
02249,2024,2,2,0,0,100,150750,1002,155
02251,2024,2,2,0,0,100,91214,677,122
02253,2024,4,4,0,0,100,147712,1386,124
02254,2024,5,5,0,0,100,186880,1430,138
02256,2024,2,2,0,0,100,90925,589,146
02257,2024,3,3,0,0,100,197667,1623,121
02258,2024,3,3,0,0,100,166133,1890,86
02259,2024,5,5,0,0,100,151800,1634,90
02260,2024,11,11,0,0,100,89380,1173,78
02261,2024,7,7,0,0,100,102293,1188,98
02262,2024,2,2,0,0,100,169500,1569,108
02263,2024,1,1,0,0,100,78000,578,135
02264,2024,10,10,0,0,100,92500,1123,86
02265,2024,2,2,0,0,100,70000,830,85
02266,2024,1,1,0,0,100,65000,1000,65
02267,2024,3,3,0,0,100,303373,3546,101
02268,2024,5,5,0,0,100,120934,1852,79
02269,2024,1,1,0,0,100,60000,571,105
02270,2024,2,2,0,0,100,39500,522,74
02271,2024,3,3,0,0,100,174733,1811,96
02272,2024,2,2,0,0,100,92210,942,97
02275,2024,2,2,0,0,100,37500,460,86
02276,2024,4,4,0,0,100,162375,1151,136
02277,2024,3,3,0,0,100,133333,1367,94
02279,2024,9,9,0,0,100,354192,2721,110
02280,2024,4,4,0,0,100,253125,1734,153
02281,2024,3,3,0,0,100,170100,1698,101
02282,2024,1,1,0,0,100,165000,1941,85
02283,2024,4,4,0,0,100,85975,859,101
02284,2024,1,1,0,0,100,50000,500,100
02286,2024,4,4,0,0,100,89375,977,90
02287,2024,19,19,0,0,100,157671,1592,100
02288,2024,7,7,0,0,100,124743,1241,99
02289,2024,3,3,0,0,100,124333,1419,88
02290,2024,26,24,2,8,92,187800,1926,103
02291,2024,2,2,0,0,100,84950,883,105
02292,2024,10,10,0,0,100,170300,2218,79
02293,2024,2,2,0,0,100,69200,926,74
02295,2024,6,6,0,0,100,89692,794,112
02296,2024,14,14,0,0,100,125779,1325,99
02297,2024,1,1,0,0,100,50000,877,57
02298,2024,10,10,0,0,100,76646,920,82
02299,2024,7,7,0,0,100,86529,1191,72
02302,2024,3,3,0,0,100,180333,1764,104
02303,2024,8,8,0,0,100,194756,1601,122
02304,2024,21,16,5,24,76,82986,835,105
02305,2024,33,31,2,6,94,103072,1191,87
02306,2024,9,9,0,0,100,110950,1055,106
02307,2024,30,26,4,13,87,171930,1955,91
02308,2024,7,7,0,0,100,130379,1208,112
02309,2024,9,9,0,0,100,123183,1216,104
02310,2024,1,1,0,0,100,95000,1218,78
02311,2024,2,2,0,0,100,134250,1718,78
02312,2024,12,12,0,0,100,173522,1142,135
02313,2024,1,1,0,0,100,140000,959,146
02315,2024,16,16,0,0,100,122738,1306,97
02317,2024,2,2,0,0,100,203200,1646,122
02318,2024,13,13,0,0,100,102408,1276,82
02319,2024,5,5,0,0,100,85000,719,114
02321,2024,4,4,0,0,100,121500,1126,111
02322,2024,3,3,0,0,100,140300,1108,120
02324,2024,1,1,0,0,100,200000,1869,107
02326,2024,7,7,0,0,100,149897,1466,105
02327,2024,6,6,0,0,100,105028,1266,82
02328,2024,3,3,0,0,100,174667,1601,105
02329,2024,6,6,0,0,100,92325,1081,81
02330,2024,4,4,0,0,100,196838,1750,114
02332,2024,5,5,0,0,100,112220,1139,97
02333,2024,2,2,0,0,100,89850,1149,82
02334,2024,29,29,0,0,100,91682,1051,89
02336,2024,11,11,0,0,100,162164,1728,95
02337,2024,1,1,0,0,100,50000,500,100
02338,2024,3,3,0,0,100,146133,947,161
02339,2024,7,7,0,0,100,147307,1430,101
02340,2024,52,48,4,8,92,113220,1342,84
02341,2024,2,2,0,0,100,112500,1042,120
02342,2024,1,1,0,0,100,200000,862,232
02343,2024,1,1,0,0,100,455000,1928,236
02346,2024,7,7,0,0,100,121004,1341,92
02347,2024,3,3,0,0,100,163667,1276,139
02349,2024,2,2,0,0,100,211500,1298,184
02350,2024,1,1,0,0,100,186400,1664,112
02351,2024,2,2,0,0,100,103000,1334,78
02352,2024,7,7,0,0,100,84429,935,88
02353,2024,1,1,0,0,100,107700,1171,92
02354,2024,1,1,0,0,100,170000,1030,165
02355,2024,3,3,0,0,100,100000,1234,81
02356,2024,2,2,0,0,100,71500,713,104
02358,2024,4,4,0,0,100,91375,784,102
02359,2024,14,11,3,21,79,132564,1580,82
02360,2024,31,31,0,0,100,164246,1781,94
02361,2024,42,39,3,7,93,72649,853,85
02363,2024,3,3,0,0,100,137833,1772,79
02366,2024,6,6,0,0,100,91750,1072,103
02367,2024,2,2,0,0,100,101750,1405,72
02368,2024,3,3,0,0,100,371000,3147,117
02369,2024,2,2,0,0,100,42500,534,80
02370,2024,3,3,0,0,100,186000,1276,145
02371,2024,19,19,0,0,100,137529,1438,98
02372,2024,7,7,0,0,100,168700,1594,110
02373,2024,1,1,0,0,100,100000,1333,75
02374,2024,9,7,2,22,78,75578,931,82
02375,2024,1,1,0,0,100,390000,2321,168
02376,2024,1,1,0,0,100,135000,1378,98
02377,2024,2,2,0,0,100,112500,662,152
02378,2024,3,3,0,0,100,65333,624,114
02379,2024,3,3,0,0,100,71667,921,77
02381,2024,99,91,8,8,92,65601,832,86
02382,2024,9,9,0,0,100,188054,1496,126
02383,2024,21,17,4,19,81,152324,1332,114
02386,2024,2,2,0,0,100,45500,464,98
02387,2024,3,3,0,0,100,160300,1432,106
02388,2024,4,4,0,0,100,90800,753,117
02389,2024,8,7,1,12,88,134625,1546,87
02390,2024,4,4,0,0,100,107000,1112,97
02391,2024,2,2,0,0,100,166500,1522,112
02392,2024,3,3,0,0,100,119333,857,144
02395,2024,2,2,0,0,100,202300,1562,134
02397,2024,17,17,0,0,100,114551,1126,108
02398,2024,1,1,0,0,100,177650,1974,90
02399,2024,9,9,0,0,100,161383,1308,125
02403,2024,6,5,1,17,83,95417,958,98
02404,2024,1,1,0,0,100,20000,370,54
02405,2024,4,4,0,0,100,130625,1188,101
02406,2024,3,3,0,0,100,217000,1589,138
02407,2024,4,4,0,0,100,195650,1835,111
02408,2024,234,151,83,35,65,94454,1238,78
02409,2024,3,3,0,0,100,104333,1201,86
02412,2024,1,1,0,0,100,108500,1550,70
02413,2024,1,1,0,0,100,263000,1206,218
02414,2024,4,4,0,0,100,156875,1150,150
02415,2024,1,1,0,0,100,140000,2857,49
02416,2024,6,6,0,0,100,82675,997,91
02417,2024,2,2,0,0,100,132500,1353,128
02418,2024,5,5,0,0,100,123040,1397,89
02419,2024,1,1,0,0,100,34000,447,76
02420,2024,4,4,0,0,100,127950,1467,90
02421,2024,2,2,0,0,100,94000,1040,93
02422,2024,15,15,0,0,100,89693,976,102
02423,2024,5,5,0,0,100,170410,1656,104
02424,2024,1,1,0,0,100,220000,791,278
02425,2024,1,1,0,0,100,145000,1074,135
02426,2024,6,6,0,0,100,112050,1327,86
02427,2024,6,6,0,0,100,117462,1300,93
02429,2024,1,1,0,0,100,289000,2779,104
02430,2024,13,13,0,0,100,84300,1059,80
02431,2024,5,5,0,0,100,98580,1231,78
02432,2024,1,1,0,0,100,175000,2465,71
02433,2024,1,1,0,0,100,100874,1215,83
02438,2024,1,1,0,0,100,124900,1436,87
02439,2024,17,17,0,0,100,177768,1512,124
02440,2024,2,2,0,0,100,88900,990,92
02443,2024,4,4,0,0,100,185750,1490,132
02444,2024,1,1,0,0,100,50000,806,62
02445,2024,2,2,0,0,100,80000,876,88
02446,2024,1,1,0,0,100,128000,1320,97
02447,2024,3,3,0,0,100,184333,1515,109
02450,2024,4,4,0,0,100,51000,643,82
02451,2024,2,2,0,0,100,132600,1142,118
02452,2024,1,1,0,0,100,185000,1156,160
02453,2024,8,8,0,0,100,123903,1577,84
02454,2024,1,1,0,0,100,175000,946,185
02455,2024,1,1,0,0,100,50000,769,65
02456,2024,2,2,0,0,100,132500,2310,62
02457,2024,4,4,0,0,100,123500,1249,97
02458,2024,5,5,0,0,100,177620,1729,103
02459,2024,2,2,0,0,100,140550,1112,126
02461,2024,3,3,0,0,100,161333,1638,105
02462,2024,6,6,0,0,100,113167,1409,84
02463,2024,4,4,0,0,100,128000,1242,124
02464,2024,5,5,0,0,100,163890,1596,99
02465,2024,7,7,0,0,100,216579,2085,104
02466,2024,2,2,0,0,100,145750,1650,96
02468,2024,24,22,2,8,92,86633,1195,89
02469,2024,4,4,0,0,100,65000,672,94
02470,2024,2,2,0,0,100,235242,1286,158
02471,2024,1,1,0,0,100,260000,2680,97
02472,2024,6,6,0,0,100,144950,1647,102
02473,2024,3,3,0,0,100,119167,1014,118
02474,2024,6,6,0,0,100,90167,999,88
02476,2024,6,6,0,0,100,73417,636,107
02477,2024,6,5,1,17,83,156133,1800,87
02480,2024,1,1,0,0,100,89500,752,119
02481,2024,2,2,0,0,100,443000,1892,226
02483,2024,9,9,0,0,100,112689,1209,91
02484,2024,8,8,0,0,100,174300,1811,105
02485,2024,1,1,0,0,100,212500,2125,100
02486,2024,1,1,0,0,100,90000,857,105
02487,2024,3,3,0,0,100,183167,2297,89
02488,2024,2,2,0,0,100,90000,1092,76
02489,2024,5,5,0,0,100,140840,1291,108
02490,2024,1,1,0,0,100,95000,1218,78
02491,2024,4,4,0,0,100,163425,920,144
02492,2024,3,3,0,0,100,115333,1077,139
02493,2024,5,5,0,0,100,71600,1004,70
02494,2024,2,2,0,0,100,70000,996,70
02495,2024,10,10,0,0,100,120080,1130,106
02496,2024,1,1,0,0,100,125000,1087,115
02497,2024,9,9,0,0,100,154333,1611,101
02498,2024,7,7,0,0,100,141571,1163,120
02499,2024,1,1,0,0,100,238000,1587,150
02500,2024,12,12,0,0,100,88200,991,85
02502,2024,15,15,0,0,100,91926,1009,93
02503,2024,12,12,0,0,100,96771,919,109
02504,2024,17,17,0,0,100,144546,1364,107
02506,2024,3,3,0,0,100,294542,2077,136
02507,2024,1,1,0,0,100,120000,597,201
02508,2024,2,2,0,0,100,115000,1337,86
02511,2024,3,3,0,0,100,109120,1094,100
02512,2024,3,3,0,0,100,173333,1448,119
02514,2024,3,3,0,0,100,150833,1861,81
02516,2024,1,1,0,0,100,44000,373,118
02517,2024,4,4,0,0,100,89962,1032,89
02519,2024,1,1,0,0,100,122000,1419,86
02520,2024,11,11,0,0,100,141427,1506,92
02521,2024,23,22,1,4,96,175109,1943,94
02523,2024,1,1,0,0,100,435000,1279,340
02524,2024,5,5,0,0,100,171100,1658,104
02525,2024,1,1,0,0,100,78000,1300,60
02526,2024,2,2,0,0,100,51875,514,98
02527,2024,1,1,0,0,100,120000,1000,120
02528,2024,1,1,0,0,100,184320,2491,74
02529,2024,2,2,0,0,100,110900,1111,92
02530,2024,1,1,0,0,100,25000,610,41
02531,2024,2,2,0,0,100,161300,1142,162
02532,2024,9,9,0,0,100,114433,1045,111
02533,2024,3,3,0,0,100,129200,1104,113
02535,2024,1,1,0,0,100,119700,921,130
02536,2024,1,1,0,0,100,258000,2580,100
02537,2024,1,1,0,0,100,80000,909,88
02538,2024,2,2,0,0,100,182500,1894,86
02539,2024,6,6,0,0,100,118450,1352,83
02540,2024,7,7,0,0,100,158857,1574,113
02541,2024,5,5,0,0,100,163860,1533,104
02542,2024,3,3,0,0,100,105333,1577,67
02543,2024,22,22,0,0,100,132166,1452,93
02544,2024,6,6,0,0,100,102533,891,120
02545,2024,1,1,0,0,100,57500,479,120
02548,2024,4,4,0,0,100,128500,1264,119
02549,2024,14,14,0,0,100,141936,1671,85
02550,2024,1,1,0,0,100,241000,2975,81
02551,2024,1,1,0,0,100,75000,1250,60
02552,2024,2,2,0,0,100,212250,1189,186
02553,2024,2,2,0,0,100,78250,976,86
02554,2024,11,9,2,18,82,191746,2049,99
02555,2024,31,26,5,16,84,174487,1921,91
02556,2024,1,1,0,0,100,35000,438,80
02557,2024,1,1,0,0,100,312000,1248,250
02558,2024,29,29,0,0,100,103317,1170,92
02559,2024,5,5,0,0,100,91540,1132,87
02560,2024,5,5,0,0,100,117680,1623,97
02561,2024,1,1,0,0,100,105042,1439,73
02562,2024,2,2,0,0,100,85000,1129,77
02563,2024,4,4,0,0,100,95625,1225,78
02564,2024,12,11,1,8,92,148792,1670,89
02565,2024,4,4,0,0,100,85250,1234,72
02566,2024,18,18,0,0,100,134122,1523,89
02567,2024,2,2,0,0,100,154625,1275,122
02568,2024,3,3,0,0,100,302983,2444,125
02569,2024,4,4,0,0,100,101250,1025,105
02570,2024,1,1,0,0,100,154000,1556,99
02571,2024,3,3,0,0,100,97600,1392,70
02572,2024,3,3,0,0,100,255157,2004,149
02574,2024,11,11,0,0,100,92854,726,133
02575,2024,15,15,0,0,100,68127,778,87
02576,2024,2,2,0,0,100,207000,1519,150
02577,2024,2,2,0,0,100,129312,1076,122
02578,2024,2,2,0,0,100,61875,851,74
02580,2024,6,6,0,0,100,193033,1587,121
02581,2024,3,3,0,0,100,117667,1262,94
02585,2024,1,1,0,0,100,139000,1759,79
02586,2024,1,1,0,0,100,43080,431,100
02587,2024,3,3,0,0,100,173667,1518,142
02589,2024,3,3,0,0,100,139667,1679,83
02591,2024,1,1,0,0,100,184100,1089,169
02592,2024,4,4,0,0,100,78500,796,108
02593,2024,9,9,0,0,100,165344,1602,103
02596,2024,11,11,0,0,100,148545,1432,102
02598,2024,10,9,1,10,90,127000,1749,96
02599,2024,2,2,0,0,100,63500,1052,58
02600,2024,3,3,0,0,100,65667,973,67
02601,2024,3,3,0,0,100,165177,1842,93
02602,2024,19,19,0,0,100,111642,1331,83
02605,2024,2,2,0,0,100,51750,503,102
02606,2024,1,1,0,0,100,231700,1324,175
02608,2024,7,7,0,0,100,73300,796,87
02610,2024,5,5,0,0,100,192800,1935,104
02612,2024,1,1,0,0,100,66000,805,82
02613,2024,9,9,0,0,100,148820,1704,92
02614,2024,1,1,0,0,100,160000,1391,115
02615,2024,3,3,0,0,100,126900,1085,116
02617,2024,2,2,0,0,100,89000,871,103
02618,2024,4,4,0,0,100,100252,1103,90
02619,2024,9,9,0,0,100,129944,1290,101
02620,2024,5,5,0,0,100,144140,1793,86
02621,2024,7,6,1,14,86,178279,1367,130
02623,2024,1,1,0,0,100,26000,500,52
02626,2024,4,4,0,0,100,215880,2430,89
02629,2024,2,2,0,0,100,98900,932,92
02631,2024,10,10,0,0,100,107822,1348,87
02636,2024,1,1,0,0,100,196650,1206,163
02637,2024,5,5,0,0,100,125090,1077,115
02638,2024,6,6,0,0,100,119667,1273,97
02639,2024,2,2,0,0,100,201500,1352,149
02640,2024,2,2,0,0,100,59000,754,76
02642,2024,4,4,0,0,100,133750,1131,106
02643,2024,6,6,0,0,100,149605,1547,104
02644,2024,4,4,0,0,100,205500,1531,140
02648,2024,26,26,0,0,100,98668,1075,94
02649,2024,1,1,0,0,100,187000,1100,170
02650,2024,4,4,0,0,100,109750,1242,92
02651,2024,1,1,0,0,100,80000,1026,78
02653,2024,4,4,0,0,100,192750,1950,99
02656,2024,5,5,0,0,100,183720,1679,115
02657,2024,2,2,0,0,100,128050,1178,110
02658,2024,4,4,0,0,100,66500,828,83
02659,2024,6,6,0,0,100,122325,1280,87
02661,2024,2,2,0,0,100,168500,1164,136
02662,2024,7,6,1,14,86,127714,1503,90
02663,2024,1,1,0,0,100,241750,1691,143
02665,2024,4,4,0,0,100,107700,1282,83
02666,2024,12,12,0,0,100,60938,655,88
02667,2024,1,1,0,0,100,225306,2048,110
02668,2024,15,14,1,7,93,84209,865,102
02670,2024,2,2,0,0,100,60000,912,66
02671,2024,2,2,0,0,100,116500,1456,80
02672,2024,2,2,0,0,100,173500,1264,138
02673,2024,3,3,0,0,100,115333,1613,75
02674,2024,1,1,0,0,100,30000,536,56
02675,2024,1,1,0,0,100,140000,1591,88
02676,2024,13,12,1,8,92,143504,1099,141
02677,2024,3,3,0,0,100,84333,1302,68
02678,2024,1,1,0,0,100,112000,875,128
02679,2024,1,1,0,0,100,258000,1402,184
02680,2024,21,21,0,0,100,88162,1034,86
02682,2024,1,1,0,0,100,80000,889,90
02684,2024,35,34,1,3,97,93265,874,109
02685,2024,1,1,0,0,100,170000,1126,151
02686,2024,3,3,0,0,100,79333,966,88
02687,2024,4,4,0,0,100,250350,2385,111
02690,2024,1,1,0,0,100,50000,385,130
02691,2024,582,451,131,23,77,107095,1220,87
02693,2024,1,1,0,0,100,71500,627,114
02694,2024,9,9,0,0,100,90378,1137,84
02697,2024,4,4,0,0,100,163325,1504,109
02698,2024,1,1,0,0,100,72000,1263,57
02701,2024,9,9,0,0,100,144944,1358,112
02702,2024,3,3,0,0,100,122633,1168,97
02703,2024,10,10,0,0,100,82540,1119,73
02704,2024,3,3,0,0,100,109300,1331,89
02705,2024,4,4,0,0,100,120325,1167,110
02706,2024,8,8,0,0,100,161006,1695,96
02707,2024,1,1,0,0,100,92000,920,100
02708,2024,2,2,0,0,100,251525,1494,164
02709,2024,4,4,0,0,100,82100,854,92
02710,2024,4,4,0,0,100,91100,1070,85
02711,2024,4,4,0,0,100,179000,1092,174
02713,2024,2,2,0,0,100,157000,2018,83
02714,2024,3,3,0,0,100,145000,1754,81
02715,2024,2,2,0,0,100,61188,520,114
02716,2024,4,4,0,0,100,176750,1681,108
02717,2024,6,6,0,0,100,131717,1177,113
02719,2024,32,32,0,0,100,100827,1179,86
02720,2024,18,18,0,0,100,100671,897,114
02721,2024,7,7,0,0,100,157351,1247,131
02722,2024,275,131,144,52,48,145339,1832,81
02723,2024,1,1,0,0,100,100000,775,129
02724,2024,1,1,0,0,100,155000,1535,101
02725,2024,1,1,0,0,100,49000,343,143
02726,2024,2,2,0,0,100,127500,1687,83
02727,2024,3,3,0,0,100,99000,707,158
02728,2024,2,2,0,0,100,200200,1369,149
02730,2024,2,2,0,0,100,71500,1222,56
02736,2024,1,1,0,0,100,137000,958,143
02737,2024,5,5,0,0,100,124800,1395,99
02738,2024,127,124,3,2,98,96408,1152,86
02739,2024,3,3,0,0,100,141333,1306,120
02740,2024,2,2,0,0,100,63066,992,61
02741,2024,6,6,0,0,100,60433,830,74
02743,2024,1,1,0,0,100,102000,1229,83
02746,2024,5,5,0,0,100,111000,1150,92
02747,2024,2,2,0,0,100,147000,1263,116
02748,2024,11,11,0,0,100,132836,1589,94
02749,2024,1,1,0,0,100,111000,2135,52
02750,2024,4,4,0,0,100,61000,1264,49
02752,2024,8,8,0,0,100,94312,891,109
02753,2024,4,4,0,0,100,112125,1033,105
02754,2024,1,1,0,0,100,112500,1324,85
02755,2024,2,2,0,0,100,100610,988,98
02756,2024,3,3,0,0,100,156133,1024,145
02757,2024,6,6,0,0,100,67167,694,101
02758,2024,24,22,2,8,92,139858,1435,101
02759,2024,2,2,0,0,100,115000,996,112
02760,2024,2,2,0,0,100,75250,758,99
02761,2024,2,2,0,0,100,210875,1864,113
02763,2024,4,4,0,0,100,125083,982,124
02764,2024,1,1,0,0,100,187000,1870,100
02765,2024,2,2,0,0,100,143500,1438,100
02766,2024,3,3,0,0,100,131667,1104,119
02767,2024,3,3,0,0,100,185833,1706,122
02768,2024,7,7,0,0,100,132543,1371,101
02769,2024,10,10,0,0,100,102335,883,113
02770,2024,2,2,0,0,100,402425,2702,153
02772,2024,1,1,0,0,100,176000,1725,102
02774,2024,1,1,0,0,100,95000,880,108
02775,2024,11,11,0,0,100,113973,1287,90
02776,2024,4,4,0,0,100,110450,1338,76
02779,2024,1,1,0,0,100,68000,764,89
02780,2024,12,12,0,0,100,194114,1788,108
02781,2024,4,4,0,0,100,205700,2030,101
02782,2024,1,1,0,0,100,45000,395,114
02783,2024,2,2,0,0,100,144000,1218,124
02785,2024,12,12,0,0,100,101854,1190,90
02786,2024,1,1,0,0,100,355000,3859,92
02787,2024,5,5,0,0,100,127300,1380,96
02788,2024,5,5,0,0,100,110700,1179,95
02789,2024,13,13,0,0,100,91444,985,92
02790,2024,1,1,0,0,100,126200,1328,95
02791,2024,4,4,0,0,100,66512,1323,47
02792,2024,2,2,0,0,100,245000,1420,176
02793,2024,1,1,0,0,100,105000,1750,60
02794,2024,2,2,0,0,100,141750,2459,73
02795,2024,15,10,5,33,67,112117,1686,72
02796,2024,1,1,0,0,100,63000,594,106
02797,2024,2,2,0,0,100,127500,1342,98
02798,2024,9,7,2,22,78,154422,1577,107
02799,2024,4,4,0,0,100,165162,1262,142
02800,2024,4,4,0,0,100,511473,3412,144
02801,2024,4,4,0,0,100,110938,878,141
02802,2024,1,1,0,0,100,75000,514,146
02803,2024,3,3,0,0,100,143633,1781,79
02804,2024,4,4,0,0,100,163750,1701,92
02805,2024,25,21,4,16,84,131288,1496,88
02806,2024,4,4,0,0,100,99000,1133,89
02807,2024,8,8,0,0,100,148125,1490,96
02808,2024,1,1,0,0,100,42000,894,47
02809,2024,1,1,0,0,100,143000,1490,96
02810,2024,92,61,31,34,66,169757,2021,86
02812,2024,1,1,0,0,100,184400,1537,120
02813,2024,2,2,0,0,100,102460,1486,65
02814,2024,2,2,0,0,100,97000,1651,68
02815,2024,6,6,0,0,100,161025,1238,120
02816,2024,9,8,1,11,89,121478,1451,88
02817,2024,1,1,0,0,100,110000,957,115
02818,2024,6,6,0,0,100,177833,2099,88
02819,2024,1,1,0,0,100,25000,347,72
02820,2024,15,15,0,0,100,107527,1151,101
02821,2024,5,5,0,0,100,107990,1235,88
02822,2024,2,2,0,0,100,240000,3270,73
02823,2024,2,2,0,0,100,58000,910,67
02824,2024,4,4,0,0,100,189112,1767,118
02826,2024,1,1,0,0,100,115000,1045,110
02827,2024,7,7,0,0,100,95864,960,93
02828,2024,1,1,0,0,100,116000,1634,71
02830,2024,12,12,0,0,100,71242,716,104
02831,2024,3,3,0,0,100,102333,1127,90
02832,2024,4,4,0,0,100,129750,1117,116
02833,2024,3,3,0,0,100,125000,1285,97
03001,2024,35,33,2,6,94,150207,1644,89
03002,2024,2,2,0,0,100,115000,1414,113
03003,2024,14,14,0,0,100,101161,879,124
03004,2024,2,2,0,0,100,73715,934,70
03005,2024,6,6,0,0,100,50283,908,58
03006,2024,10,9,1,10,90,112017,1414,83
03007,2024,6,6,0,0,100,91570,756,105
03008,2024,6,6,0,0,100,102732,1290,75
03010,2024,4,4,0,0,100,130745,1401,93
03011,2024,4,4,0,0,100,131585,1328,102
03012,2024,3,3,0,0,100,155667,1429,111
03013,2024,25,25,0,0,100,181256,1763,103
03014,2024,2,2,0,0,100,219850,2117,87
03015,2024,2,2,0,0,100,100475,1988,49
03016,2024,1,1,0,0,100,25000,625,40
03017,2024,2,2,0,0,100,84530,1100,88
03018,2024,5,5,0,0,100,98220,1263,79
03019,2024,18,18,0,0,100,126598,1216,100
03020,2024,4,4,0,0,100,80122,874,98
03021,2024,3,3,0,0,100,76000,774,94
03022,2024,17,17,0,0,100,99075,1205,83
03023,2024,119,97,22,18,82,191878,1991,98
03024,2024,3,3,0,0,100,150333,1526,122
03025,2024,16,16,0,0,100,113664,1160,107
03026,2024,9,9,0,0,100,172656,1803,107
03027,2024,14,14,0,0,100,86854,965,100
03028,2024,8,8,0,0,100,108334,1112,95
03029,2024,11,11,0,0,100,108071,1298,81
03030,2024,10,10,0,0,100,120182,1421,88
03031,2024,1,1,0,0,100,60000,476,126
03032,2024,1,1,0,0,100,78600,1123,70
03034,2024,8,8,0,0,100,185119,1967,86
03035,2024,1,1,0,0,100,201000,2072,97
03036,2024,27,26,1,4,96,111104,1230,85
03037,2024,7,7,0,0,100,86022,1067,67
03038,2024,9,9,0,0,100,107333,981,106
03039,2024,2,2,0,0,100,106000,1166,92
03040,2024,7,7,0,0,100,158286,1777,91
03041,2024,2,2,0,0,100,226036,1498,150
03042,2024,5,5,0,0,100,71380,1214,66
03043,2024,14,14,0,0,100,151891,1402,107
03044,2024,20,20,0,0,100,174043,1621,106
03045,2024,11,11,0,0,100,99265,1371,83
03046,2024,19,18,1,5,95,64705,871,77
03047,2024,6,6,0,0,100,80688,1181,67
03048,2024,20,20,0,0,100,81053,969,86
03049,2024,7,7,0,0,100,73429,867,89
03050,2024,6,6,0,0,100,137171,1583,89
03051,2024,4,4,0,0,100,32500,606,54
03052,2024,11,11,0,0,100,131927,1134,117
03053,2024,14,14,0,0,100,95818,1186,86
03054,2024,6,6,0,0,100,140680,1415,101
03055,2024,8,8,0,0,100,109499,1112,90
03056,2024,10,10,0,0,100,112544,1589,80
03057,2024,1,1,0,0,100,64000,1123,57
03058,2024,3,3,0,0,100,54500,889,57
03059,2024,4,4,0,0,100,296750,1540,198
03060,2024,11,11,0,0,100,170673,1566,113
03061,2024,5,5,0,0,100,144780,1624,84
03062,2024,7,7,0,0,100,104160,1658,61
03063,2024,12,12,0,0,100,112561,1055,101
03064,2024,1,1,0,0,100,127000,3256,39
03065,2024,3,3,0,0,100,134833,931,142
03066,2024,7,7,0,0,100,74930,1076,76
03067,2024,1,1,0,0,100,171500,1072,160
03068,2024,1,1,0,0,100,295000,1612,183
03069,2024,3,3,0,0,100,75667,725,110
03070,2024,1,1,0,0,100,205000,1708,120
03071,2024,2,2,0,0,100,197500,1484,120
03072,2024,1,1,0,0,100,45000,511,88
03073,2024,3,3,0,0,100,153303,1433,97
03074,2024,11,11,0,0,100,180727,1586,94
03075,2024,4,4,0,0,100,117000,1043,115
03076,2024,1,1,0,0,100,179210,1572,114
03077,2024,2,2,0,0,100,206750,1596,113
03078,2024,11,11,0,0,100,103170,1066,99
03079,2024,6,6,0,0,100,247055,2333,104
03080,2024,7,7,0,0,100,220933,1918,113
03081,2024,3,3,0,0,100,122017,1146,108
03082,2024,69,59,10,14,86,76876,962,82
03083,2024,5,5,0,0,100,95940,914,102
03084,2024,37,37,0,0,100,94184,1034,92
03085,2024,4,4,0,0,100,151425,1401,97
03086,2024,4,4,0,0,100,124738,1508,82
03087,2024,7,7,0,0,100,87286,1027,74
03088,2024,1,1,0,0,100,150000,1087,138
03089,2024,5,5,0,0,100,66168,831,81
03090,2024,4,4,0,0,100,81678,740,125
03091,2024,3,3,0,0,100,134223,1407,114
03092,2024,6,6,0,0,100,126367,1240,107
03093,2024,11,11,0,0,100,177772,1882,100
03094,2024,21,17,4,19,81,186581,1970,94
03095,2024,180,102,78,43,57,126181,1510,80
03096,2024,2,2,0,0,100,128000,833,130
03097,2024,4,4,0,0,100,133655,1407,91
03098,2024,59,52,7,12,88,99051,1122,85
03099,2024,2,2,0,0,100,51500,951,82
03100,2024,12,12,0,0,100,96121,1170,92
03101,2024,96,94,2,2,98,111053,1246,90
03102,2024,27,26,1,4,96,97329,1131,88
03103,2024,18,14,4,22,78,78650,1067,76
03104,2024,20,19,1,5,95,90245,968,96
03105,2024,3,3,0,0,100,94253,1197,78
03106,2024,16,16,0,0,100,112774,1207,93
03107,2024,15,14,1,7,93,119902,1375,90
03108,2024,2,2,0,0,100,108550,2004,54
03109,2024,12,12,0,0,100,119129,1230,95
03110,2024,10,10,0,0,100,160845,1856,91
03111,2024,14,14,0,0,100,118401,1129,104
03112,2024,5,5,0,0,100,123900,1115,110
03113,2024,5,5,0,0,100,68760,938,81
03115,2024,7,7,0,0,100,168857,1422,119
03116,2024,1,1,0,0,100,100000,333,300
03117,2024,7,7,0,0,100,118943,1193,106
03118,2024,77,70,7,9,91,113825,1313,86
03119,2024,5,5,0,0,100,50300,582,94
03120,2024,4,4,0,0,100,61400,750,87
03121,2024,4,4,0,0,100,173485,1450,119
03122,2024,5,5,0,0,100,117393,1265,91
03124,2024,2,2,0,0,100,160750,1276,146
03125,2024,2,2,0,0,100,56250,936,53
03126,2024,27,17,10,37,63,158451,1803,83
03127,2024,14,13,1,7,93,82745,830,102
03128,2024,37,35,2,5,95,102044,1219,85
03129,2024,2,2,0,0,100,116915,1130,98
03130,2024,8,8,0,0,100,104938,849,122
03131,2024,7,7,0,0,100,138358,1458,114
03132,2024,3,3,0,0,100,177042,1067,182
03133,2024,7,7,0,0,100,134431,1078,132
03134,2024,5,5,0,0,100,92500,1060,96
03135,2024,2,2,0,0,100,63995,936,68
03136,2024,2,2,0,0,100,41000,490,91
03137,2024,2,2,0,0,100,103650,906,124
03138,2024,35,27,8,23,77,105685,1039,100
03139,2024,8,7,1,12,88,67944,1108,74
03140,2024,6,6,0,0,100,132725,1356,98
03142,2024,3,2,1,33,67,119398,1659,74
03143,2024,3,3,0,0,100,121000,1279,94
03144,2024,4,4,0,0,100,259875,1846,126
03145,2024,8,8,0,0,100,109800,1183,90
03146,2024,2,2,0,0,100,122000,846,142
03147,2024,2,2,0,0,100,51500,644,88
03148,2024,2,2,0,0,100,52000,659,90
03149,2024,4,4,0,0,100,299234,4084,72
03150,2024,2,2,0,0,100,77235,920,86
03151,2024,7,7,0,0,100,101286,938,111
03152,2024,4,4,0,0,100,56625,1019,59
03154,2024,5,5,0,0,100,152923,1387,114
03155,2024,24,22,2,8,92,88642,838,102
03156,2024,11,10,1,9,91,140873,1623,90
03157,2024,15,15,0,0,100,153657,1620,96
03158,2024,7,7,0,0,100,82857,1085,70
03159,2024,9,8,1,11,89,106048,953,110
03160,2024,6,6,0,0,100,155150,1533,104
03161,2024,9,9,0,0,100,82719,699,112
03162,2024,2,2,0,0,100,206500,1863,111
03163,2024,7,7,0,0,100,89600,1120,80
03164,2024,4,4,0,0,100,130346,1408,108
03165,2024,15,15,0,0,100,116369,1260,93
03166,2024,1,1,0,0,100,186050,1632,114
03167,2024,3,3,0,0,100,100833,1573,67
03168,2024,7,7,0,0,100,101626,985,115
03169,2024,7,7,0,0,100,102637,1350,79
03171,2024,5,5,0,0,100,96230,1098,88
03172,2024,1,1,0,0,100,114000,1341,85
03173,2024,8,8,0,0,100,125526,1380,90
03174,2024,5,5,0,0,100,202057,1721,118
03175,2024,5,5,0,0,100,81905,1203,68
03176,2024,4,4,0,0,100,187465,1768,104
03177,2024,4,4,0,0,100,157482,1699,96
03178,2024,5,5,0,0,100,125952,1375,92
03179,2024,4,4,0,0,100,131592,1268,112
03180,2024,10,10,0,0,100,120581,1424,82
03181,2024,3,3,0,0,100,43000,580,77
03182,2024,3,3,0,0,100,175333,1826,86
03183,2024,4,3,1,25,75,73500,778,98
03184,2024,3,3,0,0,100,130000,1110,117
03185,2024,507,244,263,52,48,76484,995,77
03186,2024,17,17,0,0,100,95250,971,94
03187,2024,5,5,0,0,100,155792,1251,125
03189,2024,9,9,0,0,100,82088,999,86
03190,2024,223,81,142,64,36,106093,1392,76
03192,2024,3,3,0,0,100,133167,1550,93
03193,2024,3,3,0,0,100,155680,1350,129
03194,2024,4,4,0,0,100,92938,1038,82
03195,2024,41,34,7,17,83,97173,1269,85
03196,2024,4,4,0,0,100,84285,1060,78
03197,2024,12,12,0,0,100,130325,1307,101
03198,2024,1,1,0,0,100,27500,917,30
03200,2024,11,11,0,0,100,122245,1457,84
03201,2024,2,2,0,0,100,106800,1201,88
03202,2024,6,6,0,0,100,74708,878,94
03203,2024,2,2,0,0,100,105960,1071,114
03204,2024,2,2,0,0,100,123000,1289,90
03205,2024,3,3,0,0,100,152067,1361,107
03206,2024,4,4,0,0,100,57625,611,89
03207,2024,6,6,0,0,100,111616,1200,94
03208,2024,5,5,0,0,100,74890,991,90
03209,2024,2,2,0,0,100,202525,1988,102
03210,2024,9,9,0,0,100,100389,868,101
03211,2024,19,19,0,0,100,150243,1489,96
03212,2024,17,17,0,0,100,175689,1645,102
03213,2024,3,3,0,0,100,109833,1039,107
03214,2024,2,2,0,0,100,185750,2002,90
03215,2024,7,7,0,0,100,156626,1380,112
03217,2024,6,6,0,0,100,142292,1145,112
03218,2024,3,3,0,0,100,103233,1454,82
03219,2024,2,2,0,0,100,103250,3109,50
03220,2024,9,9,0,0,100,156910,1762,91
03221,2024,7,6,1,14,86,112757,1159,97
03222,2024,2,2,0,0,100,59625,1224,51
03223,2024,2,2,0,0,100,46440,724,68
03224,2024,6,6,0,0,100,135578,1194,113
03225,2024,7,7,0,0,100,161043,1359,120
03226,2024,3,3,0,0,100,61333,1013,65
03227,2024,3,3,0,0,100,115000,1632,74
03228,2024,1,1,0,0,100,154000,1426,108
03229,2024,4,4,0,0,100,106000,1034,98
03230,2024,3,3,0,0,100,143333,1596,91
03231,2024,4,4,0,0,100,83500,894,89
03232,2024,2,2,0,0,100,174100,1185,148
03233,2024,2,2,0,0,100,18000,405,46
03234,2024,5,5,0,0,100,61300,688,85
03235,2024,11,11,0,0,100,207322,1335,138
03236,2024,35,30,5,14,86,112301,1334,85
03237,2024,4,4,0,0,100,118120,1675,77
03238,2024,3,3,0,0,100,132500,1273,105
03239,2024,3,3,0,0,100,112667,969,105
03240,2024,5,5,0,0,100,161610,1405,100
03241,2024,4,4,0,0,100,132952,1364,104
03242,2024,6,6,0,0,100,111483,838,133
03243,2024,1,1,0,0,100,233000,1465,159
03244,2024,3,3,0,0,100,96833,1129,85
03245,2024,1,1,0,0,100,134000,1558,86
03246,2024,7,7,0,0,100,90429,1036,83
03247,2024,12,12,0,0,100,109408,982,107
03248,2024,5,5,0,0,100,91450,1150,75
03249,2024,5,5,0,0,100,79300,1315,73
03250,2024,7,7,0,0,100,145429,1200,113
03251,2024,8,8,0,0,100,100138,921,110
03252,2024,2,2,0,0,100,100000,677,154
03253,2024,2,2,0,0,100,97500,1137,80
03254,2024,57,48,9,16,84,122782,1352,89
03255,2024,4,4,0,0,100,170975,1650,105
03256,2024,1,1,0,0,100,119300,795,150
03257,2024,15,14,1,7,93,85953,848,99
03258,2024,18,17,1,6,94,159654,1493,104
03259,2024,13,13,0,0,100,69898,1127,76
03260,2024,3,3,0,0,100,124911,1513,90
03261,2024,1,1,0,0,100,149000,1049,142
03262,2024,9,9,0,0,100,143642,1460,97
03263,2024,2,2,0,0,100,100250,906,113
03264,2024,39,38,1,3,97,123873,1475,84
03265,2024,9,9,0,0,100,130711,1332,96
03266,2024,2,2,0,0,100,111750,1466,81
03267,2024,9,9,0,0,100,158772,1720,94
03268,2024,3,3,0,0,100,116207,1490,81
03271,2024,7,7,0,0,100,243186,1752,126
03272,2024,4,4,0,0,100,93468,933,92
03273,2024,4,4,0,0,100,101950,1268,75
03274,2024,2,2,0,0,100,108250,1136,99
03275,2024,13,13,0,0,100,141394,1410,107
03276,2024,4,4,0,0,100,126025,988,106
03278,2024,1,1,0,0,100,230800,1282,180
03279,2024,4,4,0,0,100,60125,810,74
03280,2024,2,2,0,0,100,80000,867,88
03281,2024,10,10,0,0,100,62256,699,90
03282,2024,5,5,0,0,100,141510,1040,142
03283,2024,11,11,0,0,100,89020,1342,70
03284,2024,3,3,0,0,100,57180,981,58
03286,2024,8,8,0,0,100,218586,2770,82
03287,2024,2,2,0,0,100,54500,404,128
03288,2024,10,10,0,0,100,83040,939,89
03289,2024,6,6,0,0,100,85383,1100,79
03290,2024,6,6,0,0,100,130856,1405,95
03291,2024,3,3,0,0,100,119012,1033,120
03292,2024,15,15,0,0,100,108340,1077,95
03293,2024,7,7,0,0,100,68281,724,92
03294,2024,2,2,0,0,100,127500,1540,84
03295,2024,2,2,0,0,100,102050,1143,86
03296,2024,3,3,0,0,100,80667,1020,89
03297,2024,15,15,0,0,100,91649,1128,82
03298,2024,48,37,11,23,77,84725,1093,77
03299,2024,2,2,0,0,100,102000,1122,90
03300,2024,7,7,0,0,100,75143,1011,76
03301,2024,3,3,0,0,100,150240,1627,93
03303,2024,4,4,0,0,100,88250,1059,86
03304,2024,25,25,0,0,100,209466,1867,112
03305,2024,3,3,0,0,100,192292,1670,114
03306,2024,16,16,0,0,100,182217,1693,100
03307,2024,5,5,0,0,100,151782,1700,98
03309,2024,4,4,0,0,100,63750,679,97
03310,2024,636,125,511,80,20,128388,1918,66
03311,2024,2,2,0,0,100,122820,1424,86
03312,2024,2,2,0,0,100,70750,560,118
03313,2024,2,2,0,0,100,84500,1544,58
03314,2024,5,5,0,0,100,107800,1008,107
03315,2024,13,13,0,0,100,88964,1056,86
03316,2024,9,9,0,0,100,176603,1612,99
03317,2024,8,8,0,0,100,74156,701,104
03319,2024,8,8,0,0,100,127219,1347,89
03320,2024,12,12,0,0,100,104871,1394,77
03321,2024,148,114,34,23,77,131686,1507,87
04001,2024,8,8,0,0,100,242988,2206,113
04004,2024,11,10,1,9,91,153555,2534,62
04005,2024,3,3,0,0,100,46500,1185,51
04006,2024,220,21,199,90,10,115231,2975,36
04007,2024,1,1,0,0,100,70500,1410,50
04008,2024,17,7,10,59,41,85955,1596,58
04013,2024,2,2,0,0,100,169000,2128,76
04016,2024,1,1,0,0,100,150000,2586,58
04017,2024,4,2,2,50,50,168924,2212,88
04018,2024,12,11,1,8,92,170890,1987,86
04019,2024,89,16,73,82,18,136431,2588,54
04021,2024,1,1,0,0,100,305511,1840,166
04022,2024,6,6,0,0,100,106250,1373,84
04023,2024,8,6,2,25,75,109816,1604,67
04024,2024,3,2,1,33,67,106933,2050,57
04025,2024,20,14,6,30,70,151864,2323,72
04026,2024,3,3,0,0,100,197232,2153,91
04028,2024,2,2,0,0,100,374000,1934,174
04030,2024,1,1,0,0,100,85750,1715,50
04031,2024,10,10,0,0,100,195452,2373,84
04032,2024,2,2,0,0,100,107500,1979,63
04033,2024,10,9,1,10,90,213165,2006,105
04034,2024,4,4,0,0,100,313502,2628,128
04035,2024,5,4,1,20,80,184000,1532,109
04036,2024,4,4,0,0,100,207372,2549,82
04039,2024,21,15,6,29,71,121321,1957,57
04041,2024,1,1,0,0,100,45000,577,78
04042,2024,4,2,2,50,50,111000,1658,62
04043,2024,5,4,1,20,80,148160,1712,79
04045,2024,31,30,1,3,97,258218,2813,90
04046,2024,5,5,0,0,100,213900,2267,96
04047,2024,2,2,0,0,100,398000,2480,149
04049,2024,74,29,45,61,39,167048,2055,83
04051,2024,1,1,0,0,100,162000,2531,64
04053,2024,5,4,1,20,80,166862,2421,67
04054,2024,1,1,0,0,100,228000,2151,106
04055,2024,3,3,0,0,100,258600,1712,147
04057,2024,4,4,0,0,100,103000,1523,65
04058,2024,3,3,0,0,100,213820,2000,114
04059,2024,2,2,0,0,100,202500,2688,75
04061,2024,13,8,5,38,62,143655,2401,57
04062,2024,4,2,2,50,50,98881,1131,80
04063,2024,12,12,0,0,100,248880,2517,98
04065,2024,10,8,2,20,80,161608,1819,79
04066,2024,2,2,0,0,100,246166,2786,86
04068,2024,10,10,0,0,100,257546,2626,105
04069,2024,1,1,0,0,100,78000,2053,38
04070,2024,235,66,169,72,28,136196,1938,69
04073,2024,58,5,53,91,9,90074,2300,40
04075,2024,1,1,0,0,100,250000,2273,110
04076,2024,13,9,4,31,69,158578,2162,76
04077,2024,2,1,1,50,50,100700,1124,87
04079,2024,12,9,3,25,75,229975,2339,100
04081,2024,15,14,1,7,93,314039,3334,88
04084,2024,9,6,3,33,67,173683,1651,103
04086,2024,1,1,0,0,100,254600,5304,48
04087,2024,2,2,0,0,100,313610,3347,94
04088,2024,57,41,16,28,72,259793,3009,87
04090,2024,3,3,0,0,100,184360,1782,96
04091,2024,1,1,0,0,100,350000,2869,122
04092,2024,5,3,2,40,60,112500,1560,74
04093,2024,1,1,0,0,100,203000,1285,158
04094,2024,118,38,80,68,32,145346,3169,46
04095,2024,1,1,0,0,100,332000,4000,83
04096,2024,29,9,20,69,31,169978,2292,67
04097,2024,5,5,0,0,100,149180,1577,103
04099,2024,2,1,1,50,50,113840,1674,64
04101,2024,3,3,0,0,100,192000,2381,90
04102,2024,3,1,2,67,33,62640,1533,44
04104,2024,4,4,0,0,100,165375,1788,90
04106,2024,5,3,2,40,60,226800,2520,90
04108,2024,20,11,9,45,55,153234,2007,71
04109,2024,6,6,0,0,100,242710,2274,103
04110,2024,7,7,0,0,100,197044,2488,79
04111,2024,19,19,0,0,100,331017,3383,102
04112,2024,252,78,174,69,31,178249,2315,75
04113,2024,4,3,1,25,75,143912,1995,71
04115,2024,8,7,1,12,88,124375,1983,58
04116,2024,39,32,7,18,82,207983,2415,88
04118,2024,2,2,0,0,100,174500,1274,135
04120,2024,3,3,0,0,100,132052,1386,98
04121,2024,13,10,3,23,77,156473,2023,79
04122,2024,2,2,0,0,100,247500,2489,99
04123,2024,10,10,0,0,100,210600,2214,90
04124,2024,12,12,0,0,100,237806,2729,88
04126,2024,23,2,21,91,9,76815,2259,35
04127,2024,9,8,1,11,89,176250,2239,86
04128,2024,3,3,0,0,100,189167,2084,89
04129,2024,2,2,0,0,100,252500,2764,82
04130,2024,2,2,0,0,100,140500,1560,70
04132,2024,2,2,0,0,100,328750,2990,108
04133,2024,2,2,0,0,100,176067,5869,30
04134,2024,9,8,1,11,89,132722,2014,65
04135,2024,6,2,4,67,33,136812,2867,50
04136,2024,6,6,0,0,100,161028,2093,76
04138,2024,2,2,0,0,100,172500,1242,142
04139,2024,3,3,0,0,100,139000,1657,82
04140,2024,2,2,0,0,100,136500,2282,62
04141,2024,4,4,0,0,100,296068,4184,70
04142,2024,1,0,1,100,0,80000,1333,60
04143,2024,66,55,11,17,83,254060,2813,92
04144,2024,5,5,0,0,100,292000,3103,98
04145,2024,15,15,0,0,100,238458,2478,98
04148,2024,5,4,1,20,80,160600,3033,54
04149,2024,22,19,3,14,86,237398,2513,93
04151,2024,5,5,0,0,100,283730,2263,123
04152,2024,45,40,5,11,89,324364,3180,101
04155,2024,4,4,0,0,100,163380,2061,94
04157,2024,16,16,0,0,100,215381,2502,85
04158,2024,14,12,2,14,86,195920,2862,75
04160,2024,20,19,1,5,95,266446,2715,98
04161,2024,11,9,2,18,82,180230,1860,89
04162,2024,3,2,1,33,67,119533,2201,54
04163,2024,6,6,0,0,100,156542,1983,76
04164,2024,2,2,0,0,100,368250,3543,86
04166,2024,27,21,6,22,78,155908,1893,85
04167,2024,5,5,0,0,100,143356,2093,77
04169,2024,1,1,0,0,100,101200,1632,62
04170,2024,1,0,1,100,0,61750,561,110
04171,2024,1,0,1,100,0,30000,882,34
04172,2024,10,10,0,0,100,164390,2098,75
04173,2024,9,4,5,56,44,147382,2195,67
04174,2024,2,2,0,0,100,326845,2391,138
04176,2024,2,1,1,50,50,230205,3070,74
04178,2024,24,22,2,8,92,229578,2769,83
04179,2024,3,3,0,0,100,163933,3806,42
04180,2024,2,2,0,0,100,159250,2354,96
04182,2024,4,3,1,25,75,177481,2031,95
04183,2024,2,2,0,0,100,415000,2804,154
04184,2024,1,1,0,0,100,142000,2840,50
04186,2024,3,1,2,67,33,156900,2805,61
04187,2024,2,2,0,0,100,123175,1846,68
04188,2024,6,4,2,33,67,259717,2429,100
04189,2024,8,7,1,12,88,117954,3050,39
04190,2024,1,1,0,0,100,80000,1000,80
04192,2024,13,13,0,0,100,248335,2932,89
04193,2024,5,3,2,40,60,224443,3498,85
04195,2024,9,5,4,44,56,228384,2439,84
04197,2024,40,30,10,25,75,181912,2671,70
04200,2024,4,4,0,0,100,247500,2240,123
04201,2024,3,3,0,0,100,226500,2858,78
04202,2024,2,1,1,50,50,73000,1670,48
04203,2024,23,3,20,87,13,72394,2148,34
04204,2024,4,4,0,0,100,92928,1492,57
04205,2024,49,23,26,53,47,120030,1938,62
04206,2024,4,4,0,0,100,186800,2910,71
04208,2024,17,17,0,0,100,268087,3716,82
04209,2024,101,44,57,56,44,149561,1953,76
04210,2024,5,1,4,80,20,103600,1238,84
04211,2024,1,1,0,0,100,158000,1386,114
04216,2024,2,2,0,0,100,275088,2340,122
04217,2024,7,5,2,29,71,136500,1981,73
04218,2024,6,6,0,0,100,130667,1920,70
04219,2024,5,5,0,0,100,173000,1909,81
04220,2024,8,4,4,50,50,170002,2592,63
04222,2024,3,3,0,0,100,205667,2534,80
04224,2024,2,2,0,0,100,96500,1582,64
04226,2024,110,5,105,95,5,108745,2964,36
04227,2024,2,2,0,0,100,79000,2032,40
04228,2024,2,2,0,0,100,544000,3756,146
04229,2024,3,3,0,0,100,138000,2152,55
04230,2024,28,25,3,11,89,216186,2630,79
04231,2024,1,1,0,0,100,101000,1836,55
04233,2024,2,2,0,0,100,314500,2535,110
04234,2024,3,3,0,0,100,402367,2824,141
04235,2024,5,4,1,20,80,165690,1887,88
04236,2024,6,2,4,67,33,87602,1419,67
04237,2024,2,1,1,50,50,142000,2688,60
04240,2024,8,5,3,38,62,92336,1824,50
04241,2024,3,2,1,33,67,161667,1291,164
04242,2024,27,26,1,4,96,243421,2603,94
04244,2024,17,10,7,41,59,102454,1367,80
04245,2024,34,21,13,38,62,209377,2516,84
05001,2024,22,1,21,95,5,124745,2498,49
05003,2024,19,4,15,79,21,92099,1633,60
05004,2024,55,10,45,82,18,130826,2781,46
05006,2024,19,12,7,37,63,209915,2822,91
05007,2024,10,4,6,60,40,241708,3353,59
05008,2024,10,10,0,0,100,135506,1513,89
05009,2024,2,1,1,50,50,63600,1016,78
05010,2024,9,9,0,0,100,161806,1846,97
05011,2024,1,1,0,0,100,17000,425,40
05012,2024,8,2,6,75,25,209938,3141,72
05013,2024,1,1,0,0,100,408992,3195,128
05014,2024,6,6,0,0,100,210867,2141,110
05016,2024,4,4,0,0,100,95500,1816,84
05017,2024,16,13,3,19,81,277161,2871,97
05018,2024,1,1,0,0,100,455170,3298,138
05019,2024,3,3,0,0,100,68333,1289,59
05021,2024,2,2,0,0,100,110000,3309,38
05022,2024,6,3,3,50,50,143708,1188,123
05023,2024,244,28,216,89,11,191518,3056,63
05024,2024,4,4,0,0,100,142750,1730,80
05026,2024,7,0,7,100,0,146110,3084,45
05027,2024,3,1,2,67,33,48000,3621,16
05028,2024,3,2,1,33,67,150000,1717,87
05029,2024,6,5,1,17,83,201808,2002,98
05031,2024,3,1,2,67,33,179618,2517,82
05032,2024,2,2,0,0,100,228200,2559,88
05033,2024,1,1,0,0,100,419900,2799,150
05035,2024,3,3,0,0,100,131667,2108,63
05036,2024,11,8,3,27,73,333409,3913,87
05037,2024,7,6,1,14,86,400631,4266,100
05038,2024,8,4,4,50,50,128210,1368,92
05039,2024,7,6,1,14,86,119500,1447,79
05040,2024,34,27,7,21,79,301307,3669,87
05044,2024,3,1,2,67,33,118400,2409,60
05045,2024,18,16,2,11,89,264556,2874,93
05046,2024,148,39,109,74,26,208161,3336,64
05047,2024,1,1,0,0,100,237000,1975,120
05048,2024,3,3,0,0,100,115167,1487,77
05049,2024,2,2,0,0,100,103380,1450,76
05050,2024,5,4,1,20,80,157300,2490,77
05052,2024,13,6,7,54,46,197163,2854,73
05053,2024,5,5,0,0,100,191640,2055,96
05054,2024,2,1,1,50,50,196900,2596,76
05055,2024,4,4,0,0,100,145012,1562,83
05056,2024,2,2,0,0,100,213000,1775,116
05057,2024,2,2,0,0,100,240200,2434,99
05058,2024,2,2,0,0,100,343474,1848,168
05059,2024,10,10,0,0,100,320188,2912,109
05060,2024,1,1,0,0,100,259070,2786,93
05061,2024,464,116,348,75,25,194409,2531,77
05062,2024,1,0,1,100,0,66000,2062,32
05063,2024,9,6,3,33,67,147059,3420,46
05064,2024,1,1,0,0,100,50000,769,65
05065,2024,32,12,20,62,38,200124,2626,75
05068,2024,1,1,0,0,100,399200,3095,129
05070,2024,40,20,20,50,50,128209,1699,80
05071,2024,1,1,0,0,100,95000,1900,50
05072,2024,12,6,6,50,50,154971,2524,60
05073,2024,3,3,0,0,100,252317,2242,115
05075,2024,11,10,1,9,91,279508,3357,93
05077,2024,17,3,14,82,18,133673,2558,53
05078,2024,1,1,0,0,100,323000,2563,126
05079,2024,48,15,33,69,31,345558,5178,65
05084,2024,2,2,0,0,100,333200,3402,107
05085,2024,54,4,50,93,7,200405,4334,44
05086,2024,3,3,0,0,100,100667,1127,85
05087,2024,6,5,1,17,83,135767,1624,80
05090,2024,1,1,0,0,100,199800,1816,110
05091,2024,1,1,0,0,100,71000,866,82
05092,2024,5,4,1,20,80,320300,3216,123
05093,2024,12,3,9,75,25,256442,3637,62
05095,2024,3,2,1,33,67,174210,2534,65
05096,2024,125,13,112,90,10,131510,2686,47
05097,2024,3,1,2,67,33,172500,1974,81
05098,2024,91,3,88,97,3,124008,3524,34
05100,2024,11,11,0,0,100,385046,4104,102
05101,2024,32,13,19,59,41,206795,3229,65
05103,2024,6,4,2,33,67,132176,2254,64
05104,2024,5,5,0,0,100,299880,3373,93
05106,2024,9,7,2,22,78,381268,4296,87
05107,2024,3,2,1,33,67,303750,5479,91
05108,2024,2,2,0,0,100,276614,3468,104
05109,2024,6,3,3,50,50,1003698,6600,119
05110,2024,72,3,69,96,4,91914,2695,32
05111,2024,1,1,0,0,100,350000,5833,60
05112,2024,1,1,0,0,100,197500,3038,65
05113,2024,1,1,0,0,100,329180,3227,102
05114,2024,16,6,10,62,38,136249,2872,49
05115,2024,6,5,1,17,83,194133,2063,99
05116,2024,5,3,2,40,60,196170,2078,87
05118,2024,20,18,2,10,90,138994,2404,86
05119,2024,111,5,106,95,5,119758,3838,31
05121,2024,6,4,2,33,67,128433,1657,78
05122,2024,7,5,2,29,71,259010,2770,89
05123,2024,12,10,2,17,83,215640,2712,77
05124,2024,1,1,0,0,100,267500,3429,78
05126,2024,9,7,2,22,78,84074,1304,64
05127,2024,2,2,0,0,100,230300,2504,101
05128,2024,12,11,1,8,92,184524,2498,90
05129,2024,1,0,1,100,0,35000,795,44
05130,2024,2,2,0,0,100,399495,4656,87
05132,2024,36,14,22,61,39,146409,2377,61
05133,2024,69,7,62,90,10,185223,4020,44
05134,2024,7,5,2,29,71,160956,2413,73
05135,2024,2,1,1,50,50,83000,1252,75
05136,2024,12,10,2,17,83,224775,2749,80
05139,2024,135,9,126,93,7,104986,2814,35
05140,2024,3,3,0,0,100,233600,2884,81
05142,2024,7,5,2,29,71,214843,2647,80
05144,2024,1,1,0,0,100,45000,1250,36
05145,2024,20,12,8,40,60,156850,2190,75
05146,2024,1,1,0,0,100,110750,1231,90
05147,2024,2,2,0,0,100,309000,2220,176
05148,2024,1,1,0,0,100,278740,2323,120
05149,2024,26,4,22,85,15,85038,2284,37
05151,2024,12,8,4,33,67,211653,3631,60
05152,2024,3,3,0,0,100,173452,2025,85
05153,2024,21,4,17,81,19,115780,2629,46
05154,2024,5,5,0,0,100,148160,1805,98
05155,2024,1,1,0,0,100,228000,2533,90
05156,2024,5,3,2,40,60,228860,2551,88
05157,2024,2,1,1,50,50,163550,4602,36
05158,2024,3,2,1,33,67,120917,2049,59
05159,2024,1,1,0,0,100,220000,2821,78
05160,2024,2,2,0,0,100,158815,2093,76
05161,2024,83,7,76,92,8,233007,4410,51
05162,2024,12,5,7,58,42,203823,2582,76
05163,2024,1,1,0,0,100,326000,4289,76
05164,2024,22,11,11,50,50,391668,4095,92
05166,2024,29,21,8,28,72,134174,1610,82
05168,2024,6,5,1,17,83,285200,2618,102
05170,2024,19,14,5,26,74,164416,2157,81
05171,2024,2,2,0,0,100,136500,1716,87
05172,2024,3,3,0,0,100,176229,2070,84
05173,2024,6,6,0,0,100,257868,2290,119
05174,2024,4,1,3,75,25,137904,1824,78
05176,2024,2,1,1,50,50,217300,2880,78
05177,2024,115,5,110,96,4,149622,3705,39
05178,2024,3,3,0,0,100,131263,2862,66
05179,2024,39,20,19,49,51,123677,1731,72
05180,2024,10,7,3,30,70,305335,3190,101
05181,2024,2,1,1,50,50,142000,3625,37
05182,2024,1,0,1,100,0,110000,2444,45
05183,2024,16,13,3,19,81,343541,3826,85
05184,2024,3,2,1,33,67,90833,1301,92
06001,2024,1,1,0,0,100,120000,1714,70
06002,2024,1,1,0,0,100,218000,1425,153
06003,2024,19,5,14,74,26,89387,1968,44
06004,2024,1949,190,1759,90,10,355558,5660,61
06005,2024,3,2,1,33,67,138067,1616,73
06006,2024,26,20,6,23,77,461077,5058,89
06007,2024,34,22,12,35,65,451221,5031,88
06009,2024,1,1,0,0,100,335000,2094,160
06010,2024,33,18,15,45,55,273114,3301,78
06011,2024,102,4,98,96,4,499309,7897,64
06012,2024,238,11,227,95,5,359596,7185,50
06013,2024,28,15,13,46,54,108875,2109,52
06014,2024,7,7,0,0,100,191971,2889,70
06015,2024,15,11,4,27,73,306417,3668,86
06016,2024,16,6,10,62,38,151661,3551,44
06017,2024,4,4,0,0,100,105750,3208,33
06018,2024,107,59,48,45,55,500940,5473,92
06019,2024,25,12,13,52,48,286583,4161,72
06020,2024,10,5,5,50,50,162998,2739,67
06021,2024,8,6,2,25,75,294698,3534,86
06022,2024,11,8,3,27,73,189773,2766,67
06023,2024,40,15,25,62,38,117274,1864,61
06024,2024,3,2,1,33,67,99167,1685,52
06025,2024,10,4,6,60,40,174720,2961,64
06026,2024,19,18,1,5,95,666886,5798,113
06027,2024,853,122,731,86,14,295828,4984,60
06028,2024,11,11,0,0,100,261171,3134,83
06029,2024,2202,78,2124,96,4,384404,6294,58
06030,2024,850,82,768,90,10,283980,4203,64
06031,2024,10,9,1,10,90,293000,2980,104
06032,2024,66,5,61,92,8,463956,8166,56
06033,2024,112,36,76,68,32,310862,4115,77
06034,2024,7,5,2,29,71,326833,3659,95
06035,2024,11,4,7,64,36,310700,4732,65
06036,2024,7,2,5,71,29,218371,3534,60
06037,2024,5,5,0,0,100,310000,3383,95
06038,2024,36,28,8,22,78,1051499,6603,145
06039,2024,10,8,2,20,80,313840,2828,108
06040,2024,2,0,2,100,0,56500,734,78
06041,2024,6,4,2,33,67,136450,1581,87
06042,2024,9,6,3,33,67,113101,2316,51
06043,2024,8,7,1,12,88,199112,2823,72
06044,2024,83,56,27,33,67,772508,5909,121
06045,2024,1,1,0,0,100,75500,2221,34
06046,2024,15,13,2,13,87,376420,4466,88
06047,2024,1,1,0,0,100,60000,500,120
06048,2024,42,32,10,24,76,315008,3697,89
06049,2024,1,1,0,0,100,80000,2500,32
06050,2024,9,9,0,0,100,253188,3848,73
06051,2024,3,0,3,100,0,26000,1066,27
06052,2024,3,3,0,0,100,123667,1284,99
06053,2024,1,1,0,0,100,175000,2500,70
06054,2024,33,16,17,52,48,249012,3717,73
06055,2024,4,1,3,75,25,86250,1647,54
06056,2024,7,4,3,43,57,166709,1850,75
06057,2024,32,8,24,75,25,165881,2861,61
06058,2024,8,7,1,12,88,240412,2774,85
06059,2024,46,12,34,74,26,811928,8684,86
06060,2024,15,11,4,27,73,819476,6046,133
06061,2024,1,1,0,0,100,80000,2105,38
06062,2024,5,1,4,80,20,39660,713,54
06063,2024,2,2,0,0,100,64500,1259,53
06064,2024,38,32,6,16,84,461276,4404,107
06065,2024,45,40,5,11,89,582830,5211,115
06066,2024,19,12,7,37,63,267655,3338,83
06067,2024,15,5,10,67,33,352640,4854,73
06068,2024,4,1,3,75,25,177462,3106,60
06069,2024,710,172,538,76,24,266075,3497,72
06070,2024,31,5,26,84,16,116089,1997,56
06071,2024,22,4,18,82,18,152184,3739,46
06072,2024,2,2,0,0,100,88212,2935,33
06073,2024,112,9,103,92,8,172931,4894,35
06074,2024,31,16,15,48,52,133117,2504,55
06075,2024,47,35,12,26,74,338053,3867,91
06077,2024,18,8,10,56,44,132390,2312,60
06078,2024,4,2,2,50,50,120750,2705,42
06079,2024,728,65,663,91,9,328463,5160,61
06080,2024,1,0,1,100,0,82330,2111,39
06081,2024,5,5,0,0,100,176600,2168,78
06082,2024,2,2,0,0,100,53250,1444,37
06083,2024,852,37,815,96,4,264849,5057,52
06084,2024,118,61,57,48,52,570534,5098,100
06085,2024,281,131,150,53,47,667457,6108,97
06086,2024,15,4,11,73,27,95133,1479,54
06088,2024,6613,249,6364,96,4,298383,5116,58
06089,2024,30,28,2,7,93,966186,6857,142
06090,2024,40,19,21,52,48,374121,4865,75
06091,2024,19,13,6,32,68,345130,4629,71
06092,2024,10,7,3,30,70,267550,2914,86
06093,2024,4,4,0,0,100,258250,3650,70
06094,2024,58,6,52,90,10,217174,4763,48
06095,2024,142,81,61,43,57,344746,4121,80
06096,2024,1,1,0,0,100,40000,833,48
06097,2024,2,1,1,50,50,122500,1945,66
06098,2024,3,3,0,0,100,186333,3540,53
06099,2024,20,10,10,50,50,151578,1753,85
06101,2024,1,0,1,100,0,40000,851,47
06102,2024,4,4,0,0,100,240562,2724,100
06103,2024,21,9,12,57,43,170190,2859,60
06104,2024,406,31,375,92,8,416263,6687,58
06105,2024,78,64,14,18,82,843623,6240,132
06106,2024,14,8,6,43,57,166826,2721,73
06107,2024,1,1,0,0,100,45000,750,60
06108,2024,52,30,22,42,58,427440,4599,90
06109,2024,8,6,2,25,75,251269,3177,80
06110,2024,5,3,2,40,60,138000,2646,51
06111,2024,4,4,0,0,100,133275,1940,60
06112,2024,49,39,10,20,80,665879,5639,114
06113,2024,15,7,8,53,47,269206,3655,77
06114,2024,48,12,36,75,25,259966,3915,65
06115,2024,1,0,1,100,0,18000,720,25
06116,2024,3,2,1,33,67,90750,1351,72
06117,2024,15,11,4,27,73,343340,4469,85
06118,2024,46,42,4,9,91,459852,4549,104
06119,2024,1,1,0,0,100,160000,1143,140
06120,2024,111,7,104,94,6,232598,5890,38
06121,2024,25,3,22,88,12,738573,11420,65
06122,2024,36,28,8,22,78,514536,4638,109
06123,2024,469,38,431,92,8,283917,4880,59
06125,2024,4,3,1,25,75,59000,990,62
06126,2024,23,8,15,65,35,301690,4262,67
06127,2024,34,14,20,59,41,155127,2761,60
06128,2024,44,34,10,23,77,709460,6425,115
06129,2024,10,1,9,90,10,62610,1446,46
06130,2024,55,46,9,16,84,288862,3859,78
06132,2024,13,2,11,85,15,70154,1513,48
06133,2024,3,2,1,33,67,77667,1118,76
06134,2024,16,9,7,44,56,187665,2684,68
06135,2024,7,4,3,43,57,64429,978,58
06136,2024,72,30,42,58,42,233921,3340,73
06137,2024,25,21,4,16,84,613189,4470,123
06138,2024,89,19,70,79,21,589301,7957,65
06140,2024,41,39,2,5,95,502874,4428,115
06141,2024,5,3,2,40,60,270800,2731,90
06142,2024,7,5,2,29,71,106114,3613,39
06143,2024,9,5,4,44,56,164310,2519,68
06144,2024,7,2,5,71,29,113429,2343,57
06145,2024,3,2,1,33,67,103333,1402,69
06146,2024,1,1,0,0,100,280000,3111,90
06147,2024,34,25,9,26,74,383291,4478,86
06148,2024,50,46,4,8,92,913161,6248,146
06149,2024,94,24,70,74,26,252940,3690,68
06150,2024,34,18,16,47,53,741188,6931,97
06151,2024,8,2,6,75,25,105581,1806,55
06152,2024,143,62,81,57,43,470141,5318,82
06153,2024,28,13,15,54,46,170531,2602,64
06154,2024,3,2,1,33,67,104333,2262,49
06155,2024,589,91,498,85,15,338261,4796,63
06156,2024,2,1,1,50,50,122500,1598,75
06157,2024,330,97,233,71,29,362303,4568,74
06158,2024,10,4,6,60,40,155617,2346,73
06159,2024,146,20,126,86,14,735145,8848,75
06160,2024,1,1,0,0,100,130000,2826,46
06161,2024,357,65,292,82,18,382029,6190,61
06162,2024,19,12,7,37,63,83726,1467,67
06163,2024,38,9,29,76,24,88794,1755,50
07001,2024,2,2,0,0,100,127870,920,117
07002,2024,3,3,0,0,100,291933,2636,114
07003,2024,1,1,0,0,100,345680,2305,150
07004,2024,3,3,0,0,100,138833,1855,96
07005,2024,10,10,0,0,100,212648,2367,83
07006,2024,3,3,0,0,100,183307,1506,87
07007,2024,13,13,0,0,100,179214,2019,89
07008,2024,10,9,1,10,90,169320,1846,99
07009,2024,11,7,4,36,64,100039,1385,74
07010,2024,187,57,130,70,30,129898,1483,84
07011,2024,10,10,0,0,100,213104,2632,76
07012,2024,6,6,0,0,100,72542,1354,61
07013,2024,8,8,0,0,100,185668,1931,102
07014,2024,6,6,0,0,100,160500,2303,74
07015,2024,6,6,0,0,100,139583,1546,89
07017,2024,9,9,0,0,100,283141,2288,126
07018,2024,1,1,0,0,100,180800,4018,45
07019,2024,149,52,97,65,35,138299,1841,73
07020,2024,3,3,0,0,100,455667,5552,75
07022,2024,7,7,0,0,100,255723,2118,118
07023,2024,6,6,0,0,100,249768,3084,82
07024,2024,6,5,1,17,83,249333,2361,98
07025,2024,6,6,0,0,100,155083,1175,111
07026,2024,2,2,0,0,100,163000,1904,82
07027,2024,22,20,2,9,91,172307,2086,86
07028,2024,5,4,1,20,80,333400,3613,94
07029,2024,3,3,0,0,100,213000,2091,100
07030,2024,3,3,0,0,100,180000,3015,66
07031,2024,16,14,2,12,88,281743,3059,94
07032,2024,1,1,0,0,100,52800,866,61
07033,2024,4,4,0,0,100,132934,1806,96
07034,2024,1,1,0,0,100,371000,3710,100
07035,2024,11,10,1,9,91,170647,2009,87
07036,2024,6,6,0,0,100,222933,2402,91
07037,2024,2,2,0,0,100,106000,1082,112
07038,2024,1,1,0,0,100,40000,667,60
07039,2024,3,3,0,0,100,163640,1228,129
07040,2024,6,6,0,0,100,196450,1748,119
07041,2024,16,14,2,12,88,200501,2028,97
07042,2024,91,50,41,45,55,146862,1787,86
07044,2024,4,4,0,0,100,179638,2212,92
07045,2024,13,8,5,38,62,130398,1797,78
07048,2024,9,7,2,22,78,149447,2120,70
07050,2024,19,18,1,5,95,263082,2439,108
07051,2024,8,8,0,0,100,150904,1993,78
07052,2024,10,10,0,0,100,180545,1944,95
07053,2024,4,4,0,0,100,323178,2879,114
07054,2024,4,4,0,0,100,121028,1624,74
07055,2024,20,19,1,5,95,247938,2422,99
07056,2024,9,9,0,0,100,239474,2412,100
07058,2024,9,8,1,11,89,241089,3006,84
07059,2024,2,2,0,0,100,190000,2052,94
07060,2024,1,1,0,0,100,470000,2814,167
07061,2024,10,9,1,10,90,207338,2296,94
07062,2024,3,3,0,0,100,137500,1990,75
07063,2024,1,1,0,0,100,171180,2313,74
07064,2024,34,19,15,44,56,92854,1204,74
07065,2024,2,2,0,0,100,161050,1818,84
07066,2024,32,23,9,28,72,212464,2246,92
07068,2024,10,10,0,0,100,131884,1475,86
07069,2024,2,2,0,0,100,193545,2202,100
07070,2024,19,17,2,11,89,280809,2540,112
07071,2024,8,6,2,25,75,130544,1513,82
07072,2024,20,19,1,5,95,205074,1969,104
07073,2024,4,4,0,0,100,120632,1881,76
07074,2024,1,1,0,0,100,200900,2160,93
07075,2024,3,2,1,33,67,94500,1401,68
07076,2024,25,17,8,32,68,161881,1905,85
07077,2024,3,3,0,0,100,210817,2174,105
07078,2024,35,28,7,20,80,209745,2216,95
07079,2024,9,8,1,11,89,172425,2030,98
07080,2024,4,4,0,0,100,71125,895,82
07081,2024,1,1,0,0,100,186360,1035,180
07083,2024,9,9,0,0,100,183168,2031,95
07084,2024,8,8,0,0,100,240500,2271,98
07085,2024,5,5,0,0,100,66531,1021,63
07086,2024,3,3,0,0,100,143000,1961,67
07087,2024,4,4,0,0,100,216825,2152,92
07088,2024,2,2,0,0,100,102020,2774,38
07089,2024,11,8,3,27,73,186455,1797,104
07090,2024,9,8,1,11,89,175772,2228,81
07092,2024,2,2,0,0,100,74000,914,102
07093,2024,9,9,0,0,100,190487,2146,91
07094,2024,3,3,0,0,100,176350,2273,74
07095,2024,7,7,0,0,100,287711,2537,116
07096,2024,4,4,0,0,100,178148,1696,93
07097,2024,4,4,0,0,100,190300,2142,87
07098,2024,2,2,0,0,100,168825,1359,123
07099,2024,6,6,0,0,100,350492,3514,106
07100,2024,6,6,0,0,100,188011,2778,78
07101,2024,9,8,1,11,89,224470,3056,81
07102,2024,164,56,108,66,34,201611,2549,78
07103,2024,12,11,1,8,92,103852,1434,83
07104,2024,1,1,0,0,100,210000,2658,79
07105,2024,2,2,0,0,100,69000,847,85
07106,2024,2,2,0,0,100,97925,1286,75
07107,2024,12,10,2,17,83,203975,2060,99
07109,2024,8,5,3,38,62,137456,1526,82
07110,2024,31,19,12,39,61,168453,2059,80
07111,2024,2,1,1,50,50,71900,696,88
07112,2024,5,5,0,0,100,118800,1376,84
07113,2024,4,4,0,0,100,478200,2463,177
07114,2024,1,1,0,0,100,75000,1293,58
07115,2024,7,7,0,0,100,310663,3558,90
07116,2024,14,9,5,36,64,104721,1657,60
07117,2024,27,26,1,4,96,233969,2448,96
07118,2024,2,2,0,0,100,154750,1298,132
07119,2024,4,4,0,0,100,203638,1548,141
07120,2024,1,1,0,0,100,150000,1154,130
07121,2024,3,3,0,0,100,150583,1677,91
07122,2024,7,5,2,29,71,316683,3504,96
07123,2024,2,2,0,0,100,102500,1958,50
07124,2024,1,1,0,0,100,188000,2938,64
07126,2024,14,13,1,7,93,215791,2588,92
07127,2024,14,12,2,14,86,144143,1674,94
07128,2024,12,5,7,58,42,80816,1087,78
07129,2024,23,17,6,26,74,120408,1497,83
07130,2024,2,2,0,0,100,201000,1716,150
07131,2024,6,6,0,0,100,178246,1830,93
07132,2024,13,9,4,31,69,155112,1602,90
07133,2024,2,2,0,0,100,143850,1306,85
07134,2024,2,2,0,0,100,237500,2600,90
07136,2024,1,1,0,0,100,133000,2145,62
07138,2024,12,11,1,8,92,178408,2307,78
07139,2024,3,2,1,33,67,103853,2136,52
07140,2024,2,2,0,0,100,198750,1688,116
07141,2024,3,3,0,0,100,227590,3258,71
07142,2024,3,3,0,0,100,126837,1216,91
07143,2024,8,8,0,0,100,181600,1844,97
07144,2024,1,1,0,0,100,43489,906,48
07145,2024,5,5,0,0,100,225280,2127,107
07146,2024,6,6,0,0,100,165217,2171,78
07147,2024,9,9,0,0,100,167354,2452,63
07148,2024,6,6,0,0,100,196417,2678,76
07149,2024,4,4,0,0,100,136562,1390,107
07150,2024,3,3,0,0,100,147000,1646,87
07151,2024,5,5,0,0,100,194159,2408,81
07152,2024,10,8,2,20,80,169370,2042,85
07153,2024,9,9,0,0,100,108578,1144,90
07154,2024,1,1,0,0,100,290000,4143,70
07155,2024,8,8,0,0,100,277016,2297,119
07156,2024,14,12,2,14,86,121946,2107,61
07157,2024,5,4,1,20,80,149470,1962,76
07158,2024,2,2,0,0,100,36250,826,48
07159,2024,6,6,0,0,100,248400,2657,93
07161,2024,13,11,2,15,85,165055,2495,70
07162,2024,11,10,1,9,91,184895,3010,75
07163,2024,2,2,0,0,100,77925,1182,81
07165,2024,11,11,0,0,100,129085,1466,89
07166,2024,4,4,0,0,100,197480,2381,75
07167,2024,13,12,1,8,92,228914,2097,109
07168,2024,17,17,0,0,100,385753,3249,122
07169,2024,3,3,0,0,100,183333,2687,70
07170,2024,8,8,0,0,100,190531,1774,109
07171,2024,9,8,1,11,89,221556,2873,100
07172,2024,16,15,1,6,94,252779,2545,101
07173,2024,1,1,0,0,100,40000,1333,30
07174,2024,4,4,0,0,100,178500,2065,86
07176,2024,2,2,0,0,100,256750,3576,78
07177,2024,10,10,0,0,100,203320,2261,106
07178,2024,13,12,1,8,92,144998,1865,75
07179,2024,3,3,0,0,100,78333,1090,73
07181,2024,22,17,5,23,77,176550,2238,82
07182,2024,10,9,1,10,90,196355,2236,89
07183,2024,6,6,0,0,100,189167,3078,66
07184,2024,4,4,0,0,100,183988,1970,94
07185,2024,6,6,0,0,100,118343,2133,62
07186,2024,90,38,52,58,42,141985,1655,84
07187,2024,1,1,0,0,100,203000,1933,105
07188,2024,9,9,0,0,100,156258,2256,70
07189,2024,2,2,0,0,100,245000,2895,102
07190,2024,2,2,0,0,100,301784,4135,72
07191,2024,16,16,0,0,100,230431,2190,106
07192,2024,2,2,0,0,100,145750,2242,68
07193,2024,2,2,0,0,100,117500,1445,82
07194,2024,5,5,0,0,100,181025,2036,95
07195,2024,1,1,0,0,100,72000,1800,40
07197,2024,24,24,0,0,100,207550,2056,102
07198,2024,13,13,0,0,100,211675,2079,96
07199,2024,14,14,0,0,100,227281,2081,111
07200,2024,1,0,1,100,0,158513,2402,66
07201,2024,45,32,13,29,71,172129,2544,67
07202,2024,3,3,0,0,100,170460,1620,111
07203,2024,2,2,0,0,100,150450,3390,50
07204,2024,24,22,2,8,92,151893,1857,89
07205,2024,7,7,0,0,100,196307,2143,96
07207,2024,16,15,1,6,94,245694,3157,77
07208,2024,1,1,0,0,100,280000,2154,130
07210,2024,6,6,0,0,100,141555,1832,75
07211,2024,6,6,0,0,100,281748,2122,130
07212,2024,1,1,0,0,100,216200,1138,190
07213,2024,2,2,0,0,100,87175,1458,59
07214,2024,7,7,0,0,100,191065,1894,89
07215,2024,5,5,0,0,100,86000,1279,66
07216,2024,7,7,0,0,100,114729,1670,72
07217,2024,12,12,0,0,100,160552,2096,83
07218,2024,8,8,0,0,100,203057,2304,96
07219,2024,1,1,0,0,100,362500,2627,138
07220,2024,2,2,0,0,100,82100,1122,68
07221,2024,3,3,0,0,100,128200,1207,111
07222,2024,4,4,0,0,100,183750,2860,90
07224,2024,4,4,0,0,100,104095,1782,56
07225,2024,9,9,0,0,100,264550,2317,115
07227,2024,8,8,0,0,100,265188,2658,100
07228,2024,6,6,0,0,100,202597,1976,101
07229,2024,3,3,0,0,100,171957,2194,82
07230,2024,5,5,0,0,100,171280,2143,82
07231,2024,16,16,0,0,100,234297,2211,112
07232,2024,9,9,0,0,100,102056,1262,102
07233,2024,5,5,0,0,100,196600,2268,105
07234,2024,4,4,0,0,100,74250,1125,83
07235,2024,2,2,0,0,100,175450,1847,94
07236,2024,10,9,1,10,90,188551,1924,102
07237,2024,6,6,0,0,100,167150,1851,87
07238,2024,6,6,0,0,100,267314,3168,86
07239,2024,3,3,0,0,100,119500,1597,82
07240,2024,18,18,0,0,100,311105,2712,115
07241,2024,5,5,0,0,100,262906,2688,106
07242,2024,2,2,0,0,100,95000,1362,60
07243,2024,1,1,0,0,100,85000,1328,64
07244,2024,2,2,0,0,100,176550,2032,110
07245,2024,17,14,3,18,82,188671,2104,93
07247,2024,8,7,1,12,88,184875,2382,81
07248,2024,4,4,0,0,100,161610,1446,106
07249,2024,2,2,0,0,100,75000,1314,67
07250,2024,5,4,1,20,80,153460,1939,76
07251,2024,2,2,0,0,100,264665,2300,114
07253,2024,1,0,1,100,0,171000,3420,50
07254,2024,7,7,0,0,100,245556,3059,89
07255,2024,15,15,0,0,100,183177,2277,80
07257,2024,3,3,0,0,100,179533,1717,113
07258,2024,7,5,2,29,71,126490,2259,56
07259,2024,12,11,1,8,92,172580,2091,92
07260,2024,3,3,0,0,100,239800,2547,93
07261,2024,18,18,0,0,100,182940,2178,90
07262,2024,5,5,0,0,100,68720,1274,54
07263,2024,1,1,0,0,100,150000,1667,90
07264,2024,21,21,0,0,100,255116,2658,101
07265,2024,6,5,1,17,83,155217,1624,91
07266,2024,2,2,0,0,100,75000,1018,62
07267,2024,4,4,0,0,100,112520,2105,56
07268,2024,15,13,2,13,87,187348,3632,65
07269,2024,15,10,5,33,67,90466,1143,79
07270,2024,1,1,0,0,100,190000,4043,47
07272,2024,1,1,0,0,100,295000,4214,70
07273,2024,2,2,0,0,100,396700,3922,92
07274,2024,2,2,0,0,100,184000,2054,90
07275,2024,3,3,0,0,100,209333,1970,91
07276,2024,1,1,0,0,100,29500,590,50
07277,2024,1,1,0,0,100,205550,1958,105
07278,2024,7,6,1,14,86,195057,2612,78
07279,2024,22,22,0,0,100,248498,2362,108
07280,2024,10,9,1,10,90,201021,2380,86
07281,2024,79,52,27,34,66,277522,2961,95
07282,2024,1,1,0,0,100,35000,1000,35
07283,2024,1,1,0,0,100,530000,2304,230
07284,2024,4,4,0,0,100,307000,3661,83
07285,2024,1,1,0,0,100,116950,2339,50
07286,2024,4,4,0,0,100,168085,1528,104
07287,2024,3,3,0,0,100,148750,2142,66
07288,2024,3,3,0,0,100,291978,2540,117
07289,2024,15,14,1,7,93,205519,2201,99
07290,2024,3,3,0,0,100,86667,709,123
07291,2024,14,12,2,14,86,232334,2306,98
07292,2024,5,5,0,0,100,185866,1909,86
07293,2024,10,10,0,0,100,260174,2295,116
07294,2024,5,4,1,20,80,251630,2710,91
07295,2024,6,6,0,0,100,120919,1888,67
07296,2024,11,11,0,0,100,213745,2621,85
07297,2024,4,4,0,0,100,158662,1620,98
07298,2024,4,4,0,0,100,249000,2081,120
07299,2024,1,1,0,0,100,157330,1851,85
07300,2024,8,8,0,0,100,266228,2494,112
07301,2024,10,10,0,0,100,201311,1798,113
07302,2024,4,4,0,0,100,302343,2518,120
07303,2024,2,2,0,0,100,173525,1838,90
07304,2024,23,14,9,39,61,193310,2527,76
07305,2024,7,7,0,0,100,272169,3125,92
07306,2024,1,1,0,0,100,138700,2522,55
07307,2024,3,3,0,0,100,354033,3742,88
07308,2024,24,23,1,4,96,195288,2088,96
07309,2024,18,12,6,33,67,120027,1594,74
07310,2024,8,8,0,0,100,243462,2228,113
07311,2024,1,1,0,0,100,160000,1455,110
07312,2024,6,6,0,0,100,246342,2373,108
07313,2024,19,15,4,21,79,99058,1606,61
07314,2024,11,11,0,0,100,254779,2608,94
07315,2024,6,6,0,0,100,204492,2298,90
07316,2024,38,23,15,39,61,250537,2757,92
07317,2024,5,5,0,0,100,265800,2579,105
07319,2024,91,58,33,36,64,152712,1768,87
07321,2024,1,1,0,0,100,200000,1887,106
07322,2024,26,23,3,12,88,150973,1892,83
07323,2024,14,14,0,0,100,309410,2653,121
07324,2024,128,58,70,55,45,180150,2226,83
07325,2024,19,17,2,11,89,231522,2513,100
07326,2024,5,5,0,0,100,161410,6116,42
07327,2024,4,4,0,0,100,242920,2449,99
07328,2024,2,2,0,0,100,282228,1887,140
07329,2024,10,10,0,0,100,132681,1774,78
07330,2024,45,41,4,9,91,248884,2918,88
07331,2024,58,26,32,55,45,142678,1857,77
07332,2024,4,4,0,0,100,95852,1093,90
07333,2024,6,6,0,0,100,126813,1671,70
07334,2024,33,23,10,30,70,272898,2968,90
07335,2024,2,2,0,0,100,167250,1796,81
07336,2024,2,2,0,0,100,295400,2092,146
07337,2024,14,14,0,0,100,269300,2378,109
07338,2024,16,16,0,0,100,182019,1921,102
07339,2024,19,19,0,0,100,237649,2412,103
07340,2024,15,13,2,13,87,215288,2135,102
07341,2024,31,22,9,29,71,184783,2005,92
07342,2024,16,16,0,0,100,175906,1976,92
07343,2024,14,12,2,14,86,256273,2713,102
07344,2024,5,5,0,0,100,280094,2819,99
07345,2024,5,5,0,0,100,198960,2199,91
07346,2024,37,29,8,22,78,156544,1748,89
07347,2024,7,4,3,43,57,117493,1506,76
07348,2024,11,9,2,18,82,209514,2499,82
07349,2024,56,33,23,41,59,137050,1821,76
08001,2024,4,4,0,0,100,217750,1934,113
08003,2024,25,25,0,0,100,192899,1892,106
08004,2024,2,2,0,0,100,143500,1254,115
08005,2024,2,2,0,0,100,215000,1269,134
08006,2024,4,4,0,0,100,71250,592,124
08008,2024,9,8,1,11,89,137292,1488,92
08010,2024,1,1,0,0,100,66500,1188,56
08011,2024,2,2,0,0,100,114125,1527,74
08013,2024,1,1,0,0,100,120000,1818,66
08016,2024,1,1,0,0,100,59000,756,78
08017,2024,2,2,0,0,100,80300,594,148
08018,2024,2,2,0,0,100,107500,862,125
08019,2024,1,1,0,0,100,175000,1094,160
08020,2024,1,1,0,0,100,90000,600,150
08021,2024,2,2,0,0,100,125000,1076,110
08022,2024,1,1,0,0,100,80000,656,122
08024,2024,13,13,0,0,100,172238,2016,103
08025,2024,16,15,1,6,94,122281,1190,117
08026,2024,4,4,0,0,100,123638,1230,110
08027,2024,3,3,0,0,100,131717,1145,116
08028,2024,7,7,0,0,100,134286,1369,103
08029,2024,1,1,0,0,100,55000,1375,40
08030,2024,1,1,0,0,100,145000,967,150
08031,2024,1,1,0,0,100,120000,670,179
08032,2024,5,5,0,0,100,201020,1927,132
08033,2024,2,2,0,0,100,100000,900,111
08034,2024,5,5,0,0,100,109200,1105,109
08035,2024,1,1,0,0,100,140000,933,150
08037,2024,10,9,1,10,90,141400,1325,109
08038,2024,1,1,0,0,100,179700,1190,151
08039,2024,5,5,0,0,100,84320,1667,79
08040,2024,6,4,2,33,67,147667,1551,91
08043,2024,20,15,5,25,75,120726,1379,87
08044,2024,3,3,0,0,100,107271,1518,80
08046,2024,1,1,0,0,100,150000,1456,103
08048,2024,4,4,0,0,100,157462,1968,80
08049,2024,2,2,0,0,100,110000,1108,100
08052,2024,2,2,0,0,100,82500,1900,45
08053,2024,19,18,1,5,95,165778,1613,103
08055,2024,5,5,0,0,100,125850,1429,112
08057,2024,1,1,0,0,100,65000,500,130
08058,2024,3,3,0,0,100,140667,1506,91
08060,2024,1,1,0,0,100,245000,1310,187
08061,2024,1,1,0,0,100,75000,625,120
08062,2024,1,1,0,0,100,170000,1932,88
08063,2024,2,2,0,0,100,157500,1300,118
08064,2024,3,3,0,0,100,243117,2222,112
08066,2024,3,3,0,0,100,143433,1004,142
08067,2024,12,10,2,17,83,124000,1398,93
08069,2024,1,1,0,0,100,150000,1389,108
08070,2024,2,2,0,0,100,135350,1848,72
08073,2024,1,1,0,0,100,326750,2513,130
08075,2024,5,5,0,0,100,58500,650,94
08076,2024,13,13,0,0,100,129945,1275,108
08077,2024,2,2,0,0,100,107000,848,124
08078,2024,13,13,0,0,100,117869,1280,92
08081,2024,61,56,5,8,92,91419,1192,76
08083,2024,5,5,0,0,100,116400,1003,113
08084,2024,3,3,0,0,100,155953,2099,81
08085,2024,2,2,0,0,100,95250,972,98
08086,2024,1,1,0,0,100,65000,684,95
08087,2024,1,1,0,0,100,141200,1345,105
08088,2024,1,1,0,0,100,185250,926,200
08089,2024,6,6,0,0,100,108000,888,137
08090,2024,24,19,5,21,79,127599,1326,104
08092,2024,1,1,0,0,100,222000,1805,123
08095,2024,1,1,0,0,100,130000,520,250
08096,2024,6,6,0,0,100,251733,2061,128
08097,2024,5,5,0,0,100,107140,1042,104
08100,2024,1,1,0,0,100,21450,794,27
08101,2024,3,3,0,0,100,215500,1356,154
08103,2024,3,3,0,0,100,112400,1290,86
08104,2024,1,1,0,0,100,106000,679,156
08105,2024,470,209,261,56,44,117878,1504,79
08107,2024,9,9,0,0,100,145944,1369,112
08109,2024,3,3,0,0,100,122000,971,134
08110,2024,4,4,0,0,100,119250,1206,111
08111,2024,4,4,0,0,100,282175,2176,127
08115,2024,6,6,0,0,100,138500,893,175
08116,2024,9,9,0,0,100,129611,1153,116
08117,2024,1,1,0,0,100,138000,719,192
08119,2024,1,1,0,0,100,154000,1510,102
08120,2024,1,1,0,0,100,164400,790,208
08121,2024,2,2,0,0,100,90000,1275,85
08122,2024,8,8,0,0,100,180875,1845,96
08123,2024,1,1,0,0,100,223000,2230,100
08124,2024,2,2,0,0,100,127331,928,132
08125,2024,6,6,0,0,100,168317,1536,108
08128,2024,2,2,0,0,100,59000,764,76
08131,2024,1,1,0,0,100,55000,632,87
08132,2024,1,1,0,0,100,45000,479,94
08133,2024,4,4,0,0,100,118875,1270,101
08135,2024,1,1,0,0,100,35000,538,65
08136,2024,1,1,0,0,100,278000,1716,162
08137,2024,1,1,0,0,100,311500,1684,185
08139,2024,12,12,0,0,100,69688,799,89
08140,2024,11,11,0,0,100,124618,1251,101
08141,2024,2,2,0,0,100,86000,784,108
08142,2024,14,9,5,36,64,137886,1677,79
08144,2024,1,1,0,0,100,166600,1165,143
08145,2024,20,20,0,0,100,119277,1267,93
08147,2024,1,1,0,0,100,127000,941,135
08148,2024,2,2,0,0,100,282500,1634,185
08149,2024,1,1,0,0,100,90000,744,121
08150,2024,2,2,0,0,100,134500,1114,121
08151,2024,4,4,0,0,100,75125,856,96
08153,2024,1,1,0,0,100,30000,333,90
08154,2024,2,2,0,0,100,74250,847,85
08156,2024,10,10,0,0,100,145764,1106,141
08158,2024,4,4,0,0,100,132500,1112,113
08160,2024,2,2,0,0,100,166150,2101,86
08162,2024,7,7,0,0,100,175957,1741,102
08163,2024,1,1,0,0,100,157000,1510,104
08164,2024,2,2,0,0,100,66000,893,64
08166,2024,3,3,0,0,100,135167,1420,94
08168,2024,2,2,0,0,100,36000,489,75
08169,2024,3,3,0,0,100,78224,1059,74
08170,2024,3,3,0,0,100,144833,1699,88
08171,2024,1,1,0,0,100,70000,424,165
08172,2024,1,1,0,0,100,217000,1561,139
08173,2024,12,12,0,0,100,132137,1286,109
08174,2024,18,17,1,6,94,130667,1446,97
08175,2024,4,4,0,0,100,218750,1977,107
08178,2024,1,1,0,0,100,95000,613,155
08179,2024,6,6,0,0,100,160750,1388,117
08180,2024,12,11,1,8,92,172388,1721,102
08182,2024,1,1,0,0,100,202255,1759,115
08183,2024,12,12,0,0,100,144283,1688,86
08184,2024,3,3,0,0,100,75833,1067,67
08185,2024,40,36,4,10,90,73333,966,76
08187,2024,2,2,0,0,100,105000,1003,92
08188,2024,6,6,0,0,100,112875,1206,98
08190,2024,52,43,9,17,83,134851,1353,98
08191,2024,9,9,0,0,100,144611,1453,99
08193,2024,5,5,0,0,100,102400,1053,92
08194,2024,3,3,0,0,100,175000,1230,140
08196,2024,2,2,0,0,100,83750,982,85
08198,2024,4,4,0,0,100,85500,947,91
08199,2024,8,8,0,0,100,201044,1609,124
08200,2024,2,2,0,0,100,55246,794,72
08202,2024,7,7,0,0,100,151393,1712,91
08203,2024,6,6,0,0,100,109083,1614,84
08205,2024,1,1,0,0,100,105000,1154,91
08206,2024,4,4,0,0,100,118575,1238,92
08207,2024,2,2,0,0,100,196500,1498,122
08208,2024,3,3,0,0,100,96667,871,112
08209,2024,3,3,0,0,100,140077,1296,108
08211,2024,4,4,0,0,100,110500,1138,93
08212,2024,8,8,0,0,100,138469,1127,126
08214,2024,5,5,0,0,100,136200,971,131
08215,2024,1,1,0,0,100,97000,1054,92
08216,2024,5,3,2,40,60,211022,1962,93
08217,2024,3,3,0,0,100,91167,1118,91
08218,2024,17,17,0,0,100,89265,1024,85
08219,2024,1,1,0,0,100,190000,1696,112
08220,2024,6,6,0,0,100,122217,1562,78
08222,2024,19,19,0,0,100,113389,1339,80
08223,2024,2,2,0,0,100,80000,958,82
08225,2024,1,1,0,0,100,145000,2014,72
08226,2024,1,1,0,0,100,180000,1636,110
08228,2024,3,3,0,0,100,205767,1955,104
08229,2024,1,1,0,0,100,173600,2067,84
08230,2024,1,1,0,0,100,110000,1594,69
08232,2024,6,6,0,0,100,134069,1262,102
08233,2024,1,1,0,0,100,110000,598,184
08234,2024,3,3,0,0,100,181667,2128,93
08235,2024,2,2,0,0,100,132500,2083,88
08236,2024,2,2,0,0,100,190368,1270,146
08237,2024,10,10,0,0,100,115120,1225,100
08239,2024,10,10,0,0,100,189922,1614,121
08242,2024,1,1,0,0,100,192900,1484,130
08243,2024,1,1,0,0,100,59000,702,84
08245,2024,1,1,0,0,100,197455,806,245
08246,2024,3,3,0,0,100,59182,589,99
08247,2024,3,3,0,0,100,165333,1767,100
08248,2024,3,3,0,0,100,100333,967,118
08249,2024,4,4,0,0,100,120000,1386,90
08250,2024,2,2,0,0,100,139750,1073,126
08254,2024,4,4,0,0,100,56750,615,93
08255,2024,2,2,0,0,100,87000,870,93
08256,2024,2,2,0,0,100,96190,854,112
08257,2024,1,1,0,0,100,289900,1611,180
08259,2024,2,2,0,0,100,53500,462,111
08260,2024,5,5,0,0,100,193400,1641,129
08262,2024,8,8,0,0,100,137931,1634,90
08263,2024,5,5,0,0,100,149700,1791,84
08264,2024,5,5,0,0,100,142400,1282,109
08268,2024,1,1,0,0,100,135000,1350,100
08274,2024,2,2,0,0,100,68500,488,142
08275,2024,7,7,0,0,100,114159,1159,94
08276,2024,5,4,1,20,80,125724,1942,93
08277,2024,1,1,0,0,100,120000,1188,101
08278,2024,3,3,0,0,100,120667,939,126
08280,2024,1,1,0,0,100,80000,556,144
08281,2024,6,6,0,0,100,118333,1345,101
08282,2024,14,14,0,0,100,111806,1486,94
08283,2024,2,2,0,0,100,71250,802,87
08284,2024,18,18,0,0,100,125701,1176,101
08287,2024,1,1,0,0,100,120000,784,153
08289,2024,8,8,0,0,100,144250,1182,109
08293,2024,2,2,0,0,100,100000,632,149
08296,2024,3,3,0,0,100,83000,763,108
08297,2024,4,4,0,0,100,140700,1204,114
08298,2024,10,10,0,0,100,155952,1610,90
08301,2024,1,1,0,0,100,135000,2872,47
08302,2024,15,15,0,0,100,95277,1085,87
08303,2024,2,2,0,0,100,73000,740,106
08305,2024,2,2,0,0,100,98500,776,113
08307,2024,1,1,0,0,100,190000,1418,134
08308,2024,1,1,0,0,100,85000,518,164
08309,2024,1,1,0,0,100,225000,2009,112
08310,2024,5,5,0,0,100,68230,801,84
08311,2024,25,24,1,4,96,109838,1199,94
08312,2024,4,4,0,0,100,240100,2060,150
08313,2024,3,3,0,0,100,140700,1343,98
08314,2024,9,9,0,0,100,230424,2114,118
08316,2024,12,12,0,0,100,103508,1200,86
08317,2024,1,1,0,0,100,87000,798,109
08318,2024,5,5,0,0,100,154312,1221,131
08319,2024,5,5,0,0,100,126350,1035,128
08320,2024,8,8,0,0,100,192388,1550,136
08322,2024,4,4,0,0,100,159250,1722,89
08323,2024,1,1,0,0,100,208000,1926,108
08324,2024,1,1,0,0,100,224304,4578,49
08326,2024,5,5,0,0,100,76159,1042,69
08327,2024,9,8,1,11,89,157889,1658,99
08328,2024,50,43,7,14,86,95361,1221,80
08330,2024,10,10,0,0,100,159275,1158,137
08331,2024,9,9,0,0,100,116478,1251,95
08333,2024,2,2,0,0,100,105750,907,120
08334,2024,1,1,0,0,100,110000,1100,100
08335,2024,1,1,0,0,100,160000,1553,103
08336,2024,1,1,0,0,100,330000,1315,251
08339,2024,4,4,0,0,100,179538,1938,94
08340,2024,1,1,0,0,100,237000,1222,194
08341,2024,6,5,1,17,83,152977,2032,85
08342,2024,3,3,0,0,100,107333,835,124
08343,2024,8,7,1,12,88,145375,987,141
08344,2024,1,1,0,0,100,45000,378,119
08346,2024,8,8,0,0,100,225180,1911,117
08347,2024,5,5,0,0,100,132160,1139,109
08349,2024,2,2,0,0,100,141150,1507,86
08351,2024,1,1,0,0,100,91000,623,146
08352,2024,1,1,0,0,100,166000,1627,102
08353,2024,10,10,0,0,100,195300,1608,118
08354,2024,11,11,0,0,100,104427,1165,95
08355,2024,4,4,0,0,100,168250,1541,86
08356,2024,1,1,0,0,100,80000,516,155
08357,2024,7,7,0,0,100,86000,957,105
08361,2024,17,17,0,0,100,119871,1480,89
08362,2024,58,43,15,26,74,133884,1644,82
08363,2024,56,55,1,2,98,98340,1137,85
08364,2024,2,2,0,0,100,77500,677,110
08365,2024,9,8,1,11,89,147433,1126,139
08366,2024,10,10,0,0,100,114900,1157,98
08367,2024,27,26,1,4,96,124675,1411,92
08368,2024,1,1,0,0,100,176900,1638,108
08369,2024,2,2,0,0,100,51000,750,70
08370,2024,5,5,0,0,100,122120,1188,119
08372,2024,2,2,0,0,100,94000,1118,95
08373,2024,3,3,0,0,100,70400,559,126
08374,2024,1,1,0,0,100,140000,1892,74
08375,2024,2,2,0,0,100,127350,1505,85
08376,2024,2,2,0,0,100,116000,1714,68
08378,2024,1,1,0,0,100,167000,770,217
08380,2024,2,2,0,0,100,109950,885,128
08381,2024,11,11,0,0,100,119818,1256,93
08382,2024,5,5,0,0,100,81694,1117,69
08383,2024,3,3,0,0,100,105000,1182,88
08384,2024,2,2,0,0,100,78500,638,123
08385,2024,10,8,2,20,80,143350,1350,94
08386,2024,2,2,0,0,100,161550,1403,124
08388,2024,4,4,0,0,100,173275,1316,112
08389,2024,3,3,0,0,100,135000,944,155
08390,2024,4,4,0,0,100,85350,776,121
08391,2024,14,14,0,0,100,115036,1284,93
08392,2024,2,2,0,0,100,122300,1304,94
08393,2024,3,3,0,0,100,75333,1021,94
08394,2024,2,2,0,0,100,120000,864,139
08395,2024,1,1,0,0,100,172000,1773,97
08396,2024,1,1,0,0,100,171300,1071,160
08398,2024,1,1,0,0,100,145000,1066,136
08399,2024,3,3,0,0,100,120000,1220,81
08400,2024,6,6,0,0,100,130233,1334,104
08401,2024,2,2,0,0,100,68046,486,140
08402,2024,12,12,0,0,100,135728,1393,102
08403,2024,10,10,0,0,100,151640,1591,98
08405,2024,3,3,0,0,100,171000,1340,130
08406,2024,4,4,0,0,100,155220,1180,119
08408,2024,1,1,0,0,100,160300,1471,109
08409,2024,186,71,115,62,38,91059,1110,82
08411,2024,2,2,0,0,100,79000,1036,74
08412,2024,2,2,0,0,100,102000,764,133
08415,2024,4,4,0,0,100,83375,844,94
08416,2024,3,3,0,0,100,128283,1460,84
08417,2024,1,1,0,0,100,187000,2493,75
08418,2024,1,1,0,0,100,65000,1548,42
08419,2024,12,12,0,0,100,104833,1125,87
08420,2024,25,25,0,0,100,76726,1073,81
08421,2024,1,1,0,0,100,115000,958,120
08424,2024,2,2,0,0,100,45000,576,78
08427,2024,2,2,0,0,100,115000,608,189
08428,2024,1,1,0,0,100,103000,936,110
08429,2024,2,2,0,0,100,90250,918,116
08431,2024,1,1,0,0,100,55000,753,73
08432,2024,3,3,0,0,100,105667,1180,102
08435,2024,7,7,0,0,100,194938,1535,138
08436,2024,2,2,0,0,100,230000,1404,166
08437,2024,2,2,0,0,100,137675,983,140
08438,2024,1,1,0,0,100,142900,1143,125
08439,2024,2,2,0,0,100,187300,938,190
08440,2024,1,1,0,0,100,73400,992,74
08444,2024,1,1,0,0,100,62000,620,100
08445,2024,6,6,0,0,100,116333,895,104
08448,2024,16,16,0,0,100,93318,1495,82
08449,2024,8,8,0,0,100,74906,781,102
08450,2024,2,2,0,0,100,140800,1482,96
08451,2024,4,4,0,0,100,138900,1470,98
08452,2024,3,3,0,0,100,182567,1839,99
08453,2024,1,1,0,0,100,60000,517,116
08454,2024,1,1,0,0,100,54750,421,130
08455,2024,1,1,0,0,100,77500,1292,60
08456,2024,3,3,0,0,100,172333,2055,83
08457,2024,9,8,1,11,89,174289,1495,128
08458,2024,3,3,0,0,100,64833,571,122
08459,2024,3,3,0,0,100,59500,702,80
08460,2024,2,2,0,0,100,182500,1608,118
08461,2024,5,5,0,0,100,50300,778,60
08462,2024,3,3,0,0,100,98500,1138,90
08464,2024,1,1,0,0,100,100000,602,166
08466,2024,1,1,0,0,100,33000,440,75
08467,2024,1,1,0,0,100,100000,1282,78
08468,2024,3,3,0,0,100,150733,767,202
08469,2024,5,5,0,0,100,115100,948,136
08470,2024,1,1,0,0,100,120000,667,180
08473,2024,4,4,0,0,100,150475,1717,93
08476,2024,6,6,0,0,100,136883,1774,79
08478,2024,2,2,0,0,100,148500,1295,115
08479,2024,1,1,0,0,100,195390,846,231
08480,2024,25,24,1,4,96,138549,1524,92
08481,2024,2,2,0,0,100,110375,841,138
08482,2024,1,1,0,0,100,271000,1168,232
08483,2024,4,3,1,25,75,214325,1715,129
08484,2024,1,1,0,0,100,169000,1261,134
08485,2024,2,2,0,0,100,100900,1214,83
08486,2024,25,25,0,0,100,116780,1311,90
08487,2024,26,26,0,0,100,134962,1482,95
08488,2024,27,26,1,4,96,125352,1356,92
08490,2024,49,46,3,6,94,109721,994,110
08491,2024,32,31,1,3,97,144398,1619,92
08492,2024,1,1,0,0,100,132000,795,166
08494,2024,8,8,0,0,100,112862,1244,100
08496,2024,1,1,0,0,100,182000,1767,103
08497,2024,21,21,0,0,100,171440,1876,93
08498,2024,2,2,0,0,100,236425,1408,178
08501,2024,1,1,0,0,100,215000,2337,92
08502,2024,1,1,0,0,100,100000,508,197
09002,2024,5,5,0,0,100,347079,2687,114
09003,2024,5,5,0,0,100,114460,1220,96
09004,2024,2,2,0,0,100,195000,1770,110
09005,2024,4,4,0,0,100,152838,1979,83
09006,2024,1,1,0,0,100,50000,2381,21
09008,2024,8,8,0,0,100,128496,1760,76
09009,2024,4,4,0,0,100,126750,1363,96
09011,2024,2,2,0,0,100,112675,1495,65
09014,2024,4,4,0,0,100,120624,1184,100
09015,2024,7,7,0,0,100,128200,1508,83
09016,2024,2,2,0,0,100,265500,2568,105
09017,2024,5,5,0,0,100,152870,1507,84
09018,2024,4,4,0,0,100,107700,1212,82
09019,2024,12,12,0,0,100,191663,1644,114
09021,2024,1,1,0,0,100,130000,1327,98
09022,2024,3,3,0,0,100,151033,1504,106
09023,2024,6,6,0,0,100,152492,1786,93
09024,2024,2,2,0,0,100,216350,1816,122
09026,2024,5,5,0,0,100,95628,1732,64
09027,2024,2,2,0,0,100,98105,1421,73
09029,2024,21,3,18,86,14,56989,1335,40
09030,2024,5,4,1,20,80,103408,1066,93
09032,2024,71,14,57,80,20,113720,2545,47
09034,2024,2,2,0,0,100,123398,1890,88
09035,2024,5,5,0,0,100,94900,941,97
09037,2024,1,1,0,0,100,76000,884,86
09038,2024,8,8,0,0,100,77675,1156,67
09039,2024,6,6,0,0,100,94490,1202,73
09040,2024,4,4,0,0,100,174500,2318,78
09041,2024,3,3,0,0,100,128083,1128,119
09042,2024,11,11,0,0,100,181585,1901,99
09043,2024,16,12,4,25,75,102819,1281,79
09044,2024,2,2,0,0,100,207575,2097,99
09046,2024,1,1,0,0,100,456000,2815,162
09047,2024,12,10,2,17,83,122233,1231,104
09049,2024,4,4,0,0,100,203352,1691,108
09050,2024,4,3,1,25,75,249325,2042,123
09051,2024,1,1,0,0,100,120000,1500,80
09054,2024,5,5,0,0,100,143880,1648,92
09055,2024,5,5,0,0,100,56430,1478,43
09056,2024,3,3,0,0,100,268783,1811,151
09057,2024,11,11,0,0,100,107577,1503,76
09058,2024,2,2,0,0,100,135400,1351,103
09059,2024,7,7,0,0,100,129460,2402,68
09060,2024,8,8,0,0,100,118050,1469,80
09061,2024,7,7,0,0,100,130144,1508,101
09062,2024,5,5,0,0,100,89004,1915,47
09063,2024,4,4,0,0,100,220398,3408,68
09065,2024,15,15,0,0,100,119969,1828,73
09066,2024,4,4,0,0,100,208188,2068,102
09067,2024,3,3,0,0,100,146000,2645,60
09068,2024,3,3,0,0,100,97877,1674,64
09070,2024,2,2,0,0,100,104005,1312,82
09071,2024,1,1,0,0,100,18000,360,50
09073,2024,1,1,0,0,100,242500,2021,120
09074,2024,4,4,0,0,100,155875,2163,76
09075,2024,3,3,0,0,100,81667,1355,72
09077,2024,4,4,0,0,100,60250,830,72
09078,2024,1,1,0,0,100,158730,2334,68
09079,2024,10,10,0,0,100,271430,2532,113
09080,2024,3,3,0,0,100,180000,1454,119
09081,2024,2,2,0,0,100,355000,2134,162
09082,2024,9,9,0,0,100,93550,1480,77
09084,2024,1,1,0,0,100,213075,666,320
09085,2024,6,5,1,17,83,128778,2363,74
09086,2024,4,4,0,0,100,104950,1513,69
09087,2024,2,2,0,0,100,81300,1338,62
09088,2024,1,1,0,0,100,88000,1035,85
09089,2024,1,1,0,0,100,200000,662,302
09092,2024,1,1,0,0,100,157000,1869,84
09093,2024,2,2,0,0,100,69500,758,85
09095,2024,2,2,0,0,100,99200,915,102
09097,2024,1,1,0,0,100,120000,1500,80
09098,2024,2,2,0,0,100,103400,1132,80
09099,2024,3,3,0,0,100,207720,2180,95
09100,2024,7,2,5,71,29,45843,649,72
09101,2024,3,3,0,0,100,91667,1103,77
09102,2024,3,3,0,0,100,242533,2597,95
09103,2024,18,18,0,0,100,208730,1938,104
09104,2024,9,9,0,0,100,155356,1535,101
09105,2024,11,11,0,0,100,158623,1709,93
09106,2024,1,1,0,0,100,115000,1250,92
09107,2024,14,14,0,0,100,178234,1619,114
09108,2024,3,3,0,0,100,115000,1538,99
09109,2024,2,2,0,0,100,320100,2424,133
09110,2024,2,2,0,0,100,48600,1210,60
09111,2024,4,4,0,0,100,110614,1333,86
09113,2024,11,11,0,0,100,145038,2292,72
09114,2024,1,1,0,0,100,101700,1816,56
09115,2024,2,2,0,0,100,158482,1046,138
09116,2024,3,2,1,33,67,177097,1409,138
09117,2024,4,4,0,0,100,154750,1774,102
09118,2024,3,3,0,0,100,151869,1472,108
09119,2024,11,11,0,0,100,115468,1487,82
09120,2024,5,5,0,0,100,121800,1377,97
09121,2024,15,14,1,7,93,180484,1784,112
09122,2024,124,76,48,39,61,136643,1610,85
09124,2024,15,15,0,0,100,150050,1651,98
09125,2024,8,8,0,0,100,145349,1255,114
09126,2024,4,4,0,0,100,124808,986,124
09127,2024,1,1,0,0,100,123650,1546,80
09128,2024,5,5,0,0,100,176145,1471,124
09129,2024,2,2,0,0,100,147500,2909,52
09130,2024,20,20,0,0,100,154158,1722,95
09131,2024,3,3,0,0,100,144573,1402,115
09132,2024,1,1,0,0,100,370000,2256,164
09136,2024,2,2,0,0,100,130725,2013,64
09137,2024,2,2,0,0,100,382500,3204,110
09138,2024,2,2,0,0,100,227975,3076,76
09139,2024,1,0,1,100,0,115955,1567,74
09140,2024,3,3,0,0,100,267698,3621,71
09141,2024,1,1,0,0,100,130000,2167,60
09142,2024,3,3,0,0,100,102000,1458,76
09145,2024,9,9,0,0,100,179862,1603,126
09147,2024,2,2,0,0,100,161352,1567,98
09148,2024,1,1,0,0,100,90000,1607,56
09149,2024,4,4,0,0,100,97141,1062,92
09150,2024,7,5,2,29,71,175714,1642,110
09152,2024,1,1,0,0,100,53600,893,60
09153,2024,3,3,0,0,100,98467,948,105
09154,2024,1,1,0,0,100,103150,645,160
09157,2024,16,15,1,6,94,115598,1299,90
09158,2024,2,2,0,0,100,230000,2775,82
09159,2024,2,2,0,0,100,137005,1886,76
09160,2024,80,73,7,9,91,95183,1037,95
09161,2024,14,13,1,7,93,165454,1877,95
09162,2024,2,2,0,0,100,34750,684,50
09164,2024,6,6,0,0,100,145553,1528,89
09165,2024,5,5,0,0,100,154300,1276,140
09166,2024,2,2,0,0,100,411000,1932,198
09167,2024,38,33,5,13,87,153583,1655,90
09168,2024,4,4,0,0,100,140385,1220,139
09169,2024,2,2,0,0,100,152000,1428,102
09170,2024,2,2,0,0,100,186000,1315,166
09173,2024,4,4,0,0,100,166750,1446,112
09174,2024,5,5,0,0,100,241181,2116,115
09176,2024,6,6,0,0,100,129750,1414,95
09177,2024,1,1,0,0,100,110000,902,122
09179,2024,1,1,0,0,100,272910,1949,140
09180,2024,2,2,0,0,100,89080,1483,63
09181,2024,8,8,0,0,100,115059,1287,94
09182,2024,16,16,0,0,100,114158,1870,64
09185,2024,52,45,7,13,87,141835,1622,89
09186,2024,1,1,0,0,100,285000,2740,104
09187,2024,5,5,0,0,100,290194,2246,130
09188,2024,15,14,1,7,93,114369,1477,80
09189,2024,4,4,0,0,100,88500,1776,52
09190,2024,2,2,0,0,100,162000,1754,94
09192,2024,2,2,0,0,100,105000,1145,88
09193,2024,5,5,0,0,100,107250,1223,103
09194,2024,57,50,7,12,88,196232,1902,101
09196,2024,1,1,0,0,100,190000,2879,66
09198,2024,2,2,0,0,100,230485,2124,104
09199,2024,3,3,0,0,100,187400,2469,98
09200,2024,2,2,0,0,100,71250,657,108
09202,2024,2,2,0,0,100,108500,1235,92
09203,2024,1,1,0,0,100,320000,1143,280
09205,2024,2,2,0,0,100,126500,1888,55
09206,2024,15,5,10,67,33,75920,1764,45
09207,2024,20,20,0,0,100,143394,1773,87
09209,2024,10,10,0,0,100,155575,1335,117
09210,2024,5,5,0,0,100,269408,2308,137
09211,2024,5,5,0,0,100,76600,967,85
09212,2024,3,3,0,0,100,141667,1433,100
09213,2024,5,5,0,0,100,155283,1425,112
09214,2024,6,6,0,0,100,116345,1758,72
09215,2024,2,2,0,0,100,85400,1134,64
09217,2024,4,4,0,0,100,80720,960,96
09219,2024,7,7,0,0,100,121618,1392,90
09220,2024,1,1,0,0,100,135000,2250,60
09221,2024,6,6,0,0,100,142196,1276,108
09222,2024,2,2,0,0,100,159000,2412,65
09223,2024,7,7,0,0,100,125000,1531,92
09224,2024,9,9,0,0,100,117852,1229,105
09225,2024,188,123,65,35,65,126280,1577,82
09226,2024,1,1,0,0,100,99000,900,110
09228,2024,4,4,0,0,100,114700,1609,63
09229,2024,6,6,0,0,100,71700,959,70
09230,2024,4,4,0,0,100,164965,1494,112
09231,2024,10,10,0,0,100,79636,1667,54
09232,2024,2,2,0,0,100,62500,795,79
09234,2024,2,2,0,0,100,154000,1786,84
09235,2024,7,7,0,0,100,158136,1214,138
09236,2024,2,2,0,0,100,199500,1968,96
09238,2024,9,9,0,0,100,209822,1857,124
09239,2024,6,6,0,0,100,101647,1602,61
09240,2024,4,4,0,0,100,132055,1310,112
09241,2024,5,5,0,0,100,151918,1540,100
09243,2024,1,1,0,0,100,146000,1475,99
09244,2024,7,7,0,0,100,128986,1431,97
09245,2024,15,15,0,0,100,178064,1745,99
09246,2024,8,8,0,0,100,120500,1537,88
09247,2024,3,3,0,0,100,150192,1319,116
09249,2024,1,1,0,0,100,285600,2341,122
09250,2024,3,3,0,0,100,209598,1423,128
09251,2024,2,2,0,0,100,173072,2238,78
09252,2024,3,3,0,0,100,76683,986,80
09253,2024,4,4,0,0,100,123872,1622,76
09254,2024,3,3,0,0,100,114075,1360,86
09257,2024,10,10,0,0,100,163091,1587,104
09258,2024,4,4,0,0,100,235200,1790,130
09259,2024,2,2,0,0,100,103500,1082,98
09261,2024,114,72,42,37,63,111996,1429,80
09262,2024,5,5,0,0,100,137172,1558,95
09264,2024,19,19,0,0,100,166937,1728,96
09265,2024,28,21,7,25,75,156412,1837,86
09267,2024,11,11,0,0,100,91021,1205,76
09268,2024,22,22,0,0,100,151670,1414,108
09269,2024,1,1,0,0,100,27495,458,60
09270,2024,7,7,0,0,100,74900,962,83
09271,2024,2,2,0,0,100,168568,1432,110
09272,2024,17,17,0,0,100,132037,1610,82
09273,2024,9,9,0,0,100,170033,1655,107
09274,2024,3,3,0,0,100,78333,907,83
09275,2024,5,5,0,0,100,259900,2454,109
09277,2024,13,13,0,0,100,139838,1869,90
09280,2024,17,17,0,0,100,136294,2336,80
09281,2024,2,2,0,0,100,223500,2256,95
09282,2024,62,52,10,16,84,160081,1691,100
09283,2024,9,4,5,56,44,112708,2477,51
09284,2024,2,2,0,0,100,119834,1404,84
09285,2024,12,12,0,0,100,136795,2091,76
09289,2024,13,13,0,0,100,166859,1683,100
09290,2024,10,10,0,0,100,93035,1420,74
09291,2024,8,8,0,0,100,104268,1584,65
09293,2024,11,11,0,0,100,145067,1620,96
09294,2024,1,1,0,0,100,436500,1570,278
09295,2024,6,6,0,0,100,69167,1091,70
09298,2024,3,3,0,0,100,166610,2072,86
09299,2024,6,6,0,0,100,132020,2250,66
09300,2024,4,4,0,0,100,145218,1419,98
09301,2024,11,11,0,0,100,109002,1501,72
09303,2024,4,4,0,0,100,164455,1587,102
09305,2024,2,2,0,0,100,349470,1962,210
09306,2024,28,26,2,7,93,134639,1677,82
09307,2024,1,1,0,0,100,160000,1441,111
09308,2024,1,1,0,0,100,31000,365,85
09312,2024,30,30,0,0,100,178900,1893,97
09313,2024,2,2,0,0,100,122500,910,136
09314,2024,4,3,1,25,75,189745,1555,117
09316,2024,5,5,0,0,100,186620,1403,132
09318,2024,2,2,0,0,100,181150,1828,98
09319,2024,1,1,0,0,100,92000,1314,70
09320,2024,1,1,0,0,100,138817,1361,102
09321,2024,9,4,5,56,44,95978,1530,56
09322,2024,38,23,15,39,61,94248,1896,50
09324,2024,42,42,0,0,100,193765,1799,108
09328,2024,6,6,0,0,100,195175,1764,116
09329,2024,1,1,0,0,100,245000,1678,146
09330,2024,3,3,0,0,100,82232,1498,65
09331,2024,5,5,0,0,100,214700,2236,95
09332,2024,21,20,1,5,95,199367,1937,104
09334,2024,15,13,2,13,87,85609,1343,68
09335,2024,2,2,0,0,100,155280,967,158
09336,2024,12,12,0,0,100,87509,1039,86
09339,2024,7,7,0,0,100,175443,1617,103
09340,2024,2,2,0,0,100,217175,1999,114
09342,2024,1,1,0,0,100,43500,580,75
10003,2024,34,33,1,3,97,101582,1155,93
10004,2024,3,3,0,0,100,110833,831,113
10005,2024,4,4,0,0,100,91750,922,97
10006,2024,30,26,4,13,87,120711,1256,94
10009,2024,1,1,0,0,100,30000,500,60
10011,2024,1,1,0,0,100,73950,514,144
10012,2024,4,4,0,0,100,86375,1004,84
10013,2024,1,1,0,0,100,61000,678,90
10014,2024,3,3,0,0,100,167667,1377,125
10015,2024,2,2,0,0,100,215500,2099,106
10017,2024,1,1,0,0,100,170000,1889,90
10018,2024,13,13,0,0,100,138269,1299,110
10019,2024,2,2,0,0,100,60500,628,97
10020,2024,4,4,0,0,100,217250,1557,138
10021,2024,3,3,0,0,100,55000,803,68
10022,2024,3,3,0,0,100,70633,800,87
10023,2024,1,1,0,0,100,133000,2660,50
10024,2024,4,4,0,0,100,88662,974,90
10025,2024,1,1,0,0,100,73500,574,128
10028,2024,1,1,0,0,100,80000,667,120
10029,2024,2,2,0,0,100,166500,2128,74
10030,2024,10,10,0,0,100,204712,2311,91
10031,2024,3,3,0,0,100,81000,992,74
10032,2024,1,1,0,0,100,205810,1225,168
10033,2024,43,33,10,23,77,93255,1018,94
10034,2024,36,28,8,22,78,95328,1150,87
10035,2024,11,10,1,9,91,89236,889,100
10037,2024,5,5,0,0,100,147623,1309,116
10038,2024,3,3,0,0,100,197133,1658,121
10039,2024,2,2,0,0,100,81500,754,110
10041,2024,1,1,0,0,100,70000,729,96
10042,2024,11,11,0,0,100,109900,1019,105
10045,2024,3,3,0,0,100,77000,707,130
10046,2024,2,2,0,0,100,140750,1074,125
10048,2024,4,4,0,0,100,103375,974,110
10049,2024,4,4,0,0,100,246500,1978,124
10050,2024,1,1,0,0,100,162000,1102,147
10051,2024,9,9,0,0,100,197756,1802,113
10052,2024,2,2,0,0,100,172500,1404,124
10053,2024,3,3,0,0,100,229583,1820,129
10054,2024,3,3,0,0,100,145667,1901,95
10055,2024,3,3,0,0,100,138000,1174,128
10056,2024,3,3,0,0,100,169333,1413,113
10058,2024,3,3,0,0,100,56333,764,66
10060,2024,24,21,3,12,88,192817,1998,98
10061,2024,6,5,1,17,83,139117,1500,93
10062,2024,1,1,0,0,100,216600,1836,118
10063,2024,3,3,0,0,100,88667,838,97
10064,2024,20,18,2,10,90,113916,1149,99
10065,2024,1,1,0,0,100,150000,1190,126
10066,2024,4,4,0,0,100,156750,1496,116
10067,2024,21,17,4,19,81,229721,2292,110
10068,2024,1,1,0,0,100,30000,750,40
10069,2024,1,1,0,0,100,120000,984,122
10070,2024,7,7,0,0,100,144393,1483,101
10072,2024,1,1,0,0,100,38000,345,110
10074,2024,5,5,0,0,100,126100,1199,103
10075,2024,1,1,0,0,100,140000,714,196
10076,2024,4,4,0,0,100,62625,749,90
10077,2024,1,1,0,0,100,117000,936,125
10080,2024,9,7,2,22,78,127433,1320,88
10081,2024,82,31,51,62,38,123701,1647,74
10082,2024,4,4,0,0,100,105125,993,100
10083,2024,4,4,0,0,100,157000,3016,124
10084,2024,6,6,0,0,100,248200,1630,153
10085,2024,1,1,0,0,100,105000,750,140
10086,2024,1,1,0,0,100,147300,1364,108
10089,2024,9,9,0,0,100,150167,1436,101
10090,2024,2,2,0,0,100,179051,3550,61
10091,2024,1,1,0,0,100,228500,1306,175
10093,2024,1,0,1,100,0,60000,706,85
10094,2024,2,2,0,0,100,68000,876,78
10095,2024,3,3,0,0,100,140333,919,145
10096,2024,7,7,0,0,100,128029,1474,86
10097,2024,1,1,0,0,100,166751,1684,99
10098,2024,3,3,0,0,100,94333,989,95
10099,2024,9,9,0,0,100,106578,1102,92
10100,2024,13,13,0,0,100,163489,1599,98
10101,2024,2,2,0,0,100,97500,828,128
10102,2024,1,1,0,0,100,35000,854,41
10103,2024,2,2,0,0,100,140000,1038,140
10104,2024,3,3,0,0,100,199333,1463,135
10105,2024,1,1,0,0,100,124200,1774,70
10106,2024,1,1,0,0,100,180000,1406,128
10107,2024,3,3,0,0,100,126500,982,128
10108,2024,1,1,0,0,100,66000,574,115
10109,2024,3,3,0,0,100,156267,999,172
10110,2024,3,3,0,0,100,231000,1798,128
10111,2024,2,2,0,0,100,104729,758,144
10112,2024,2,2,0,0,100,54500,680,78
10113,2024,3,3,0,0,100,115000,1234,98
10114,2024,10,10,0,0,100,108000,1239,91
10115,2024,13,13,0,0,100,191585,2097,89
10116,2024,2,2,0,0,100,165000,988,168
10117,2024,1,1,0,0,100,165000,821,201
10118,2024,1,1,0,0,100,133500,1094,122
10119,2024,4,4,0,0,100,73014,796,98
10120,2024,1,1,0,0,100,60000,488,123
10121,2024,2,2,0,0,100,156500,929,198
10122,2024,3,3,0,0,100,89167,1112,90
10123,2024,9,6,3,33,67,101200,1363,83
10124,2024,2,2,0,0,100,82900,805,102
10125,2024,2,2,0,0,100,101000,1596,80
10127,2024,2,2,0,0,100,99000,806,122
10129,2024,3,3,0,0,100,232950,2098,113
10131,2024,4,4,0,0,100,178750,1494,124
10132,2024,2,2,0,0,100,129000,1692,90
10133,2024,3,3,0,0,100,152000,1085,160
10136,2024,1,1,0,0,100,140000,1667,84
10138,2024,3,3,0,0,100,83000,1006,102
10139,2024,1,1,0,0,100,210000,1654,127
10140,2024,8,8,0,0,100,120362,1194,103
10141,2024,9,9,0,0,100,96973,989,92
10142,2024,23,23,0,0,100,108732,1229,88
10143,2024,1,1,0,0,100,200000,1000,200
10144,2024,2,2,0,0,100,133500,1408,100
10148,2024,6,6,0,0,100,138833,1270,114
10149,2024,2,2,0,0,100,174500,1650,100
10150,2024,4,3,1,25,75,82162,948,80
10151,2024,7,5,2,29,71,141857,1773,79
10153,2024,5,5,0,0,100,216000,2921,107
10155,2024,1,1,0,0,100,112200,652,172
10156,2024,12,12,0,0,100,148150,1602,93
10157,2024,3,3,0,0,100,120667,1411,80
10158,2024,5,5,0,0,100,206230,1985,104
10162,2024,2,2,0,0,100,84500,895,93
10164,2024,11,11,0,0,100,137605,1582,85
10165,2024,2,2,0,0,100,184500,2200,73
10166,2024,6,6,0,0,100,174662,1574,127
10167,2024,1,1,0,0,100,90400,869,104
10168,2024,1,1,0,0,100,75000,872,86
10169,2024,4,4,0,0,100,99750,1299,76
10170,2024,6,6,0,0,100,165500,1205,132
10171,2024,1,1,0,0,100,96000,1524,63
10172,2024,1,1,0,0,100,240000,2526,95
10173,2024,3,3,0,0,100,253667,2048,124
10174,2024,3,3,0,0,100,49500,530,88
10175,2024,2,2,0,0,100,212487,1514,127
10176,2024,5,5,0,0,100,119400,1198,102
10177,2024,2,2,0,0,100,200475,1459,133
10178,2024,1,1,0,0,100,102500,1102,93
10179,2024,1,1,0,0,100,210000,1105,190
10181,2024,2,2,0,0,100,97500,914,102
10184,2024,2,2,0,0,100,87750,1407,70
10185,2024,1,1,0,0,100,180000,1286,140
10186,2024,6,6,0,0,100,251207,2041,135
10187,2024,6,6,0,0,100,142205,1120,140
10188,2024,3,3,0,0,100,137833,1146,122
10189,2024,1,1,0,0,100,130000,1529,85
10190,2024,6,6,0,0,100,194750,2293,87
10191,2024,9,9,0,0,100,296021,2576,117
10192,2024,1,1,0,0,100,175000,1591,110
10193,2024,4,4,0,0,100,87875,879,96
10194,2024,2,2,0,0,100,144825,994,146
10195,2024,4,4,0,0,100,84866,756,106
10196,2024,5,5,0,0,100,98900,926,115
10198,2024,4,4,0,0,100,173225,1307,122
10199,2024,5,5,0,0,100,121585,917,116
10200,2024,1,1,0,0,100,75000,1500,50
10201,2024,1,1,0,0,100,46000,630,73
10202,2024,3,3,0,0,100,92000,815,121
10203,2024,3,3,0,0,100,152527,1433,108
10204,2024,2,2,0,0,100,122500,1492,86
10206,2024,1,1,0,0,100,260000,1494,174
10207,2024,1,1,0,0,100,122200,1909,64
10208,2024,5,5,0,0,100,192140,1539,140
10209,2024,20,19,1,5,95,245617,2372,103
10210,2024,2,2,0,0,100,165000,916,170
10211,2024,5,5,0,0,100,228280,2096,115
10212,2024,1,1,0,0,100,60500,1315,46
10213,2024,1,1,0,0,100,67500,742,91
10215,2024,3,3,0,0,100,201108,1115,162
10216,2024,10,9,1,10,90,105758,1049,102
10218,2024,3,3,0,0,100,149583,1492,107
10219,2024,1,1,0,0,100,265000,1199,221
10220,2024,21,21,0,0,100,166028,1477,106
10222,2024,9,9,0,0,100,149989,1086,140
10223,2024,9,9,0,0,100,94611,967,107
10224,2024,11,10,1,9,91,178705,1572,122
10225,2024,6,6,0,0,100,106083,1356,96
10226,2024,1,1,0,0,100,165000,1528,108
10227,2024,2,1,1,50,50,60000,658,92
10229,2024,2,2,0,0,100,157000,1669,94
10230,2024,2,2,0,0,100,63000,1021,85
10231,2024,3,3,0,0,100,124713,1673,67
10232,2024,5,4,1,20,80,98800,1116,102
10233,2024,11,10,1,9,91,129923,1497,90
10234,2024,3,3,0,0,100,110927,985,123
10235,2024,1,1,0,0,100,213400,2178,98
10236,2024,1,1,0,0,100,161300,1213,133
10237,2024,5,5,0,0,100,152660,1514,101
10238,2024,5,5,0,0,100,159660,2485,69
10239,2024,3,3,0,0,100,178333,1841,102
10240,2024,4,4,0,0,100,158750,1517,113
10242,2024,2,2,0,0,100,66000,715,94
10243,2024,1,1,0,0,100,84000,840,100
10245,2024,8,8,0,0,100,165306,1491,114
10246,2024,2,2,0,0,100,98616,1042,90
10247,2024,1,1,0,0,100,120000,674,178
10248,2024,5,5,0,0,100,265500,2287,115
10249,2024,3,2,1,33,67,131333,1205,137
10250,2024,3,3,0,0,100,128500,839,132
10251,2024,1,1,0,0,100,57000,570,100
10252,2024,1,1,0,0,100,240000,2824,85
10253,2024,1,1,0,0,100,98500,1216,81
10254,2024,4,4,0,0,100,143012,1510,99
10255,2024,4,4,0,0,100,175100,1295,135
10256,2024,3,3,0,0,100,133000,1459,100
10257,2024,1,1,0,0,100,75000,375,200
10258,2024,2,2,0,0,100,129500,1024,132
10259,2024,3,3,0,0,100,128333,1614,76
10260,2024,8,8,0,0,100,260275,2086,126
10261,2024,12,12,0,0,100,64858,790,87
10262,2024,3,3,0,0,100,79333,775,117
10263,2024,8,8,0,0,100,125838,1571,78
10265,2024,13,13,0,0,100,170057,1802,97
10266,2024,2,2,0,0,100,77500,996,78
10267,2024,8,8,0,0,100,120875,1431,86
10268,2024,54,39,15,28,72,183117,2054,98
10270,2024,3,3,0,0,100,232167,1322,168
10271,2024,7,7,0,0,100,151721,1536,94
10274,2024,2,2,0,0,100,61000,1032,62
10275,2024,5,5,0,0,100,152320,1482,102
10276,2024,3,3,0,0,100,157667,1648,96
10279,2024,3,3,0,0,100,93712,1123,79
10280,2024,17,17,0,0,100,136206,1344,101
10281,2024,2,2,0,0,100,148950,1418,110
10282,2024,10,10,0,0,100,207239,1828,114
10283,2024,3,3,0,0,100,157487,1370,112
10284,2024,2,2,0,0,100,144000,1494,104
10285,2024,2,2,0,0,100,121500,1150,109
10286,2024,2,2,0,0,100,166500,1506,112
10287,2024,7,7,0,0,100,127191,1159,107
10288,2024,2,2,0,0,100,49500,652,72
10289,2024,9,9,0,0,100,104765,1131,88
10290,2024,6,6,0,0,100,127333,1701,89
10291,2024,3,3,0,0,100,138167,856,168
10295,2024,1,1,0,0,100,135000,1227,110
10297,2024,45,32,13,29,71,165852,2049,80
10298,2024,7,7,0,0,100,109571,1066,107
10299,2024,7,7,0,0,100,122857,1164,113
10300,2024,2,2,0,0,100,148940,1265,119
10301,2024,2,2,0,0,100,101500,1546,66
10302,2024,1,1,0,0,100,19999,364,55
10304,2024,1,1,0,0,100,90000,726,124
10306,2024,2,2,0,0,100,90000,1081,79
10308,2024,2,2,0,0,100,51000,614,84
10309,2024,1,1,0,0,100,136000,1789,76
10310,2024,1,1,0,0,100,215985,1674,129
10312,2024,1,1,0,0,100,107000,1289,83
10313,2024,5,5,0,0,100,129400,1515,85
10314,2024,5,5,0,0,100,149260,948,146
10316,2024,1,1,0,0,100,241000,1785,135
10317,2024,12,12,0,0,100,106625,862,118
10319,2024,10,10,0,0,100,111098,1102,103
10320,2024,2,2,0,0,100,133500,1452,92
10321,2024,29,29,0,0,100,221497,2142,106
10323,2024,157,135,22,14,86,99735,1267,79
10324,2024,1,1,0,0,100,40000,1333,30
10325,2024,28,26,2,7,93,259825,2327,113
10326,2024,4,4,0,0,100,93250,878,104
10327,2024,2,2,0,0,100,177500,1646,114
10328,2024,1,1,0,0,100,100000,813,123
10329,2024,3,3,0,0,100,183517,1702,106
10331,2024,6,6,0,0,100,167000,1557,105
10332,2024,2,2,0,0,100,147500,1822,82
10333,2024,157,73,84,54,46,133492,1763,74
10334,2024,4,4,0,0,100,166500,1535,110
10335,2024,5,5,0,0,100,107000,927,124
10336,2024,2,2,0,0,100,216800,1902,144
10337,2024,1,1,0,0,100,77000,828,93
10338,2024,2,2,0,0,100,236000,1857,131
10339,2024,4,4,0,0,100,93250,1002,95
10340,2024,20,20,0,0,100,195425,1932,105
10341,2024,3,3,0,0,100,141667,3245,70
10342,2024,5,5,0,0,100,135380,1599,95
10343,2024,67,41,26,39,61,162319,1745,93
10344,2024,2,2,0,0,100,223000,2094,105
10345,2024,3,3,0,0,100,210901,1793,132
10347,2024,2,2,0,0,100,125000,1111,112
10348,2024,1,1,0,0,100,180700,1264,143
10349,2024,19,19,0,0,100,213754,2246,96
10350,2024,10,10,0,0,100,127261,1183,116
10351,2024,6,5,1,17,83,115366,1157,104
10352,2024,7,7,0,0,100,195689,1902,101
10353,2024,9,8,1,11,89,141400,1679,82
10354,2024,1,1,0,0,100,220000,1222,180
10355,2024,2,2,0,0,100,231082,1137,194
10356,2024,5,5,0,0,100,139600,1856,93
10357,2024,30,25,5,17,83,162812,1977,85
10358,2024,9,8,1,11,89,151102,1687,95
10359,2024,7,7,0,0,100,120843,1380,93
10360,2024,7,7,0,0,100,240714,1882,135
10361,2024,1,1,0,0,100,107000,823,130
10362,2024,152,87,65,43,57,146545,1990,74
10363,2024,3,3,0,0,100,215700,1754,119
10364,2024,1,1,0,0,100,151448,1306,116
10365,2024,3,3,0,0,100,114000,1179,104
10367,2024,5,5,0,0,100,146390,1390,109
10368,2024,14,14,0,0,100,170146,1673,105
10369,2024,4,4,0,0,100,117500,1182,98
10370,2024,2,2,0,0,100,152250,1690,96
10371,2024,4,4,0,0,100,201000,1394,152
10372,2024,4,4,0,0,100,111000,988,107
10373,2024,5,5,0,0,100,161800,1810,94
10374,2024,1,1,0,0,100,60000,638,94
10376,2024,2,2,0,0,100,137500,850,150
10378,2024,3,3,0,0,100,48000,937,62
10379,2024,2,2,0,0,100,151000,1622,94
10380,2024,1,1,0,0,100,120000,1714,70
10381,2024,7,7,0,0,100,235193,2187,109
10382,2024,11,11,0,0,100,115273,1283,91
10384,2024,2,2,0,0,100,113500,1192,97
10386,2024,3,3,0,0,100,176592,1657,112
10387,2024,982,182,800,81,19,113245,1800,65
10391,2024,1,1,0,0,100,328030,2466,133
10392,2024,3,3,0,0,100,97667,1068,88
10393,2024,2,2,0,0,100,75250,802,90
10394,2024,1,1,0,0,100,68000,810,84
10395,2024,3,3,0,0,100,76000,1078,70
10396,2024,8,8,0,0,100,133265,1225,112
10397,2024,3,3,0,0,100,81667,747,110
10399,2024,7,7,0,0,100,101357,1219,80
10400,2024,2,2,0,0,100,129000,1318,104
10401,2024,8,8,0,0,100,90117,1119,82
10402,2024,5,5,0,0,100,173030,1250,140
10404,2024,1,1,0,0,100,63000,969,65
10406,2024,15,15,0,0,100,190192,2083,92
10408,2024,3,3,0,0,100,129833,823,164
10409,2024,6,6,0,0,100,202267,1624,136
10410,2024,2,2,0,0,100,154875,1288,130
10412,2024,5,5,0,0,100,233000,2394,96
10414,2024,1,1,0,0,100,75000,647,116
10416,2024,1,1,0,0,100,275000,2099,131
10418,2024,1,1,0,0,100,117500,1703,69
10419,2024,4,4,0,0,100,174075,1291,132
10420,2024,20,18,2,10,90,106450,1254,87
10421,2024,1,1,0,0,100,178000,1604,111
10422,2024,1,1,0,0,100,123500,1372,90
10423,2024,6,6,0,0,100,181467,1507,124
10424,2024,2,2,0,0,100,98000,1060,92
10425,2024,3,3,0,0,100,189333,1845,101
10426,2024,7,6,1,14,86,84321,893,96
10427,2024,2,2,0,0,100,89510,1072,96
10431,2024,1,1,0,0,100,44000,587,75
10433,2024,2,2,0,0,100,63500,666,96
10434,2024,1,1,0,0,100,175000,1535,114
10435,2024,2,2,0,0,100,194500,1644,123
10436,2024,2,2,0,0,100,142176,1116,109
10437,2024,3,3,0,0,100,98833,1201,79
10438,2024,1,1,0,0,100,260000,1209,215
10439,2024,1,1,0,0,100,115000,958,120
10440,2024,4,4,0,0,100,95000,914,98
10441,2024,2,2,0,0,100,167613,1156,150
10442,2024,6,6,0,0,100,174983,1634,107
10444,2024,4,4,0,0,100,73750,738,108
11001,2024,10,10,0,0,100,152352,1476,99
11002,2024,6,5,1,17,83,139883,1528,90
11003,2024,1,1,0,0,100,80000,777,103
11004,2024,3,3,0,0,100,116667,986,106
11005,2024,10,10,0,0,100,211338,2034,106
11006,2024,1,1,0,0,100,69820,1012,69
11007,2024,2,2,0,0,100,173000,2534,68
11008,2024,5,5,0,0,100,119100,1509,79
11009,2024,23,20,3,13,87,145142,1352,103
11010,2024,3,3,0,0,100,250122,1874,133
11011,2024,5,5,0,0,100,384859,2765,132
11012,2024,28,28,0,0,100,206947,1996,103
11013,2024,10,10,0,0,100,159757,2284,85
11014,2024,15,15,0,0,100,221653,2375,94
11015,2024,8,8,0,0,100,163138,1508,104
11016,2024,1,1,0,0,100,44000,386,114
11017,2024,3,3,0,0,100,76021,981,74
11018,2024,5,5,0,0,100,255600,1308,154
11019,2024,1,1,0,0,100,120000,1875,64
11020,2024,3,3,0,0,100,95000,1051,76
11021,2024,8,8,0,0,100,86107,1018,92
11022,2024,24,20,4,17,83,152304,1562,102
11023,2024,12,12,0,0,100,191098,1508,115
11024,2024,9,7,2,22,78,291037,3235,87
11025,2024,3,3,0,0,100,97000,894,120
11026,2024,4,4,0,0,100,141912,1059,121
11027,2024,11,11,0,0,100,172585,1669,103
11028,2024,10,10,0,0,100,137728,1664,82
11032,2024,5,4,1,20,80,212000,2274,96
11033,2024,13,13,0,0,100,161746,1640,97
11034,2024,19,19,0,0,100,151650,1534,97
11035,2024,5,5,0,0,100,136720,1120,116
11036,2024,1,1,0,0,100,180000,1856,97
11037,2024,6,5,1,17,83,149167,1464,100
11038,2024,3,3,0,0,100,77677,1072,74
11040,2024,26,25,1,4,96,206234,2277,99
11041,2024,23,23,0,0,100,183119,1684,109
11042,2024,4,4,0,0,100,66375,612,109
11043,2024,4,4,0,0,100,199125,1586,117
11044,2024,3,3,0,0,100,98707,1110,90
11045,2024,4,4,0,0,100,138912,1430,94
11047,2024,2,2,0,0,100,41500,1516,32
11048,2024,12,12,0,0,100,169608,1658,95
11049,2024,37,37,0,0,100,128451,1314,99
11051,2024,5,5,0,0,100,52680,482,108
11052,2024,7,7,0,0,100,169429,2178,81
11053,2024,5,5,0,0,100,111550,999,108
11054,2024,3,3,0,0,100,196233,1719,115
11055,2024,2,2,0,0,100,97500,1658,70
11056,2024,4,4,0,0,100,56998,955,70
11058,2024,6,6,0,0,100,176231,2118,82
11061,2024,4,4,0,0,100,217922,1926,106
11063,2024,10,10,0,0,100,149416,1357,107
11064,2024,4,4,0,0,100,193765,1470,143
11065,2024,1,1,0,0,100,50000,769,65
11066,2024,7,6,1,14,86,117821,1806,75
11067,2024,23,23,0,0,100,180368,1821,97
11068,2024,21,21,0,0,100,125390,1278,95
11069,2024,748,387,361,48,52,132202,1571,81
11070,2024,2,2,0,0,100,120525,1312,94
11071,2024,5,5,0,0,100,69704,552,123
11072,2024,3,3,0,0,100,181000,1678,107
11074,2024,2,2,0,0,100,172250,1609,98
11075,2024,2,2,0,0,100,85000,806,105
11076,2024,157,100,57,36,64,113191,1477,78
11077,2024,7,7,0,0,100,121827,1226,101
11078,2024,3,3,0,0,100,491967,3689,117
11079,2024,6,6,0,0,100,158325,1676,92
11080,2024,4,4,0,0,100,95750,1580,60
11081,2024,23,20,3,13,87,180327,2278,98
11082,2024,1,1,0,0,100,30000,545,55
11083,2024,1,1,0,0,100,85000,914,93
11084,2024,14,14,0,0,100,208253,1844,110
11085,2024,12,12,0,0,100,159479,1361,124
11086,2024,10,10,0,0,100,202935,2420,85
11087,2024,2,2,0,0,100,265000,1198,268
11088,2024,17,16,1,6,94,201151,2028,101
11089,2024,7,7,0,0,100,126900,1363,93
11090,2024,11,11,0,0,100,176688,1732,101
11091,2024,20,18,2,10,90,105105,1055,94
11092,2024,1,1,0,0,100,80860,1720,47
11095,2024,5,5,0,0,100,135290,1430,92
11096,2024,6,6,0,0,100,78443,1416,56
11098,2024,21,20,1,5,95,161285,1751,84
11099,2024,30,29,1,3,97,169809,1649,103
11101,2024,1,1,0,0,100,170000,733,232
11102,2024,5,5,0,0,100,148363,1534,97
11103,2024,16,16,0,0,100,98259,872,105
11104,2024,3,3,0,0,100,59667,907,63
11105,2024,10,10,0,0,100,115290,1386,86
11106,2024,73,64,9,12,88,172717,1972,86
11107,2024,1,1,0,0,100,280000,1867,150
11110,2024,2,2,0,0,100,181378,3364,68
11111,2024,9,9,0,0,100,194052,1878,101
11113,2024,5,5,0,0,100,230324,2590,87
11114,2024,1,1,0,0,100,520000,6047,86
11115,2024,13,12,1,8,92,124243,1280,93
11116,2024,73,69,4,5,95,177505,1860,93
11117,2024,4,4,0,0,100,71350,1253,63
11118,2024,2,2,0,0,100,47500,602,79
11119,2024,5,5,0,0,100,149600,1606,88
11120,2024,7,7,0,0,100,127113,1417,88
11122,2024,11,11,0,0,100,132591,1317,96
11123,2024,1,1,0,0,100,65000,774,84
11124,2024,5,5,0,0,100,136080,1704,78
11125,2024,4,4,0,0,100,231550,2495,109
11126,2024,6,6,0,0,100,87092,1053,86
11127,2024,3,3,0,0,100,116783,1169,106
11129,2024,47,46,1,2,98,100252,1190,91
11130,2024,4,4,0,0,100,177960,1851,90
11131,2024,9,9,0,0,100,93389,939,104
11132,2024,26,25,1,4,96,154969,1558,102
11135,2024,1,1,0,0,100,52630,1385,38
11136,2024,7,7,0,0,100,123364,1241,114
11137,2024,1,1,0,0,100,130000,1429,91
11138,2024,7,7,0,0,100,185800,1880,95
11139,2024,3,3,0,0,100,125000,1693,81
11140,2024,19,19,0,0,100,155115,1510,102
11141,2024,1,1,0,0,100,180000,947,190
11142,2024,2,2,0,0,100,35500,516,76
11143,2024,2,2,0,0,100,204408,2730,66
11144,2024,44,28,16,36,64,178898,2275,78
11145,2024,267,152,115,43,57,151384,3522,50
11146,2024,4,4,0,0,100,144800,1323,101
11148,2024,4,4,0,0,100,68972,938,80
11150,2024,4,4,0,0,100,124314,1349,96
11151,2024,4,4,0,0,100,150042,1734,88
11152,2024,1,1,0,0,100,339700,2980,114
11153,2024,4,4,0,0,100,173892,1945,92
11155,2024,2,2,0,0,100,244900,1880,130
11156,2024,2,2,0,0,100,59450,900,66
11157,2024,1,1,0,0,100,60000,2500,24
11158,2024,1,1,0,0,100,67000,931,72
11159,2024,2,2,0,0,100,78500,680,110
11161,2024,1,1,0,0,100,33000,434,76
11162,2024,2,2,0,0,100,127350,1235,102
11163,2024,1,1,0,0,100,88500,1283,69
11164,2024,16,16,0,0,100,218528,2418,96
11165,2024,2,2,0,0,100,177500,1572,113
11166,2024,2,2,0,0,100,212500,2296,91
11168,2024,1,1,0,0,100,264600,1594,166
11170,2024,362,167,195,54,46,187381,4497,42
11172,2024,24,24,0,0,100,155500,2161,73
11174,2024,1,1,0,0,100,15000,577,26
11175,2024,3,3,0,0,100,166667,1804,84
11177,2024,2,2,0,0,100,65400,872,80
11178,2024,13,13,0,0,100,151987,1613,92
11179,2024,2,2,0,0,100,79750,1375,58
11180,2024,3,3,0,0,100,67583,957,63
11181,2024,8,8,0,0,100,170871,1511,114
11182,2024,6,6,0,0,100,149823,1424,108
11183,2024,2,2,0,0,100,114000,1248,90
11185,2024,4,3,1,25,75,141025,2028,70
11187,2024,3,3,0,0,100,141098,1452,104
11188,2024,30,28,2,7,93,296545,2818,108
11190,2024,22,20,2,9,91,124264,1393,90
11191,2024,4,4,0,0,100,64800,957,70
11192,2024,11,11,0,0,100,127314,1760,81
11193,2024,3,3,0,0,100,114667,1181,93
11194,2024,2,2,0,0,100,86500,887,101
11195,2024,4,4,0,0,100,241335,1904,103
11196,2024,6,6,0,0,100,120563,1439,89
11197,2024,10,10,0,0,100,162892,1500,110
11198,2024,20,20,0,0,100,114313,1350,87
11199,2024,20,20,0,0,100,208048,2023,102
11200,2024,4,4,0,0,100,72232,870,92
11201,2024,7,7,0,0,100,166968,1468,110
11202,2024,490,186,304,62,38,141951,3740,37
11203,2024,143,118,25,17,83,142642,1645,88
11205,2024,3,3,0,0,100,132333,2232,81
11206,2024,128,111,17,13,87,137887,1642,85
11207,2024,2,2,0,0,100,162500,1892,80
11209,2024,1,1,0,0,100,180000,1029,175
11210,2024,13,13,0,0,100,131464,1609,82
11211,2024,7,7,0,0,100,160846,1546,108
11212,2024,11,11,0,0,100,156333,1779,85
11213,2024,1,1,0,0,100,90000,720,125
11214,2024,3,3,0,0,100,205700,1976,106
11215,2024,9,8,1,11,89,187128,2265,91
11216,2024,4,4,0,0,100,132000,1379,102
11217,2024,17,16,1,6,94,180906,1851,101
11218,2024,3,3,0,0,100,517453,1984,247
11219,2024,1,1,0,0,100,16000,762,21
11220,2024,6,5,1,17,83,98922,1141,88
11221,2024,2,2,0,0,100,110005,943,110
11222,2024,6,6,0,0,100,73965,1220,66
11224,2024,1,1,0,0,100,64000,780,82
11225,2024,8,8,0,0,100,246749,1908,127
11226,2024,3,3,0,0,100,243583,3230,75
11227,2024,1,1,0,0,100,100000,1042,96
11228,2024,3,3,0,0,100,75000,679,112
11230,2024,1,1,0,0,100,25000,417,60
11232,2024,3,3,0,0,100,76800,749,93
11233,2024,10,10,0,0,100,258825,2489,101
11236,2024,3,3,0,0,100,132983,1506,95
11238,2024,1,1,0,0,100,186900,2100,89
11239,2024,1,1,0,0,100,140000,1373,102
11240,2024,15,15,0,0,100,139207,1778,80
11241,2024,6,6,0,0,100,155513,1502,99
11242,2024,5,5,0,0,100,154865,1712,99
11243,2024,8,8,0,0,100,226188,1935,126
11244,2024,5,5,0,0,100,63994,1050,93
11245,2024,3,3,0,0,100,112960,1315,82
11246,2024,1,1,0,0,100,210000,1429,147
11248,2024,1,1,0,0,100,150000,1327,113
11250,2024,1,1,0,0,100,50000,676,74
11251,2024,13,13,0,0,100,109207,1386,81
11252,2024,4,4,0,0,100,150754,1482,113
11253,2024,7,7,0,0,100,175925,1713,106
11254,2024,22,22,0,0,100,183690,1433,119
11255,2024,9,7,2,22,78,189140,1779,110
11256,2024,14,14,0,0,100,194675,1893,101
11257,2024,8,8,0,0,100,173920,1776,98
11258,2024,20,18,2,10,90,221420,2364,93
11259,2024,7,7,0,0,100,119714,1614,72
11260,2024,2,2,0,0,100,115300,1430,82
11261,2024,14,14,0,0,100,156929,1589,100
11262,2024,976,368,608,62,38,166549,2513,67
11263,2024,3,3,0,0,100,92833,1033,98
11264,2024,18,18,0,0,100,238568,2381,98
11265,2024,2,2,0,0,100,47500,724,69
11266,2024,181,81,100,55,45,130792,2693,52
11267,2024,23,23,0,0,100,205715,1877,108
11269,2024,37,36,1,3,97,157407,1668,97
11270,2024,1,1,0,0,100,37500,586,64
11272,2024,25,25,0,0,100,203358,2078,98
11273,2024,9,9,0,0,100,155669,1517,106
11274,2024,5,5,0,0,100,258200,1476,148
11276,2024,9,9,0,0,100,137651,1433,90
11277,2024,3,3,0,0,100,183856,1375,129
11278,2024,2,2,0,0,100,212500,1490,139
11279,2024,31,31,0,0,100,203875,1989,99
11280,2024,18,18,0,0,100,114773,1427,77
11281,2024,13,13,0,0,100,167297,1739,101
11283,2024,3,3,0,0,100,48333,733,60
11284,2024,3,3,0,0,100,272667,2264,121
11285,2024,14,12,2,14,86,192802,2180,84
11286,2024,18,17,1,6,94,144523,1496,91
11287,2024,4,4,0,0,100,164813,2142,81
11288,2024,15,15,0,0,100,156759,1590,94
11289,2024,13,13,0,0,100,179517,1586,105
11290,2024,1,1,0,0,100,150000,1875,80
11291,2024,1,1,0,0,100,350000,2756,127
11292,2024,2,2,0,0,100,171500,1266,136
11293,2024,12,12,0,0,100,174108,1653,103
11295,2024,16,16,0,0,100,185655,1905,96
11296,2024,12,12,0,0,100,202245,1717,122
11297,2024,4,4,0,0,100,92630,968,94
11299,2024,9,9,0,0,100,118539,1415,94
11300,2024,4,4,0,0,100,149562,2103,80
11301,2024,13,13,0,0,100,99558,1358,76
11302,2024,7,7,0,0,100,95654,1121,78
11303,2024,14,14,0,0,100,104925,1280,85
11304,2024,73,69,4,5,95,124042,1344,90
11305,2024,1,1,0,0,100,110000,1000,110
11307,2024,3,3,0,0,100,138680,1662,84
11308,2024,4,4,0,0,100,144600,1617,83
11309,2024,2,2,0,0,100,211250,3908,54
11310,2024,9,4,5,56,44,77503,1198,58
11311,2024,3,3,0,0,100,95467,1090,102
11313,2024,1,1,0,0,100,135000,1227,110
11314,2024,4,4,0,0,100,118600,1540,79
11315,2024,33,33,0,0,100,118519,1291,94
11316,2024,2,2,0,0,100,271500,3010,81
11317,2024,4,4,0,0,100,155538,2175,74
11318,2024,2,2,0,0,100,79525,1144,63
11320,2024,7,7,0,0,100,74683,1429,66
11321,2024,7,7,0,0,100,71421,1050,77
11322,2024,22,21,1,5,95,223240,2356,98
11323,2024,3,3,0,0,100,136533,922,137
11324,2024,9,9,0,0,100,120076,1121,95
11325,2024,3,3,0,0,100,216083,1985,109
11326,2024,3,3,0,0,100,118133,1392,84
11327,2024,8,8,0,0,100,147673,1764,84
11328,2024,2,2,0,0,100,62584,534,116
11330,2024,6,6,0,0,100,156572,1691,94
11331,2024,2,2,0,0,100,117750,1778,72
11332,2024,20,20,0,0,100,209761,1962,105
11333,2024,1,1,0,0,100,130000,1300,100
11334,2024,1,1,0,0,100,150000,1807,83
11335,2024,1,1,0,0,100,80331,638,126
11336,2024,9,9,0,0,100,105530,925,101
11337,2024,9,9,0,0,100,152249,1695,104
11338,2024,1,1,0,0,100,168300,3237,52
11339,2024,9,9,0,0,100,84738,1191,81
11340,2024,6,6,0,0,100,130708,1127,117
11341,2024,2,2,0,0,100,161000,1534,110
11342,2024,1,1,0,0,100,210000,2917,72
11343,2024,5,5,0,0,100,368002,3631,103
11344,2024,13,13,0,0,100,157009,1287,114
11345,2024,5,5,0,0,100,112600,1069,90
11347,2024,1,1,0,0,100,210000,2333,90
11351,2024,22,21,1,5,95,161900,1741,86
11352,2024,1,1,0,0,100,347175,3404,102
11353,2024,26,26,0,0,100,262252,2269,114
11354,2024,3,3,0,0,100,139733,1577,89
11355,2024,1,1,0,0,100,205000,2356,87
11356,2024,12,12,0,0,100,201410,1815,109
11357,2024,6,6,0,0,100,126708,1591,74
11358,2024,1,1,0,0,100,65000,1161,56
11359,2024,11,11,0,0,100,210086,2323,97
11360,2024,25,25,0,0,100,254651,2690,97
11361,2024,13,13,0,0,100,139057,1318,100
11363,2024,5,4,1,20,80,302630,2265,125
11364,2024,5,5,0,0,100,119400,1169,96
11366,2024,8,8,0,0,100,159916,1691,103
11367,2024,12,12,0,0,100,103942,1275,81
11369,2024,50,49,1,2,98,194762,2012,97
11370,2024,61,57,4,7,93,245364,2465,104
11371,2024,7,7,0,0,100,188621,1999,95
11372,2024,4,4,0,0,100,142343,1350,104
11373,2024,5,5,0,0,100,75060,1434,62
11375,2024,1,1,0,0,100,100000,1000,100
11376,2024,3,3,0,0,100,49667,635,80
11377,2024,1,1,0,0,100,136000,1971,69
11378,2024,3,3,0,0,100,69933,671,102
11379,2024,96,89,7,7,93,180639,2023,92
11380,2024,3,3,0,0,100,103522,1020,109
11381,2024,2,2,0,0,100,172844,1277,119
11382,2024,1,1,0,0,100,89625,606,148
11383,2024,2,2,0,0,100,263600,2272,116
11384,2024,2,2,0,0,100,208500,1268,146
11386,2024,4,4,0,0,100,125325,1361,101
11387,2024,3,3,0,0,100,165917,1364,145
11390,2024,11,11,0,0,100,143429,1399,112
11392,2024,6,6,0,0,100,121328,1717,69
11393,2024,17,17,0,0,100,170099,1935,87
11394,2024,3,3,0,0,100,51667,746,69
11395,2024,1,1,0,0,100,127200,848,150
11396,2024,17,16,1,6,94,125811,1472,80
11397,2024,91,81,10,11,89,158089,1629,93
11398,2024,2,2,0,0,100,189000,1732,105
11401,2024,12,12,0,0,100,133165,2109,63
11402,2024,1,1,0,0,100,57500,471,122
11404,2024,8,8,0,0,100,136441,1467,92
11405,2024,16,15,1,6,94,211690,2179,98
11407,2024,5,5,0,0,100,76707,1042,76
11408,2024,8,8,0,0,100,176804,1284,141
11409,2024,1,1,0,0,100,83300,1515,55
11410,2024,9,9,0,0,100,93511,1311,72
11411,2024,2,2,0,0,100,73500,960,86
11412,2024,6,6,0,0,100,79417,1122,67
11413,2024,5,5,0,0,100,148767,1329,101
11415,2024,3,3,0,0,100,198101,1623,128
11416,2024,4,4,0,0,100,230025,1614,123
11417,2024,1,1,0,0,100,460000,2421,190
11418,2024,13,13,0,0,100,157667,1584,100
11420,2024,1,1,0,0,100,276572,2213,125
11421,2024,10,10,0,0,100,178978,1934,100
11422,2024,5,5,0,0,100,161362,1334,125
11423,2024,1,1,0,0,100,90000,1125,80
11424,2024,1,1,0,0,100,121350,1517,80
11425,2024,20,20,0,0,100,160387,1643,101
11426,2024,20,12,8,40,60,162605,1867,88
11427,2024,1,1,0,0,100,155892,2259,69
11428,2024,5,5,0,0,100,125400,1357,95
11429,2024,48,44,4,8,92,215052,2110,100
11430,2024,8,8,0,0,100,197958,1815,109
11431,2024,2,2,0,0,100,81025,706,117
11432,2024,1,1,0,0,100,245000,1960,125
11433,2024,17,17,0,0,100,122018,1456,83
11434,2024,21,21,0,0,100,139099,1326,111
11435,2024,4,4,0,0,100,119395,884,128
11436,2024,7,7,0,0,100,260143,2291,136
11437,2024,11,11,0,0,100,148107,1693,89
11438,2024,3,3,0,0,100,176204,1489,125
11439,2024,6,6,0,0,100,146560,1433,107
11440,2024,2,2,0,0,100,64234,780,81
11441,2024,44,37,7,16,84,206645,2619,83
12001,2024,8,8,0,0,100,193594,2185,95
12002,2024,9,6,3,33,67,162917,1691,94
12003,2024,3,3,0,0,100,118333,1635,77
12004,2024,1,1,0,0,100,290000,1812,160
12006,2024,2,2,0,0,100,154250,1530,108
12007,2024,5,5,0,0,100,117800,1372,73
12008,2024,8,8,0,0,100,152881,1170,126
12010,2024,1,1,0,0,100,180000,1429,126
12011,2024,5,5,0,0,100,244743,2602,103
12012,2024,5,5,0,0,100,131626,1354,96
12013,2024,40,39,1,2,98,97805,1119,88
12015,2024,1,1,0,0,100,169000,1056,160
12016,2024,11,11,0,0,100,73879,865,88
12019,2024,1,1,0,0,100,47695,1192,40
12021,2024,13,13,0,0,100,187935,1422,143
12022,2024,1,1,0,0,100,72000,655,110
12023,2024,5,5,0,0,100,57300,1098,66
12024,2024,3,3,0,0,100,110533,1128,85
12025,2024,8,7,1,12,88,104981,1008,116
12026,2024,10,10,0,0,100,142363,1445,100
12027,2024,1,1,0,0,100,157000,2617,60
12028,2024,9,9,0,0,100,62372,869,73
12030,2024,6,5,1,17,83,58061,676,91
12031,2024,1,1,0,0,100,66000,1245,53
12032,2024,2,2,0,0,100,232150,2062,112
12033,2024,20,15,5,25,75,174808,1801,94
12034,2024,1,1,0,0,100,106000,1233,86
12036,2024,7,7,0,0,100,94499,995,94
12037,2024,13,13,0,0,100,103966,2037,68
12038,2024,1,1,0,0,100,190000,1098,173
12039,2024,2,2,0,0,100,92858,844,122
12041,2024,2,2,0,0,100,76250,1021,80
12042,2024,1,1,0,0,100,180000,1565,115
12043,2024,10,10,0,0,100,223743,2379,92
12044,2024,12,10,2,17,83,99632,1036,94
12045,2024,5,5,0,0,100,226160,1553,119
12046,2024,4,4,0,0,100,178347,1556,108
12047,2024,5,5,0,0,100,117832,1362,97
12048,2024,2,2,0,0,100,151125,1300,116
12049,2024,5,4,1,20,80,112005,1402,75
12050,2024,5,5,0,0,100,134980,1539,85
12051,2024,6,6,0,0,100,138317,1464,88
12052,2024,56,48,8,14,86,122717,1396,91
12053,2024,5,5,0,0,100,173810,1469,124
12054,2024,5,5,0,0,100,141384,2195,89
12055,2024,2,2,0,0,100,37500,523,70
12056,2024,37,22,15,41,59,165417,1979,87
12057,2024,7,7,0,0,100,119021,1190,97
12059,2024,4,4,0,0,100,106250,958,128
12060,2024,1,1,0,0,100,152920,1353,113
12061,2024,3,3,0,0,100,143700,1300,100
12062,2024,5,5,0,0,100,115894,1569,68
12063,2024,11,9,2,18,82,138995,1682,78
12064,2024,1,1,0,0,100,248000,1033,240
12065,2024,3,3,0,0,100,139500,1362,103
12066,2024,4,4,0,0,100,139000,1568,101
12067,2024,5,4,1,20,80,150413,2094,77
12068,2024,11,11,0,0,100,123355,1387,100
12069,2024,3,3,0,0,100,173993,1834,95
12070,2024,3,3,0,0,100,247433,2538,104
12071,2024,3,3,0,0,100,65212,866,90
12072,2024,5,5,0,0,100,94732,1170,81
12073,2024,7,7,0,0,100,205820,2001,126
12074,2024,1,1,0,0,100,62500,1562,40
12075,2024,8,8,0,0,100,111862,1358,91
12076,2024,7,7,0,0,100,135512,1993,71
12077,2024,3,3,0,0,100,182433,1444,130
12078,2024,3,3,0,0,100,84833,1000,85
12079,2024,2,2,0,0,100,94925,958,95
12080,2024,1,1,0,0,100,50000,602,83
12082,2024,5,5,0,0,100,120219,1578,83
12083,2024,24,20,4,17,83,72768,1061,73
12084,2024,9,7,2,22,78,159644,2191,71
12085,2024,7,7,0,0,100,94007,1126,96
12086,2024,5,5,0,0,100,193370,2277,85
12088,2024,1,1,0,0,100,75500,563,134
12089,2024,60,48,12,20,80,88592,1134,86
12090,2024,16,16,0,0,100,237396,2150,112
12091,2024,6,6,0,0,100,135350,1169,117
12092,2024,7,7,0,0,100,93011,1121,84
12093,2024,1,1,0,0,100,194200,2428,80
12094,2024,15,15,0,0,100,125259,1518,89
12095,2024,3,3,0,0,100,148000,1661,91
12096,2024,77,37,40,52,48,128629,1481,88
12097,2024,5,5,0,0,100,106906,1132,96
12098,2024,13,12,1,8,92,145338,1723,95
12099,2024,6,6,0,0,100,102320,1229,79
12100,2024,27,22,5,19,81,112207,1417,82
12101,2024,10,10,0,0,100,133450,1662,80
12102,2024,13,12,1,8,92,154642,1819,89
12103,2024,3,3,0,0,100,142167,1438,106
12104,2024,4,4,0,0,100,113990,1932,65
12105,2024,12,12,0,0,100,211652,2003,108
12106,2024,5,5,0,0,100,213860,1661,111
12107,2024,5,5,0,0,100,149180,1780,96
12108,2024,1,1,0,0,100,177200,1656,107
12109,2024,3,3,0,0,100,90333,1079,98
12110,2024,4,4,0,0,100,128700,1281,108
12111,2024,1,1,0,0,100,60000,750,80
12113,2024,3,3,0,0,100,115017,1776,61
12115,2024,5,5,0,0,100,87400,898,96
12118,2024,4,3,1,25,75,152325,1523,98
12119,2024,29,15,14,48,52,125935,1680,75
12120,2024,25,17,8,32,68,166895,1724,100
12121,2024,10,8,2,20,80,324871,2865,112
12124,2024,2,2,0,0,100,211350,3152,76
12125,2024,5,5,0,0,100,81465,758,114
12127,2024,11,11,0,0,100,155732,1752,105
12129,2024,2,2,0,0,100,117752,1267,149
12130,2024,14,14,0,0,100,94743,1068,93
12131,2024,9,9,0,0,100,268005,2269,131
12133,2024,50,32,18,36,64,179659,2188,86
12134,2024,3,3,0,0,100,208990,2273,105
12135,2024,6,6,0,0,100,129168,1250,99
12136,2024,6,6,0,0,100,133467,1102,130
12137,2024,7,7,0,0,100,177471,1752,95
12138,2024,16,15,1,6,94,185440,1976,93
12139,2024,4,4,0,0,100,231925,1991,119
12140,2024,12,12,0,0,100,184743,1638,114
12141,2024,6,6,0,0,100,102993,995,104
12142,2024,2,2,0,0,100,97750,1486,66
12143,2024,1,1,0,0,100,36170,458,79
12144,2024,2,2,0,0,100,100000,994,108
12145,2024,272,105,167,61,39,156302,1979,78
12146,2024,16,11,5,31,69,194351,2392,79
12147,2024,5,5,0,0,100,60831,1026,66
12148,2024,16,12,4,25,75,135068,1548,92
12149,2024,2,2,0,0,100,70500,734,97
12150,2024,1,1,0,0,100,156000,1696,92
12151,2024,2,2,0,0,100,110000,1592,74
12152,2024,1,1,0,0,100,90000,750,120
12153,2024,12,12,0,0,100,82477,1107,79
12154,2024,5,5,0,0,100,63400,666,98
12155,2024,6,6,0,0,100,79835,1065,72
12156,2024,2,2,0,0,100,55000,790,67
12157,2024,16,14,2,12,88,150168,1714,94
12158,2024,4,4,0,0,100,220325,1735,130
12159,2024,4,4,0,0,100,117112,944,138
12160,2024,3,2,1,33,67,193217,1496,115
12161,2024,1,1,0,0,100,175000,2431,72
12162,2024,14,14,0,0,100,158059,1641,112
12163,2024,2,2,0,0,100,28000,422,69
12164,2024,8,6,2,25,75,105438,964,104
12165,2024,7,7,0,0,100,178299,2115,87
12167,2024,19,19,0,0,100,132028,1295,104
12168,2024,16,14,2,12,88,176589,1925,102
12169,2024,21,20,1,5,95,161469,1743,91
12170,2024,3,3,0,0,100,135000,1847,74
12171,2024,8,8,0,0,100,153831,1934,84
12172,2024,8,8,0,0,100,171935,1503,108
12174,2024,27,15,12,44,56,159879,2230,74
12175,2024,2,2,0,0,100,235250,1902,125
12176,2024,136,68,68,50,50,177595,2171,83
12177,2024,12,12,0,0,100,134901,1311,93
12179,2024,2,2,0,0,100,77000,810,95
12180,2024,1,1,0,0,100,61000,1220,50
12181,2024,3,3,0,0,100,165267,2000,77
12182,2024,1,1,0,0,100,224000,2333,96
12183,2024,5,5,0,0,100,139696,1438,97
12184,2024,3,3,0,0,100,121167,1518,99
12185,2024,6,5,1,17,83,148667,1578,97
12186,2024,2,2,0,0,100,53800,541,100
12187,2024,6,5,1,17,83,89052,1176,77
12188,2024,5,5,0,0,100,119800,1238,106
12189,2024,2,2,0,0,100,148342,1150,130
12190,2024,2,2,0,0,100,145000,1305,161
12191,2024,2,2,0,0,100,149850,1078,142
12192,2024,3,3,0,0,100,81667,1107,90
12193,2024,3,3,0,0,100,103768,1133,91
12194,2024,2,2,0,0,100,209000,2592,81
12195,2024,6,6,0,0,100,96967,1130,97
12197,2024,19,17,2,11,89,117238,1290,91
12198,2024,17,13,4,24,76,140648,1499,90
12199,2024,17,12,5,29,71,159156,1611,98
12200,2024,8,7,1,12,88,154945,1658,90
12201,2024,9,9,0,0,100,227218,1812,127
12202,2024,430,62,368,86,14,143068,2108,69
12203,2024,5,5,0,0,100,130380,1542,99
12204,2024,2,2,0,0,100,139000,1972,70
12205,2024,5,5,0,0,100,127060,1624,76
12206,2024,4,4,0,0,100,166375,1370,120
12207,2024,1,1,0,0,100,42800,611,70
12208,2024,102,64,38,37,63,133091,1514,87
12209,2024,5,4,1,20,80,168436,1688,104
12210,2024,4,4,0,0,100,115935,1309,101
12212,2024,2,2,0,0,100,115000,894,118
12213,2024,3,3,0,0,100,53896,579,95
12214,2024,1,1,0,0,100,255000,1723,148
12215,2024,13,12,1,8,92,198566,1910,104
12216,2024,14,14,0,0,100,137935,2056,74
12217,2024,5,5,0,0,100,119900,1404,83
12219,2024,5,5,0,0,100,118321,1227,93
12220,2024,4,4,0,0,100,142000,2033,80
12222,2024,2,2,0,0,100,127250,1246,86
12223,2024,15,14,1,7,93,126201,1098,110
12224,2024,32,21,11,34,66,100377,1388,76
12225,2024,17,16,1,6,94,178639,1751,116
12226,2024,5,5,0,0,100,53194,938,54
12227,2024,1,1,0,0,100,85000,1574,54
12228,2024,6,5,1,17,83,101842,1304,105
12229,2024,1,1,0,0,100,136000,1700,80
12230,2024,1,1,0,0,100,42000,568,74
12231,2024,13,7,6,46,54,104534,1319,73
12232,2024,1,1,0,0,100,266497,3135,85
12233,2024,4,4,0,0,100,104175,1604,61
12234,2024,4,4,0,0,100,234612,1939,125
12235,2024,3,3,0,0,100,164467,1656,119
12236,2024,3,3,0,0,100,85833,1015,74
12237,2024,12,11,1,8,92,89778,1170,85
12238,2024,4,4,0,0,100,115169,1503,74
12239,2024,3,3,0,0,100,181667,1744,105
12240,2024,6,6,0,0,100,98422,1117,76
12241,2024,11,11,0,0,100,296039,2592,106
12242,2024,1,1,0,0,100,50000,1136,44
12243,2024,6,6,0,0,100,134750,1317,110
12244,2024,14,13,1,7,93,127390,1350,93
12246,2024,5,5,0,0,100,106780,1205,80
12247,2024,5,5,0,0,100,102800,897,119
12248,2024,5,3,2,40,60,82436,1247,79
12249,2024,5,5,0,0,100,63250,529,125
12250,2024,1,1,0,0,100,161640,1050,154
12251,2024,3,3,0,0,100,188150,1563,115
12252,2024,4,4,0,0,100,95612,1415,66
12253,2024,23,20,3,13,87,191219,2617,74
12254,2024,18,18,0,0,100,206137,1754,117
12255,2024,10,10,0,0,100,197122,1688,111
12256,2024,8,8,0,0,100,177834,2242,93
12257,2024,9,9,0,0,100,176200,1660,108
12258,2024,12,12,0,0,100,115410,1289,92
12259,2024,7,7,0,0,100,152450,1490,102
12260,2024,2,2,0,0,100,136380,1498,89
12262,2024,12,11,1,8,92,139422,2094,92
12263,2024,5,5,0,0,100,161717,1622,106
12264,2024,27,24,3,11,89,229438,2732,90
12265,2024,8,8,0,0,100,135388,1524,88
12266,2024,1,1,0,0,100,90000,462,195
12267,2024,5,5,0,0,100,144540,1215,111
12268,2024,7,7,0,0,100,129071,1351,103
12270,2024,39,34,5,13,87,142333,1605,91
12272,2024,5,5,0,0,100,160854,1705,94
12273,2024,2,2,0,0,100,226000,2716,88
12274,2024,3,3,0,0,100,49100,877,56
12276,2024,2,2,0,0,100,135400,992,139
12277,2024,4,4,0,0,100,102684,1220,79
12278,2024,2,2,0,0,100,83240,1344,76
12280,2024,5,5,0,0,100,136080,1440,88
12281,2024,7,7,0,0,100,127613,1250,104
12282,2024,9,8,1,11,89,97611,959,101
12283,2024,5,5,0,0,100,105150,869,125
12284,2024,3,3,0,0,100,59383,557,103
12286,2024,11,11,0,0,100,181131,1446,134
12287,2024,6,6,0,0,100,194254,1887,108
12288,2024,18,18,0,0,100,240753,2078,112
12289,2024,1,1,0,0,100,222700,1687,132
12290,2024,4,4,0,0,100,108550,1517,76
12291,2024,3,3,0,0,100,116333,1252,90
12292,2024,2,2,0,0,100,200000,1724,116
12293,2024,1,1,0,0,100,47500,528,90
12294,2024,6,6,0,0,100,142902,1147,115
12295,2024,3,3,0,0,100,84167,1165,74
12296,2024,7,7,0,0,100,85000,1031,83
12297,2024,6,6,0,0,100,145990,2004,77
12298,2024,4,4,0,0,100,117525,1271,106
12299,2024,12,10,2,17,83,143060,1564,105
12300,2024,145,101,44,30,70,120252,1441,87
12301,2024,25,25,0,0,100,161742,1563,101
12303,2024,8,8,0,0,100,92211,1109,93
12305,2024,24,24,0,0,100,77636,920,80
12307,2024,2,2,0,0,100,143750,1208,118
13001,2024,1730,274,1456,84,16,360464,5300,66
13002,2024,171,110,61,36,64,370170,4445,86
13003,2024,15,14,1,7,93,282528,3201,93
13004,2024,564,348,216,38,62,221455,3004,75
13005,2024,427,130,297,70,30,267462,3471,75
13006,2024,13,12,1,8,92,344504,4065,88
13007,2024,95,54,41,43,57,331036,4121,81
13008,2024,2,1,1,50,50,364240,4493,80
13009,2024,8,7,1,12,88,404155,4127,96
13010,2024,34,25,9,26,74,254257,2939,90
13011,2024,13,4,9,69,31,607822,5532,74
13012,2024,4,4,0,0,100,773411,6620,115
13013,2024,17,16,1,6,94,463410,4344,106
13014,2024,77,42,35,45,55,234233,3091,78
13015,2024,134,104,30,22,78,515120,5322,98
13016,2024,48,37,11,23,77,386653,4523,87
13017,2024,8,7,1,12,88,390219,4366,96
13018,2024,40,33,7,18,82,240960,2776,88
13019,2024,71,67,4,6,94,680212,5716,120
13020,2024,12,7,5,42,58,278447,3962,67
13021,2024,80,44,36,45,55,514063,6067,88
13022,2024,112,31,81,72,28,600655,7919,79
13023,2024,44,35,9,20,80,513140,5047,96
13024,2024,26,18,8,31,69,264611,3559,77
13025,2024,8,6,2,25,75,492245,5232,101
13026,2024,139,91,48,35,65,279284,3718,79
13027,2024,186,120,66,35,65,244538,2813,87
13028,2024,598,139,459,77,23,350904,5491,63
13029,2024,8,7,1,12,88,411270,3666,107
13030,2024,41,31,10,24,76,328964,4062,80
13031,2024,34,14,20,59,41,311743,3860,81
13032,2024,77,54,23,30,70,694377,6354,103
13033,2024,39,22,17,44,56,370221,5266,71
13034,2024,24,24,0,0,100,1973105,9100,208
13035,2024,57,38,19,33,67,275134,3941,69
13036,2024,36,32,4,11,89,418532,3736,108
13037,2024,97,75,22,23,77,344004,4015,86
13038,2024,48,39,9,19,81,358679,4029,90
13039,2024,116,77,39,34,66,239117,3101,79
13040,2024,74,50,24,32,68,389069,5181,80
13041,2024,169,66,103,61,39,270135,3736,71
13042,2024,44,32,12,27,73,556404,5531,100
13043,2024,66,46,20,30,70,284412,3677,79
13044,2024,50,36,14,28,72,334447,3912,86
13045,2024,41,39,2,5,95,332370,3340,102
13046,2024,34,27,7,21,79,389725,4537,88
13047,2024,412,216,196,48,52,243618,3187,77
13048,2024,35,32,3,9,91,394245,3612,107
13049,2024,16,16,0,0,100,335242,3144,111
13050,2024,86,62,24,28,72,359687,3916,90
13051,2024,83,63,20,24,76,337187,3855,86
13052,2024,13,8,5,38,62,342564,4850,81
13053,2024,104,60,44,42,58,301022,3743,76
13054,2024,330,126,204,62,38,227526,2965,77
13055,2024,10269,1231,9038,88,12,227849,3521,63
13056,2024,473,186,287,61,39,245297,3480,73
13057,2024,4,4,0,0,100,319640,3265,100
13058,2024,43,38,5,12,88,721808,5911,119
13059,2024,27,21,6,22,78,340509,3878,84
13060,2024,56,31,25,45,55,442665,4772,91
13061,2024,1,1,0,0,100,270000,1800,150
13062,2024,29,29,0,0,100,525749,4970,108
13063,2024,238,112,126,53,47,208078,2798,76
13064,2024,22,21,1,5,95,398809,4008,100
13065,2024,54,47,7,13,87,396281,3959,93
13066,2024,45,37,8,18,82,376671,3339,103
13067,2024,18,17,1,6,94,229825,3077,86
13068,2024,24,21,3,12,88,481468,4740,101
13069,2024,123,94,29,24,76,331346,3809,87
13070,2024,55,25,30,55,45,274761,3600,77
13071,2024,170,120,50,29,71,331204,3974,83
13072,2024,35,24,11,31,69,433897,4614,92
13073,2024,44,33,11,25,75,370149,4482,87
13074,2024,56,35,21,38,62,326487,3843,84
13075,2024,129,64,65,50,50,335859,4476,77
13076,2024,29,28,1,3,97,374218,2998,114
13077,2024,135,68,67,50,50,201162,2808,72
13078,2024,63,37,26,41,59,194476,2527,76
13079,2024,10,7,3,30,70,310650,4121,75
13080,2024,60,45,15,25,75,467434,4708,97
13081,2024,97,61,36,37,63,292013,3545,83
13082,2024,38,37,1,3,97,770630,5249,148
13083,2024,21,18,3,14,86,265065,3030,90
13084,2024,40,34,6,15,85,268970,3114,88
13085,2024,39,20,19,49,51,360289,4615,79
13086,2024,63,40,23,37,63,371373,4573,79
13087,2024,52,26,26,50,50,309396,4022,75
13088,2024,40,26,14,35,65,365850,5277,75
13089,2024,34,22,12,35,65,242254,2562,90
13091,2024,43,32,11,26,74,454399,4563,97
13092,2024,101,54,47,47,53,245424,3417,73
13093,2024,1,1,0,0,100,210000,2958,71
13094,2024,25,19,6,24,76,369688,4495,96
13095,2024,7,7,0,0,100,1626272,8032,188
13096,2024,93,35,58,62,38,280894,5095,56
13097,2024,124,88,36,29,71,289653,3088,91
13098,2024,41,34,7,17,83,307367,3977,80
13099,2024,6,4,2,33,67,142500,1995,66
13100,2024,138,93,45,33,67,581410,5971,92
13101,2024,30,17,13,43,57,367052,4576,82
13102,2024,49,34,15,31,69,297898,3736,83
13103,2024,565,172,393,70,30,228521,3162,72
13104,2024,141,62,79,56,44,368262,6462,61
13105,2024,55,47,8,15,85,306952,3079,98
13106,2024,104,52,52,50,50,267582,3411,78
13107,2024,29,24,5,17,83,428883,4498,96
13108,2024,151,73,78,52,48,157873,1937,79
13109,2024,5,5,0,0,100,1693900,10999,142
13110,2024,132,89,43,33,67,306684,3852,82
13111,2024,7,3,4,57,43,785316,6610,103
13112,2024,69,61,8,12,88,442651,4676,95
13113,2024,73,49,24,33,67,436063,5023,87
13114,2024,52,44,8,15,85,724592,5612,125
13115,2024,29,29,0,0,100,378082,3800,103
13116,2024,3,3,0,0,100,373117,3885,101
13117,2024,326,127,199,61,39,262365,3592,74
13118,2024,27,19,8,30,70,343532,3982,87
13119,2024,78,36,42,54,46,378621,4207,86
14001,2024,12,12,0,0,100,315363,3298,99
14003,2024,2,2,0,0,100,235600,2099,114
14005,2024,10,10,0,0,100,214816,1693,125
14006,2024,12,12,0,0,100,259893,2175,120
14007,2024,2,2,0,0,100,292250,1954,140
14009,2024,10,10,0,0,100,398798,2762,149
14011,2024,8,8,0,0,100,200230,1891,107
14012,2024,3,3,0,0,100,388367,2385,163
14014,2024,9,9,0,0,100,359967,3361,106
14015,2024,6,6,0,0,100,512917,3032,163
14016,2024,8,8,0,0,100,259356,3207,86
14019,2024,2,2,0,0,100,664500,3308,174
14020,2024,27,27,0,0,100,237749,2404,100
14021,2024,15,11,4,27,73,244657,2993,84
14022,2024,12,11,1,8,92,180516,3283,67
14023,2024,2,2,0,0,100,204500,1682,123
14024,2024,5,4,1,20,80,411490,3231,115
14025,2024,3,3,0,0,100,121500,993,111
14026,2024,15,15,0,0,100,269796,2208,120
14027,2024,30,28,2,7,93,179019,1712,108
14030,2024,15,10,5,33,67,279720,2986,94
14032,2024,3,3,0,0,100,203000,2347,89
14033,2024,5,5,0,0,100,329324,2296,129
14034,2024,4,4,0,0,100,290362,2198,130
14035,2024,17,16,1,6,94,205557,1589,118
14036,2024,5,5,0,0,100,317121,2480,129
14037,2024,8,8,0,0,100,210875,1898,112
14038,2024,8,8,0,0,100,280844,3444,103
14039,2024,8,8,0,0,100,182811,1872,102
14040,2024,5,5,0,0,100,203685,2192,90
14041,2024,1,1,0,0,100,555000,3171,175
14042,2024,12,12,0,0,100,313946,2439,128
14043,2024,2,2,0,0,100,86008,785,112
14044,2024,10,10,0,0,100,296235,2613,109
14045,2024,2,2,0,0,100,165000,2542,70
14046,2024,18,18,0,0,100,319382,2978,107
14047,2024,158,72,86,54,46,198845,2467,79
14049,2024,3,3,0,0,100,422967,2858,149
14053,2024,2,2,0,0,100,105950,1332,77
14054,2024,3,3,0,0,100,54833,889,62
14055,2024,9,8,1,11,89,594129,4534,141
14057,2024,13,12,1,8,92,216485,2695,88
14059,2024,31,3,28,90,10,398558,6307,55
14060,2024,16,14,2,12,88,370322,3156,121
14061,2024,92,92,0,0,100,131445,1309,101
14062,2024,5,5,0,0,100,288260,3056,93
14063,2024,1,1,0,0,100,76000,571,133
14064,2024,2,2,0,0,100,185000,2314,82
14066,2024,62,41,21,34,66,269476,3792,74
14068,2024,27,25,2,7,93,332713,3023,115
14069,2024,19,17,2,11,89,148782,1842,81
14070,2024,3,3,0,0,100,613333,3414,194
14076,2024,57,37,20,35,65,239124,2805,86
14077,2024,9,9,0,0,100,296282,2973,97
14078,2024,4,4,0,0,100,193890,2366,84
14079,2024,98,26,72,73,27,259960,4574,57
14080,2024,1,1,0,0,100,30000,500,60
14082,2024,3,3,0,0,100,230507,2935,91
14083,2024,10,10,0,0,100,261838,2649,98
14084,2024,6,6,0,0,100,184561,2018,95
14085,2024,13,13,0,0,100,244323,2637,94
14086,2024,6,6,0,0,100,555708,4456,123
14087,2024,1,1,0,0,100,185000,1762,105
14088,2024,6,5,1,17,83,206283,2061,97
14089,2024,2,2,0,0,100,256750,2674,96
14090,2024,6,6,0,0,100,185650,1595,112
14091,2024,3,3,0,0,100,990333,5179,147
14092,2024,19,16,3,16,84,245571,2643,96
14093,2024,1,1,0,0,100,285000,3032,94
14096,2024,4,4,0,0,100,167750,1014,154
14098,2024,53,51,2,4,96,251623,2454,104
14100,2024,11,10,1,9,91,192767,2569,76
14101,2024,41,31,10,24,76,266265,3056,90
14102,2024,15,15,0,0,100,387744,3576,126
14103,2024,8,8,0,0,100,274529,2179,128
14104,2024,3,3,0,0,100,323333,3291,104
14106,2024,4,4,0,0,100,298300,2953,103
14107,2024,4,4,0,0,100,171590,1668,104
14110,2024,1,1,0,0,100,332450,2341,142
14111,2024,2,2,0,0,100,140000,1358,101
14116,2024,2,2,0,0,100,170300,2208,77
14117,2024,294,52,242,82,18,238426,5481,44
14118,2024,1795,265,1530,85,15,184336,3045,62
14119,2024,20,20,0,0,100,212665,2201,102
14120,2024,11,11,0,0,100,166105,1667,107
14121,2024,3,3,0,0,100,167467,1107,145
14122,2024,6,6,0,0,100,185042,1947,109
14123,2024,22,22,0,0,100,332303,2665,124
14124,2024,7,7,0,0,100,115889,1305,85
14125,2024,24,21,3,12,88,322597,2750,121
14126,2024,15,15,0,0,100,226790,2093,104
14127,2024,2,2,0,0,100,123220,1268,96
14130,2024,2,2,0,0,100,132500,1364,88
14131,2024,4,4,0,0,100,297000,2463,145
14134,2024,6,6,0,0,100,246020,1546,152
14135,2024,2,1,1,50,50,139750,1434,96
14137,2024,22,17,5,23,77,246590,3107,84
14138,2024,6,6,0,0,100,159092,1268,124
14140,2024,4,4,0,0,100,162250,1481,110
14141,2024,2,1,1,50,50,413750,2688,156
14143,2024,23,23,0,0,100,152727,1382,109
14145,2024,8,8,0,0,100,217481,2241,110
14147,2024,3,3,0,0,100,146467,1634,92
14149,2024,10,10,0,0,100,202740,2588,79
14150,2024,13,13,0,0,100,201042,2076,99
14159,2024,1,1,0,0,100,110000,1486,74
14160,2024,1,1,0,0,100,202000,2886,70
14161,2024,7,7,0,0,100,634139,4002,152
14162,2024,8,8,0,0,100,112919,1672,73
14165,2024,5,5,0,0,100,251698,2328,117
14166,2024,22,21,1,5,95,301371,3262,93
14167,2024,61,33,28,46,54,171787,2521,70
14169,2024,6,6,0,0,100,281754,2143,141
14172,2024,8,8,0,0,100,181264,2305,80
14173,2024,4,4,0,0,100,247900,2239,110
14174,2024,77,58,19,25,75,111167,1151,96
14175,2024,3,3,0,0,100,180083,1865,96
14177,2024,14,14,0,0,100,231236,2121,113
14179,2024,2,2,0,0,100,491500,3293,148
14180,2024,3,3,0,0,100,54133,976,57
14181,2024,56,36,20,36,64,195085,2362,81
14182,2024,5,5,0,0,100,131238,1193,114
14183,2024,1,1,0,0,100,137050,1523,90
14190,2024,3,3,0,0,100,114000,1572,71
14191,2024,186,43,143,77,23,163210,3500,48
14193,2024,7,7,0,0,100,318171,2325,120
14194,2024,7,7,0,0,100,231050,1857,131
14195,2024,5,5,0,0,100,186597,1773,100
14197,2024,13,13,0,0,100,389488,4470,118
14198,2024,1,1,0,0,100,215000,2263,95
14200,2024,23,23,0,0,100,208678,2264,94
14202,2024,4,4,0,0,100,683250,5128,129
14203,2024,2,2,0,0,100,549050,3198,145
14204,2024,1,1,0,0,100,95000,1638,58
14205,2024,2,2,0,0,100,312400,2235,140
14206,2024,3,3,0,0,100,188667,1428,130
14207,2024,6,6,0,0,100,228105,1766,115
14209,2024,4,4,0,0,100,217788,2187,102
14211,2024,4,4,0,0,100,171000,1982,91
14214,2024,3,3,0,0,100,230233,2142,110
14215,2024,14,14,0,0,100,305656,2522,122
14216,2024,3,3,0,0,100,174983,1417,115
14218,2024,4,4,0,0,100,370292,2757,127
14220,2024,243,53,190,78,22,434023,7015,60
14221,2024,30,27,3,10,90,213973,2334,94
14223,2024,2,2,0,0,100,132000,2054,60
14225,2024,90,53,37,41,59,218981,4031,59
14226,2024,4,4,0,0,100,242060,2307,102
14228,2024,57,41,16,28,72,280174,2957,96
14229,2024,29,29,0,0,100,198787,2225,89
14230,2024,2,2,0,0,100,135708,1587,86
14231,2024,3,3,0,0,100,470400,2951,145
14236,2024,5,5,0,0,100,250377,2122,119
14237,2024,3,3,0,0,100,238283,2384,103
14238,2024,2,2,0,0,100,520319,3903,132
14239,2024,1,1,0,0,100,180000,1682,107
14240,2024,4,4,0,0,100,157312,1710,90
14241,2024,7,7,0,0,100,179597,1764,103
14242,2024,19,15,4,21,79,312310,2993,106
14243,2024,19,10,9,47,53,263414,3145,77
14245,2024,6,6,0,0,100,187665,1833,104
14246,2024,10,8,2,20,80,247453,2431,95
14248,2024,4,4,0,0,100,278164,2273,143
14249,2024,11,11,0,0,100,243189,2189,112
14250,2024,4,4,0,0,100,222788,2890,77
14251,2024,5,5,0,0,100,181460,1908,95
14254,2024,13,11,2,15,85,290419,2879,101
14256,2024,3,3,0,0,100,166667,1858,98
14257,2024,18,17,1,6,94,206460,2431,90
14258,2024,86,54,32,37,63,144879,1829,82
14260,2024,2,2,0,0,100,476700,3639,156
14261,2024,5,5,0,0,100,380471,3308,115
14266,2024,13,13,0,0,100,244863,2495,96
14269,2024,3,3,0,0,100,435000,2953,146
14271,2024,67,38,29,43,57,236754,3082,76
14272,2024,3,3,0,0,100,86333,766,128
14273,2024,3,3,0,0,100,369000,3019,114
14274,2024,18,16,2,11,89,278374,2486,114
14275,2024,4,4,0,0,100,300000,2699,114
14276,2024,1,1,0,0,100,210100,1410,149
14277,2024,24,24,0,0,100,219898,2157,103
14278,2024,6,6,0,0,100,212777,2353,88
14280,2024,6,6,0,0,100,398883,3253,128
14281,2024,7,7,0,0,100,297911,2565,112
14282,2024,1,1,0,0,100,115000,1278,90
14283,2024,2,2,0,0,100,191000,3119,60
14284,2024,2,2,0,0,100,85500,550,160
14286,2024,4,4,0,0,100,291246,2085,140
14287,2024,22,22,0,0,100,232715,2512,95
14288,2024,11,11,0,0,100,291855,2684,108
14289,2024,8,8,0,0,100,182506,1598,120
14290,2024,2,2,0,0,100,192154,2390,81
14291,2024,3,3,0,0,100,173233,1586,137
14293,2024,6,6,0,0,100,571330,4454,120
14299,2024,10,10,0,0,100,387154,3443,107
14301,2024,41,38,3,7,93,245453,2567,97
14302,2024,1,1,0,0,100,150000,1744,86
14303,2024,6,6,0,0,100,224100,1617,134
14304,2024,12,12,0,0,100,338254,3211,111
14305,2024,14,14,0,0,100,606250,4297,145
14306,2024,5,5,0,0,100,355108,3646,101
14308,2024,5,5,0,0,100,344811,2087,168
14309,2024,6,6,0,0,100,195544,2305,86
14310,2024,13,13,0,0,100,187196,2045,96
14311,2024,13,13,0,0,100,277149,2438,115
14312,2024,61,36,25,41,59,148253,2418,59
14316,2024,3,3,0,0,100,301000,3045,101
14318,2024,8,8,0,0,100,276371,2491,113
14319,2024,9,9,0,0,100,237033,2613,94
14320,2024,4,4,0,0,100,211842,1992,108
14322,2024,4,4,0,0,100,312292,1941,166
14325,2024,50,40,10,20,80,227011,3136,74
14326,2024,7,7,0,0,100,288893,2385,112
14327,2024,201,49,152,76,24,146999,2290,64
14328,2024,16,16,0,0,100,244515,2553,97
14329,2024,3,3,0,0,100,319500,2484,140
14332,2024,5,5,0,0,100,156000,1783,92
14333,2024,129,51,78,60,40,244275,3422,71
14334,2024,6,6,0,0,100,178923,1783,103
14335,2024,5,5,0,0,100,211958,2275,95
14336,2024,6,6,0,0,100,299316,2134,134
14337,2024,1,1,0,0,100,190000,1681,113
14338,2024,141,36,105,74,26,234456,4306,54
14341,2024,118,62,56,47,53,185307,2415,78
14342,2024,50,38,12,24,76,127629,1520,85
14343,2024,2,2,0,0,100,132500,1567,84
14344,2024,7,7,0,0,100,275307,2628,109
14345,2024,4,4,0,0,100,137205,1369,103
14346,2024,3,3,0,0,100,244133,2249,103
14347,2024,12,12,0,0,100,163254,1887,98
14349,2024,16,16,0,0,100,241681,2218,110
14352,2024,12,12,0,0,100,125040,1148,118
14353,2024,6,6,0,0,100,188117,1794,103
14354,2024,20,15,5,25,75,248017,3714,70
14355,2024,12,12,0,0,100,297737,2449,130
14357,2024,12,12,0,0,100,109443,1049,106
14358,2024,1,1,0,0,100,241000,2802,86
14364,2024,4,4,0,0,100,268025,1836,148
14365,2024,34,25,9,26,74,257201,3666,75
14366,2024,256,92,164,64,36,134111,1883,71
14367,2024,2,2,0,0,100,402500,4519,80
14368,2024,4,4,0,0,100,163475,2267,71
14369,2024,2,2,0,0,100,179600,2052,91
14370,2024,38,38,0,0,100,192203,1998,100
14371,2024,84,82,2,2,98,182988,1725,106
14375,2024,1,1,0,0,100,96000,2043,47
14377,2024,5,5,0,0,100,270034,2335,117
14378,2024,5,5,0,0,100,148355,1574,104
14379,2024,2,2,0,0,100,333850,3055,110
14380,2024,3,3,0,0,100,232418,1732,136
14381,2024,1,1,0,0,100,148400,1484,100
14383,2024,16,15,1,6,94,267687,2841,97
14384,2024,58,36,22,38,62,266680,3744,75
14385,2024,1,1,0,0,100,333000,2043,163
14389,2024,6,6,0,0,100,185973,1710,108
14390,2024,1,1,0,0,100,278550,1668,167
14391,2024,8,8,0,0,100,236148,2240,113
14393,2024,4,4,0,0,100,263970,2349,118
14394,2024,5,5,0,0,100,196274,1942,107
14396,2024,10,10,0,0,100,270625,2697,102
14397,2024,7,7,0,0,100,216576,1693,124
14398,2024,6,5,1,17,83,234633,2397,91
14399,2024,7,7,0,0,100,372443,3176,119
14400,2024,1,1,0,0,100,300000,2222,135
14401,2024,2,2,0,0,100,320200,1514,212
14402,2024,2,2,0,0,100,146000,2848,51
14403,2024,5,5,0,0,100,175086,2210,86
14405,2024,2,2,0,0,100,159500,1828,88
14406,2024,7,7,0,0,100,216007,2167,114
14407,2024,27,24,3,11,89,418012,3350,124
14408,2024,18,14,4,22,78,169893,2360,75
14409,2024,87,41,46,53,47,259637,4602,59
14410,2024,15,15,0,0,100,228916,2079,114
14411,2024,3,3,0,0,100,99156,960,116
14412,2024,1,1,0,0,100,190050,2603,73
14419,2024,2,2,0,0,100,232250,2156,106
14421,2024,8,8,0,0,100,204733,1580,133
14424,2024,5,5,0,0,100,143800,1374,101
14425,2024,1,1,0,0,100,85000,1977,43
14426,2024,3,3,0,0,100,510000,2530,195
14427,2024,5,5,0,0,100,85224,1125,82
14430,2024,2,2,0,0,100,200000,1950,103
14431,2024,111,108,3,3,97,187473,1985,94
14435,2024,1,1,0,0,100,261300,1866,140
14436,2024,5,5,0,0,100,321984,3039,107
14437,2024,145,86,59,41,59,182334,2657,69
14438,2024,2,2,0,0,100,234500,2500,94
14439,2024,1,1,0,0,100,323500,2311,140
14445,2024,1,1,0,0,100,332000,1775,187
14446,2024,1,1,0,0,100,233370,2917,80
14448,2024,1,1,0,0,100,376730,2512,150
14449,2024,2,2,0,0,100,242500,1453,174
14452,2024,7,7,0,0,100,139679,1617,98
14453,2024,4,4,0,0,100,378896,2742,115
14454,2024,8,8,0,0,100,253150,2407,107
14455,2024,4,4,0,0,100,158300,1710,93
14456,2024,29,28,1,3,97,212638,2196,101
14457,2024,1,1,0,0,100,63500,690,92
14458,2024,6,6,0,0,100,194167,1833,102
14460,2024,18,18,0,0,100,244301,2616,93
14461,2024,5,5,0,0,100,205898,2349,88
14465,2024,1,1,0,0,100,368000,2067,178
14466,2024,7,7,0,0,100,335257,2771,118
14467,2024,1,1,0,0,100,110000,1719,64
14468,2024,2,2,0,0,100,117100,1217,96
14474,2024,2,2,0,0,100,550000,4952,97
14475,2024,19,19,0,0,100,179111,1920,99
14476,2024,4,4,0,0,100,220078,2420,131
14478,2024,39,35,4,10,90,129479,1498,83
14480,2024,5,5,0,0,100,165340,1491,116
14482,2024,2,2,0,0,100,170416,1899,97
14483,2024,1,1,0,0,100,152000,1689,90
14484,2024,4,4,0,0,100,371052,2018,157
14486,2024,4,4,0,0,100,120175,1781,64
14487,2024,11,11,0,0,100,203222,2054,102
14488,2024,206,108,98,48,52,232496,3618,67
14491,2024,5,5,0,0,100,214512,1975,102
14492,2024,2,2,0,0,100,317500,2884,110
14494,2024,1,1,0,0,100,510750,6810,75
14495,2024,7,7,0,0,100,464084,3166,153
14496,2024,2,2,0,0,100,68375,913,76
14497,2024,5,5,0,0,100,164848,1551,111
14498,2024,4,4,0,0,100,230000,1888,121
14499,2024,4,4,0,0,100,477948,3708,117
14500,2024,1,1,0,0,100,235000,5341,44
14501,2024,1,1,0,0,100,138000,862,160
14502,2024,2,2,0,0,100,42450,966,52
14504,2024,17,17,0,0,100,249423,2271,112
14506,2024,7,7,0,0,100,227166,1998,115
14509,2024,1,1,0,0,100,212000,1828,116
14510,2024,1,1,0,0,100,69330,1778,39
14512,2024,1,1,0,0,100,50000,431,116
14514,2024,46,36,10,22,78,277734,3190,87
14515,2024,33,20,13,39,61,180708,2624,72
14516,2024,26,26,0,0,100,136288,1872,76
14520,2024,5,5,0,0,100,197433,2106,96
14522,2024,1,1,0,0,100,244000,2976,82
14524,2024,4,4,0,0,100,234750,1834,139
14527,2024,6,6,0,0,100,300067,2507,113
14528,2024,3,3,0,0,100,233500,2068,113
14530,2024,21,21,0,0,100,283118,2841,97
14531,2024,1,1,0,0,100,40000,500,80
14533,2024,1,1,0,0,100,325000,2642,123
14534,2024,2,2,0,0,100,166275,1840,88
14535,2024,3,3,0,0,100,238583,2287,106
14536,2024,45,31,14,31,69,217567,2587,81
14538,2024,23,22,1,4,96,260731,2511,108
14540,2024,6,6,0,0,100,253667,3083,87
14541,2024,2,2,0,0,100,240000,1918,142
14542,2024,9,7,2,22,78,328501,2649,126
14543,2024,25,25,0,0,100,295226,2519,126
14546,2024,2,2,0,0,100,223730,2090,108
14547,2024,2,2,0,0,100,209890,1478,154
14550,2024,1,1,0,0,100,358500,3983,90
14552,2024,5,5,0,0,100,240200,2149,116
14554,2024,11,11,0,0,100,232798,2576,93
14555,2024,3,3,0,0,100,189810,2280,80
14556,2024,18,18,0,0,100,245749,2566,103
14557,2024,28,17,11,39,61,343305,4082,83
14558,2024,18,18,0,0,100,299298,2896,104
14559,2024,4,4,0,0,100,139034,1011,136
14562,2024,50,30,20,40,60,272642,3774,71
14563,2024,5,5,0,0,100,278760,2807,100
14565,2024,4,4,0,0,100,253500,4004,70
14566,2024,20,20,0,0,100,287382,2467,117
14570,2024,29,29,0,0,100,169384,1761,99
14571,2024,12,12,0,0,100,179101,1744,103
14572,2024,12,12,0,0,100,119283,1357,90
14574,2024,21,21,0,0,100,254704,2449,113
14575,2024,15,15,0,0,100,542695,4102,133
14576,2024,8,8,0,0,100,205988,1787,108
14578,2024,15,15,0,0,100,290457,2828,105
14579,2024,10,10,0,0,100,146470,1414,106
14582,2024,4,4,0,0,100,149000,1626,94
14586,2024,2,2,0,0,100,184510,1698,106
14587,2024,8,8,0,0,100,311412,2764,113
14588,2024,5,5,0,0,100,137360,1636,87
14589,2024,15,15,0,0,100,206613,2377,98
14590,2024,1,1,0,0,100,70000,897,78
14591,2024,8,8,0,0,100,180506,2232,90
14592,2024,16,16,0,0,100,264590,2119,125
14593,2024,12,12,0,0,100,806917,5067,152
14595,2024,4,4,0,0,100,233575,2448,109
14598,2024,2,2,0,0,100,307650,2604,117
14601,2024,2,2,0,0,100,206000,2836,70
14602,2024,7,7,0,0,100,114994,1099,100
14603,2024,7,7,0,0,100,228071,1879,124
14605,2024,4,4,0,0,100,205500,2171,99
14606,2024,1,1,0,0,100,397500,2989,133
14607,2024,1,1,0,0,100,157500,1853,85
14609,2024,1,1,0,0,100,107000,2184,49
14610,2024,19,17,2,11,89,257062,2431,110
14613,2024,5,5,0,0,100,147234,986,150
14614,2024,9,9,0,0,100,150723,1505,103
14619,2024,2,2,0,0,100,84372,822,100
14620,2024,5,5,0,0,100,556400,4582,121
14621,2024,10,10,0,0,100,189040,1738,105
14622,2024,2,2,0,0,100,72575,1104,66
14623,2024,18,18,0,0,100,206078,2557,85
14625,2024,10,10,0,0,100,322364,2463,144
14626,2024,8,8,0,0,100,180892,1922,96
14627,2024,4,4,0,0,100,177344,2025,86
14630,2024,7,7,0,0,100,364330,3764,111
14635,2024,5,5,0,0,100,171800,1443,135
14637,2024,2,2,0,0,100,315950,2838,112
14639,2024,2,2,0,0,100,383250,2586,124
14640,2024,2,2,0,0,100,164416,1944,84
14643,2024,6,6,0,0,100,211020,1900,117
14644,2024,11,11,0,0,100,303950,2521,124
14645,2024,3,3,0,0,100,609034,5516,95
14646,2024,3,3,0,0,100,199050,1972,101
14648,2024,3,3,0,0,100,175333,1845,96
14649,2024,2,2,0,0,100,219000,1666,134
14650,2024,3,3,0,0,100,198967,1591,122
14651,2024,2,2,0,0,100,520000,3542,140
14652,2024,2,2,0,0,100,195550,2386,84
14654,2024,100,96,4,4,96,171790,1849,96
14656,2024,9,9,0,0,100,144050,1741,101
14657,2024,3,3,0,0,100,811183,6323,117
14658,2024,63,63,0,0,100,124896,1268,96
14659,2024,16,16,0,0,100,183322,1926,97
14661,2024,2,2,0,0,100,279750,1763,162
14663,2024,11,11,0,0,100,313401,2738,115
14664,2024,2,2,0,0,100,124800,1912,76
14665,2024,5,5,0,0,100,407590,3600,124
14666,2024,14,13,1,7,93,267945,2462,111
14667,2024,3,3,0,0,100,151000,1189,152
14668,2024,3,3,0,0,100,169640,1678,97
14669,2024,1,1,0,0,100,205000,2662,77
14672,2024,10,10,0,0,100,120370,1159,92
14674,2024,2,2,0,0,100,169995,1504,109
14675,2024,22,22,0,0,100,283920,2661,107
14676,2024,52,12,40,77,23,87037,1222,59
14677,2024,3,3,0,0,100,250300,1397,182
14678,2024,9,9,0,0,100,160989,1987,90
14679,2024,8,8,0,0,100,196303,2132,89
14681,2024,3,3,0,0,100,238333,1957,120
14682,2024,10,10,0,0,100,357010,3158,113
14684,2024,5,5,0,0,100,280540,2044,143
14685,2024,16,16,0,0,100,256460,2175,126
14687,2024,2,2,0,0,100,318800,3094,103
14689,2024,39,33,6,15,85,183554,1769,107
14692,2024,25,25,0,0,100,191762,2093,97
14694,2024,4,4,0,0,100,233000,2276,99
14698,2024,2,2,0,0,100,157500,2685,57
14699,2024,93,40,53,57,43,301977,4174,70
14700,2024,7,7,0,0,100,143536,1526,99
14701,2024,66,11,55,83,17,442530,6275,64
14705,2024,1,1,0,0,100,55000,500,110
14706,2024,1,1,0,0,100,580000,4328,134
14707,2024,8,8,0,0,100,260970,2636,100
14708,2024,2,2,0,0,100,229100,2112,106
14709,2024,2,2,0,0,100,243000,1902,142
14710,2024,6,6,0,0,100,117633,1365,83
14711,2024,6,6,0,0,100,127494,1733,77
14712,2024,31,29,2,6,94,201606,2268,90
14713,2024,4,4,0,0,100,212510,1922,112
14714,2024,10,10,0,0,100,193334,1891,111
14715,2024,316,81,235,74,26,276569,5242,52
14716,2024,3,3,0,0,100,195000,1663,122
14719,2024,4,4,0,0,100,280590,2692,92
14720,2024,9,9,0,0,100,192167,2477,84
14721,2024,5,5,0,0,100,260400,2401,110
14723,2024,1,1,0,0,100,305000,2364,129
14724,2024,30,18,12,40,60,325023,4767,74
14726,2024,66,66,0,0,100,105217,1112,93
14728,2024,4,4,0,0,100,241998,2392,104
14731,2024,4,4,0,0,100,308500,4151,103
14732,2024,2,2,0,0,100,190000,2178,88
14733,2024,6,6,0,0,100,229200,1740,135
14734,2024,1,1,0,0,100,188500,2244,84
14735,2024,13,13,0,0,100,160852,1679,90
14737,2024,3,3,0,0,100,295167,1793,153
14738,2024,43,29,14,33,67,268931,2852,95
14739,2024,37,33,4,11,89,235143,2644,91
14740,2024,10,10,0,0,100,203230,1825,112
14741,2024,2,2,0,0,100,207850,2064,104
14743,2024,1,1,0,0,100,1750000,11986,146
14745,2024,4,4,0,0,100,248325,3947,72
14747,2024,8,8,0,0,100,251794,2425,105
14748,2024,1,1,0,0,100,485000,6062,80
14751,2024,4,4,0,0,100,157162,1644,94
14752,2024,18,15,3,17,83,213629,2248,102
14753,2024,3,3,0,0,100,261333,2271,118
14754,2024,322,36,286,89,11,170950,4484,39
14755,2024,25,22,3,12,88,339913,4782,74
14756,2024,2,2,0,0,100,184000,1890,96
14758,2024,7,7,0,0,100,579624,3089,178
14759,2024,3,3,0,0,100,180583,1994,104
14760,2024,3,3,0,0,100,163500,1901,88
14761,2024,5,5,0,0,100,290592,2531,121
14762,2024,188,141,47,25,75,141386,1590,91
14764,2024,17,17,0,0,100,125073,1328,94
15001,2024,8,8,0,0,100,65931,969,70
15002,2024,2,2,0,0,100,84300,730,108
15003,2024,8,8,0,0,100,121176,1425,110
15005,2024,1,1,0,0,100,366650,3161,116
15006,2024,8,8,0,0,100,117312,1374,100
15008,2024,6,6,0,0,100,67883,841,81
15009,2024,4,4,0,0,100,103500,1245,87
15010,2024,1,1,0,0,100,184000,1559,118
15011,2024,5,5,0,0,100,123664,1331,97
15012,2024,60,40,20,33,67,143378,1641,87
15013,2024,1,1,0,0,100,45000,357,126
15014,2024,399,98,301,75,25,107920,1443,75
15015,2024,3,3,0,0,100,67667,913,82
15016,2024,6,6,0,0,100,138817,1494,92
15017,2024,2,2,0,0,100,180950,1912,94
15019,2024,6,6,0,0,100,124950,1546,89
15020,2024,3,3,0,0,100,93317,1203,80
15021,2024,11,11,0,0,100,125421,1260,100
15022,2024,1,1,0,0,100,19800,660,30
15024,2024,1,1,0,0,100,28000,560,50
15025,2024,4,4,0,0,100,60500,1016,80
15026,2024,4,4,0,0,100,137700,1891,89
15027,2024,11,11,0,0,100,98124,1059,104
15029,2024,5,5,0,0,100,146833,1821,80
15034,2024,2,2,0,0,100,90250,810,103
15036,2024,3,3,0,0,100,112557,1635,87
15037,2024,13,13,0,0,100,95761,1155,87
15038,2024,13,13,0,0,100,82262,958,104
15041,2024,1,1,0,0,100,200000,1000,200
15042,2024,2,2,0,0,100,72500,946,75
15045,2024,14,12,2,14,86,119870,1585,71
15046,2024,6,6,0,0,100,152245,1373,119
15049,2024,3,3,0,0,100,33255,604,58
15050,2024,4,4,0,0,100,90950,1517,68
15051,2024,1,1,0,0,100,119000,1082,110
15052,2024,2,2,0,0,100,84470,1026,75
15053,2024,2,2,0,0,100,131148,1876,70
15054,2024,9,9,0,0,100,76833,941,89
15056,2024,7,7,0,0,100,201179,1789,125
15058,2024,2,2,0,0,100,96590,1687,58
15061,2024,3,3,0,0,100,70200,891,96
15063,2024,7,7,0,0,100,98282,871,110
15065,2024,1,1,0,0,100,120300,2673,45
15066,2024,4,4,0,0,100,132338,1790,82
15069,2024,4,4,0,0,100,37625,570,66
15070,2024,4,4,0,0,100,70025,1099,70
15072,2024,4,4,0,0,100,101800,1213,71
15073,2024,1,1,0,0,100,252000,1800,140
15074,2024,4,4,0,0,100,138776,1463,98
15076,2024,2,2,0,0,100,100500,1803,63
15080,2024,2,2,0,0,100,276250,1427,188
15081,2024,3,3,0,0,100,66000,740,103
15082,2024,2,2,0,0,100,75225,1456,52
15083,2024,25,23,2,8,92,152808,2021,87
15084,2024,1,1,0,0,100,216980,1955,111
15085,2024,2,2,0,0,100,139200,1772,78
15086,2024,1,1,0,0,100,92000,1095,84
15087,2024,2,2,0,0,100,287625,1690,169
15088,2024,11,11,0,0,100,139106,1816,83
15090,2024,5,5,0,0,100,199755,1795,123
15091,2024,2,2,0,0,100,84570,1050,88
15092,2024,10,10,0,0,100,166130,1550,106
15093,2024,1,1,0,0,100,37000,771,48
15094,2024,9,8,1,11,89,116659,1247,90
15095,2024,3,3,0,0,100,123467,1432,94
15096,2024,5,4,1,20,80,95260,1207,82
15100,2024,1,1,0,0,100,70000,972,72
15101,2024,26,9,17,65,35,97900,2600,38
15102,2024,1,1,0,0,100,116900,835,140
15103,2024,5,5,0,0,100,148160,1560,91
15104,2024,8,8,0,0,100,97778,1113,88
15106,2024,5,5,0,0,100,86235,1190,81
15107,2024,3,3,0,0,100,52333,591,90
15108,2024,7,7,0,0,100,143644,1603,89
15110,2024,3,3,0,0,100,56150,846,56
15111,2024,1,1,0,0,100,74496,1242,60
15113,2024,2,2,0,0,100,52500,756,70
15114,2024,5,5,0,0,100,86424,1277,73
15116,2024,1,1,0,0,100,262150,2017,130
15117,2024,6,5,1,17,83,123715,1616,91
15118,2024,9,8,1,11,89,196104,2521,92
15119,2024,20,14,6,30,70,106699,1256,88
15120,2024,36,25,11,31,69,107251,1175,88
15122,2024,23,17,6,26,74,105611,1513,84
15123,2024,1,1,0,0,100,125000,1603,78
15124,2024,7,7,0,0,100,82936,920,97
15126,2024,1,1,0,0,100,40000,370,108
15127,2024,4,4,0,0,100,92475,1222,71
15128,2024,2,2,0,0,100,86300,1338,75
15131,2024,7,7,0,0,100,139549,1369,93
15132,2024,3,3,0,0,100,82667,1109,74
15134,2024,9,8,1,11,89,87147,1282,78
15135,2024,2,2,0,0,100,181485,1130,154
15137,2024,1,1,0,0,100,168000,2074,81
15138,2024,23,19,4,17,83,136021,1623,93
15139,2024,1,1,0,0,100,159500,2127,75
15140,2024,17,17,0,0,100,171633,1724,102
15141,2024,10,10,0,0,100,126595,1231,97
15142,2024,13,12,1,8,92,101769,1037,99
15143,2024,3,3,0,0,100,164167,2154,79
15144,2024,1,1,0,0,100,295000,2122,139
15146,2024,4,4,0,0,100,166500,1421,117
15147,2024,4,4,0,0,100,142052,2233,88
15148,2024,1,1,0,0,100,136500,1187,115
15149,2024,1,1,0,0,100,90000,818,110
15151,2024,2,2,0,0,100,107250,848,132
15152,2024,4,4,0,0,100,82830,1113,78
15153,2024,22,22,0,0,100,86960,988,94
15154,2024,8,8,0,0,100,104044,1208,97
15155,2024,3,3,0,0,100,161030,1361,115
15156,2024,4,4,0,0,100,155438,1519,98
15157,2024,4,4,0,0,100,110750,1403,89
15158,2024,1,1,0,0,100,143815,1598,90
15159,2024,4,4,0,0,100,72000,1158,60
15160,2024,5,5,0,0,100,102900,1214,85
15161,2024,1,1,0,0,100,97000,1078,90
15162,2024,34,20,14,41,59,86559,1089,79
15163,2024,6,6,0,0,100,164919,1707,98
15165,2024,5,5,0,0,100,126826,1518,80
15166,2024,3,3,0,0,100,160833,1521,110
15168,2024,8,8,0,0,100,124369,1240,110
15169,2024,10,10,0,0,100,102460,1037,103
15170,2024,9,9,0,0,100,110942,1441,78
15172,2024,1,1,0,0,100,63630,568,112
15173,2024,2,2,0,0,100,86500,994,86
15174,2024,3,3,0,0,100,78890,1185,63
15175,2024,9,9,0,0,100,116626,1300,96
15176,2024,3,3,0,0,100,91633,1127,77
15178,2024,3,2,1,33,67,150697,1541,82
15179,2024,2,2,0,0,100,104000,1688,59
15181,2024,6,6,0,0,100,150170,1454,98
15182,2024,1,1,0,0,100,103000,1373,75
15183,2024,2,2,0,0,100,118750,1510,78
15184,2024,5,5,0,0,100,175406,1703,108
15185,2024,8,8,0,0,100,86186,1222,79
15186,2024,6,6,0,0,100,62833,1023,59
15187,2024,57,33,24,42,58,124509,1424,87
15188,2024,7,7,0,0,100,138339,2153,67
15189,2024,8,8,0,0,100,114721,2350,49
15191,2024,8,8,0,0,100,97609,1187,86
15192,2024,7,6,1,14,86,146751,1690,83
15194,2024,1,1,0,0,100,255000,2550,100
15196,2024,16,16,0,0,100,143683,1431,104
15199,2024,1,1,0,0,100,136000,1007,135
15200,2024,2,2,0,0,100,40230,431,95
15201,2024,1,1,0,0,100,80000,2000,40
15202,2024,4,4,0,0,100,82348,932,89
15203,2024,1,1,0,0,100,117000,2340,50
15204,2024,15,14,1,7,93,160435,1694,94
15205,2024,1,0,1,100,0,330000,3929,84
15206,2024,4,4,0,0,100,110325,1060,94
15207,2024,1,1,0,0,100,218000,1946,112
15208,2024,2,2,0,0,100,77754,746,101
15209,2024,1,1,0,0,100,59000,843,70
15211,2024,5,5,0,0,100,90640,930,100
15213,2024,4,4,0,0,100,123500,1668,75
15214,2024,1,1,0,0,100,203291,1955,104
15215,2024,11,11,0,0,100,166755,1804,100
15216,2024,4,4,0,0,100,162000,1610,100
15217,2024,1,1,0,0,100,230000,2054,112
15218,2024,4,4,0,0,100,163050,1618,88
15219,2024,6,5,1,17,83,112250,1239,123
15220,2024,1,1,0,0,100,25000,347,72
15221,2024,15,15,0,0,100,178312,1811,100
15222,2024,1,1,0,0,100,170000,2537,67
15223,2024,3,3,0,0,100,49333,607,93
15224,2024,2,2,0,0,100,108650,1270,84
15225,2024,3,3,0,0,100,106233,1594,85
15226,2024,1,1,0,0,100,20000,444,45
15228,2024,3,2,1,33,67,136000,1228,94
15230,2024,5,4,1,20,80,98810,1339,78
15231,2024,1,1,0,0,100,180700,2077,87
15233,2024,3,3,0,0,100,149677,1694,89
15234,2024,1,1,0,0,100,202000,1726,117
15235,2024,2,2,0,0,100,112250,1028,106
15236,2024,7,6,1,14,86,89691,1404,65
15237,2024,2,2,0,0,100,197500,2362,90
15238,2024,4,4,0,0,100,165865,1280,121
15240,2024,5,3,2,40,60,126005,1891,75
15241,2024,2,2,0,0,100,136340,884,142
15243,2024,6,6,0,0,100,97133,1134,85
15244,2024,6,6,0,0,100,125908,1014,122
15245,2024,1,1,0,0,100,143000,1788,80
15246,2024,4,4,0,0,100,151125,1300,110
15248,2024,4,4,0,0,100,106645,1278,88
15249,2024,3,3,0,0,100,71667,765,93
15250,2024,6,6,0,0,100,82333,929,87
15252,2024,6,6,0,0,100,199853,1661,114
15255,2024,10,10,0,0,100,161049,1868,83
15257,2024,2,2,0,0,100,163420,1348,122
15258,2024,25,17,8,32,68,111928,1406,83
15259,2024,1,1,0,0,100,115000,1045,110
15260,2024,3,3,0,0,100,184250,1914,114
15261,2024,9,9,0,0,100,109651,1328,80
15262,2024,1,1,0,0,100,251750,2014,125
15264,2024,3,3,0,0,100,64333,1094,56
15265,2024,14,14,0,0,100,102446,1121,96
15266,2024,6,6,0,0,100,110600,1370,87
15267,2024,45,45,0,0,100,175890,1858,97
15268,2024,13,13,0,0,100,121684,1673,75
15269,2024,1,1,0,0,100,148000,1682,88
16001,2024,9,9,0,0,100,94764,1104,98
16002,2024,11,11,0,0,100,83979,993,81
16003,2024,8,8,0,0,100,130253,1366,99
16005,2024,26,26,0,0,100,103424,1071,104
16007,2024,12,12,0,0,100,103089,949,108
16008,2024,4,4,0,0,100,238500,1128,167
16009,2024,9,9,0,0,100,114654,1095,104
16011,2024,8,8,0,0,100,199552,1684,118
16012,2024,4,4,0,0,100,187825,1554,133
16013,2024,1,1,0,0,100,258000,1564,165
16015,2024,592,360,232,39,61,133096,1778,77
16016,2024,5,5,0,0,100,105560,894,120
16018,2024,7,6,1,14,86,152904,1541,98
16019,2024,12,12,0,0,100,164408,1510,116
16020,2024,2,2,0,0,100,163500,1624,97
16023,2024,7,7,0,0,100,137414,1110,124
16024,2024,7,7,0,0,100,158143,1591,99
16025,2024,17,17,0,0,100,143949,1230,115
16026,2024,9,9,0,0,100,193944,2191,101
16027,2024,2,2,0,0,100,168875,984,163
16028,2024,43,39,4,9,91,154199,1583,108
16030,2024,10,10,0,0,100,151046,1415,111
16031,2024,4,4,0,0,100,159718,1259,118
16032,2024,8,8,0,0,100,120188,1216,94
16034,2024,2,2,0,0,100,88250,950,74
16035,2024,3,3,0,0,100,196983,2045,99
16036,2024,2,2,0,0,100,169000,1854,91
16037,2024,2,2,0,0,100,176708,1305,136
16038,2024,6,6,0,0,100,150164,1167,102
16039,2024,7,7,0,0,100,150414,1558,103
16040,2024,2,2,0,0,100,146000,1318,125
16041,2024,3,3,0,0,100,154333,772,164
16042,2024,4,4,0,0,100,157600,1402,104
16044,2024,3,3,0,0,100,113917,1050,108
16045,2024,2,2,0,0,100,234560,1466,165
16046,2024,16,16,0,0,100,107685,1000,100
16047,2024,3,3,0,0,100,104000,1072,97
16049,2024,8,8,0,0,100,206962,1704,128
16050,2024,1,1,0,0,100,215000,1493,144
16052,2024,3,3,0,0,100,182933,1167,163
16053,2024,1,1,0,0,100,135500,1050,129
16054,2024,1,1,0,0,100,111970,991,113
16055,2024,4,4,0,0,100,245920,1528,156
16056,2024,15,15,0,0,100,212438,1497,139
16057,2024,1,1,0,0,100,50000,625,80
16058,2024,23,23,0,0,100,154690,1559,99
16059,2024,5,5,0,0,100,81500,723,122
16060,2024,4,4,0,0,100,85725,1014,92
16061,2024,29,29,0,0,100,185508,1736,107
16064,2024,14,14,0,0,100,100885,1082,98
16065,2024,14,14,0,0,100,88401,893,103
16066,2024,3,3,0,0,100,87807,1002,90
16067,2024,8,8,0,0,100,127281,1397,90
16068,2024,8,8,0,0,100,140239,1531,110
16069,2024,7,7,0,0,100,139612,1225,121
16070,2024,27,27,0,0,100,77146,904,87
16071,2024,11,11,0,0,100,107994,1186,84
16072,2024,4,4,0,0,100,138000,1492,93
16073,2024,31,31,0,0,100,125580,1202,100
16074,2024,2,2,0,0,100,153125,1390,118
16076,2024,12,12,0,0,100,111984,1175,97
16077,2024,2,2,0,0,100,152500,2010,84
16078,2024,49,49,0,0,100,187696,1706,110
16079,2024,3,3,0,0,100,220667,2174,104
16081,2024,2,2,0,0,100,142125,1278,106
16082,2024,2,2,0,0,100,171250,1808,95
16083,2024,4,4,0,0,100,127388,940,129
16084,2024,3,2,1,33,67,127000,1337,95
16085,2024,30,29,1,3,97,122163,1161,106
16086,2024,15,15,0,0,100,96860,1195,80
16087,2024,5,5,0,0,100,140600,1330,113
16088,2024,18,18,0,0,100,203422,1634,132
16089,2024,33,32,1,3,97,179834,1862,95
16090,2024,25,23,2,8,92,172032,1782,110
16091,2024,5,5,0,0,100,116900,1075,116
16093,2024,11,11,0,0,100,145845,1157,122
16095,2024,2,2,0,0,100,107725,826,126
16096,2024,4,4,0,0,100,91750,1089,84
16097,2024,41,41,0,0,100,158371,1426,110
16098,2024,1,1,0,0,100,287200,990,290
16100,2024,13,13,0,0,100,118584,1346,100
16101,2024,9,9,0,0,100,167500,1301,136
16102,2024,274,209,65,24,76,160928,1853,89
16103,2024,3,3,0,0,100,204837,1321,148
16104,2024,4,4,0,0,100,141750,1349,104
16105,2024,6,6,0,0,100,172917,991,172
16106,2024,31,31,0,0,100,102142,1112,94
16107,2024,9,9,0,0,100,152676,1291,118
16108,2024,2,2,0,0,100,234105,1706,136
16109,2024,7,7,0,0,100,156171,1548,104
16110,2024,13,13,0,0,100,120581,1165,109
16111,2024,2,2,0,0,100,190000,963,162
16112,2024,1,1,0,0,100,214000,1163,184
16113,2024,61,60,1,2,98,153425,1663,92
16114,2024,6,6,0,0,100,166909,1257,151
16116,2024,2,2,0,0,100,153500,1320,102
16117,2024,1,1,0,0,100,81000,1800,45
16119,2024,17,17,0,0,100,116937,1237,95
16120,2024,8,8,0,0,100,229044,1666,130
16121,2024,2,2,0,0,100,216950,1828,95
16122,2024,1,1,0,0,100,67568,965,70
16123,2024,3,3,0,0,100,255667,2142,119
16124,2024,21,21,0,0,100,122109,1365,97
16125,2024,2,2,0,0,100,92102,1480,68
16127,2024,2,2,0,0,100,92000,538,150
16128,2024,4,4,0,0,100,87109,1153,84
16130,2024,3,3,0,0,100,141444,1452,100
16131,2024,11,11,0,0,100,145167,1157,116
16132,2024,12,12,0,0,100,79872,949,82
16134,2024,6,6,0,0,100,118649,1416,86
16135,2024,2,2,0,0,100,135500,1069,106
16136,2024,5,5,0,0,100,98558,1047,93
16137,2024,4,4,0,0,100,112250,1098,121
16138,2024,37,35,2,5,95,191243,1796,109
16139,2024,2,2,0,0,100,118450,1226,97
16141,2024,2,2,0,0,100,91100,1143,76
16142,2024,1,1,0,0,100,235000,1577,149
16143,2024,7,7,0,0,100,172468,1708,107
16144,2024,11,11,0,0,100,123486,1080,119
16145,2024,6,6,0,0,100,217255,1766,112
16146,2024,19,19,0,0,100,187467,1679,112
16148,2024,10,10,0,0,100,128916,1029,126
16150,2024,15,15,0,0,100,199162,1735,110
16151,2024,8,8,0,0,100,177994,1306,136
16152,2024,7,7,0,0,100,206171,1906,107
16153,2024,16,16,0,0,100,161699,1420,109
16154,2024,78,69,9,12,88,123578,1517,83
16155,2024,4,4,0,0,100,93000,942,96
16157,2024,2,2,0,0,100,48100,696,70
16158,2024,1,1,0,0,100,140000,1443,97
16160,2024,2,2,0,0,100,172125,1890,92
16161,2024,2,2,0,0,100,71500,864,95
16162,2024,2,2,0,0,100,37500,574,63
16163,2024,6,6,0,0,100,164708,1506,116
16164,2024,6,6,0,0,100,141612,1235,105
16165,2024,2,2,0,0,100,130000,928,135
16166,2024,73,61,12,16,84,143496,1751,84
16167,2024,57,57,0,0,100,149674,1507,100
16168,2024,11,11,0,0,100,219173,1556,139
16169,2024,7,7,0,0,100,99086,1154,93
16170,2024,8,8,0,0,100,106652,1114,91
16171,2024,6,6,0,0,100,181710,1656,120
16173,2024,1,1,0,0,100,150550,1276,118
16174,2024,4,4,0,0,100,202900,1864,109
16175,2024,6,6,0,0,100,146000,1621,96
16176,2024,2,2,0,0,100,386300,1726,214
16178,2024,1,1,0,0,100,78045,830,94
16180,2024,4,4,0,0,100,166250,1483,117
16181,2024,5,5,0,0,100,92400,1010,80
16182,2024,9,9,0,0,100,89105,1073,90
16183,2024,4,4,0,0,100,54811,1064,60
16184,2024,2,2,0,0,100,87885,1220,90
16186,2024,4,4,0,0,100,109625,1002,118
16187,2024,11,11,0,0,100,120118,1379,86
16188,2024,7,7,0,0,100,129614,1184,101
16189,2024,7,7,0,0,100,140543,1058,130
16190,2024,3,3,0,0,100,80667,753,108
16192,2024,47,47,0,0,100,89665,1030,91
16193,2024,10,10,0,0,100,191522,1819,102
16194,2024,1,1,0,0,100,199000,1531,130
16195,2024,1,1,0,0,100,60000,968,62
16196,2024,12,12,0,0,100,148238,1122,126
16197,2024,2,2,0,0,100,111450,1121,100
16198,2024,3,3,0,0,100,183217,2326,81
16199,2024,38,38,0,0,100,169846,1683,103
16200,2024,3,3,0,0,100,61000,874,72
16203,2024,2,2,0,0,100,107120,906,120
16204,2024,11,11,0,0,100,157936,1369,115
16205,2024,9,9,0,0,100,84107,1095,83
16206,2024,31,31,0,0,100,117361,1220,97
16207,2024,6,6,0,0,100,149330,1286,125
16208,2024,4,4,0,0,100,215912,1522,144
16209,2024,6,6,0,0,100,173600,1514,116
16210,2024,7,7,0,0,100,158693,1447,110
16211,2024,6,5,1,17,83,118115,1188,110
16212,2024,6,6,0,0,100,114640,1120,108
16213,2024,1,1,0,0,100,53000,520,102
16215,2024,4,4,0,0,100,166619,1539,113
16216,2024,8,8,0,0,100,219231,1758,131
16217,2024,10,10,0,0,100,158525,1573,105
16218,2024,4,4,0,0,100,164375,1156,136
16220,2024,4,4,0,0,100,225550,1916,122
16221,2024,3,3,0,0,100,161966,1293,120
16222,2024,8,8,0,0,100,198126,1495,129
16223,2024,25,24,1,4,96,122642,1570,92
16224,2024,5,5,0,0,100,156000,1215,115
16225,2024,11,11,0,0,100,81536,1069,80
16226,2024,9,8,1,11,89,107280,1354,79
16227,2024,3,2,1,33,67,174612,2362,68
16229,2024,6,6,0,0,100,89428,1222,89
16230,2024,34,33,1,3,97,133569,1279,109
16231,2024,6,6,0,0,100,110883,1692,66
16232,2024,12,12,0,0,100,169773,1631,115
16233,2024,8,8,0,0,100,194688,1438,138
16234,2024,7,7,0,0,100,200563,1447,138
16236,2024,16,16,0,0,100,186216,1699,110
16237,2024,1,1,0,0,100,80000,964,83
16238,2024,1,1,0,0,100,20000,465,43
16240,2024,3,3,0,0,100,353833,1344,224
16241,2024,4,4,0,0,100,149927,1232,124
16242,2024,23,23,0,0,100,125966,1205,105
16243,2024,7,7,0,0,100,170550,1592,110
16244,2024,17,15,2,12,88,168769,1633,102
16245,2024,10,10,0,0,100,62050,956,64
16246,2024,1,1,0,0,100,37000,457,81
16248,2024,3,3,0,0,100,83847,802,96
16249,2024,1,1,0,0,100,665000,7000,95
16250,2024,5,5,0,0,100,168596,1501,106
16251,2024,1,1,0,0,100,130000,1313,99
16253,2024,3,3,0,0,100,62813,1133,56
16254,2024,3,3,0,0,100,115500,1113,112
16255,2024,2,2,0,0,100,70250,685,102
16256,2024,1,1,0,0,100,145000,858,169
16258,2024,3,3,0,0,100,187050,1623,114
16260,2024,6,6,0,0,100,139890,1912,74
16261,2024,6,6,0,0,100,64958,844,96
16263,2024,2,2,0,0,100,144000,920,170
16264,2024,5,5,0,0,100,69412,832,80
16268,2024,4,4,0,0,100,229839,1882,109
16269,2024,8,8,0,0,100,154098,1604,100
16270,2024,12,12,0,0,100,87562,919,98
16271,2024,25,25,0,0,100,250879,1883,132
16272,2024,3,3,0,0,100,165790,1460,117
16273,2024,1,1,0,0,100,106370,858,124
16275,2024,4,4,0,0,100,101725,1115,84
16276,2024,7,7,0,0,100,122714,1222,105
16277,2024,6,6,0,0,100,237333,1850,140
16279,2024,5,5,0,0,100,135133,1113,120
16280,2024,27,27,0,0,100,150123,1685,89
16281,2024,56,54,2,4,96,145290,1532,96
16282,2024,6,6,0,0,100,130083,1484,86
16283,2024,9,9,0,0,100,217006,1402,136
16285,2024,4,4,0,0,100,97424,1129,84
16286,2024,28,28,0,0,100,126372,1233,105
16287,2024,36,36,0,0,100,180017,1651,111
16289,2024,6,6,0,0,100,96817,1014,89
16290,2024,9,9,0,0,100,259609,1677,148
16291,2024,90,86,4,4,96,136501,1625,86
16292,2024,60,57,3,5,95,115162,1247,95
16293,2024,6,6,0,0,100,121233,1169,116
16295,2024,13,13,0,0,100,99127,1106,92
16297,2024,2,2,0,0,100,70000,430,165
16298,2024,5,5,0,0,100,184590,1718,107
16300,2024,19,19,0,0,100,128392,1201,103
16301,2024,2,2,0,0,100,294000,2141,147
16303,2024,4,4,0,0,100,144938,1134,122
16304,2024,9,9,0,0,100,222109,1823,118
16306,2024,7,7,0,0,100,102107,1201,88
16307,2024,4,4,0,0,100,169408,1344,102
16308,2024,13,13,0,0,100,94067,989,98
16310,2024,2,2,0,0,100,94725,795,124
16312,2024,2,2,0,0,100,53750,829,71
16316,2024,5,5,0,0,100,147312,1207,120
16317,2024,5,5,0,0,100,101340,988,98
16318,2024,4,4,0,0,100,109000,1150,93
16320,2024,13,13,0,0,100,143892,1445,106
16323,2024,5,5,0,0,100,133400,1262,101
16325,2024,2,2,0,0,100,87500,916,96
16326,2024,1,1,0,0,100,116250,1224,95
16329,2024,12,12,0,0,100,98691,953,98
16330,2024,7,7,0,0,100,230784,1616,138
16334,2024,1,1,0,0,100,143000,1117,128
16336,2024,7,7,0,0,100,106500,1095,104
16337,2024,12,12,0,0,100,104349,911,112
16338,2024,4,4,0,0,100,153625,1528,102
16339,2024,8,8,0,0,100,130705,1141,110
16340,2024,9,9,0,0,100,143250,1060,121
16341,2024,35,25,10,29,71,144961,1783,82
16342,2024,5,5,0,0,100,153480,1107,147
16343,2024,1,1,0,0,100,310500,2141,145
16345,2024,1,1,0,0,100,100000,909,110
16346,2024,4,4,0,0,100,150576,1092,128
16347,2024,5,5,0,0,100,216095,1399,152
16348,2024,8,8,0,0,100,211038,1353,153
16349,2024,1,1,0,0,100,376700,2354,160
16350,2024,10,10,0,0,100,127819,1217,106
16352,2024,3,3,0,0,100,73670,928,91
16353,2024,7,7,0,0,100,192486,2005,101
16354,2024,1,1,0,0,100,122650,791,155
16356,2024,3,3,0,0,100,197175,1463,132
16357,2024,2,2,0,0,100,47500,629,73
16358,2024,94,89,5,5,95,180264,1849,101
16359,2024,6,6,0,0,100,200336,1310,134
16361,2024,9,9,0,0,100,117922,942,125
16362,2024,5,5,0,0,100,154398,1259,116
16363,2024,3,3,0,0,100,192945,1536,128
16364,2024,1,1,0,0,100,241025,1545,156
16366,2024,19,19,0,0,100,152588,1422,112
16368,2024,5,5,0,0,100,169400,1517,112
16369,2024,5,5,0,0,100,192821,1343,132
16370,2024,12,12,0,0,100,167733,1644,104
16372,2024,3,3,0,0,100,243417,1726,115
16373,2024,3,3,0,0,100,109500,1167,94
16374,2024,107,92,15,14,86,154560,1699,94
16375,2024,3,3,0,0,100,164784,1022,149
16377,2024,2,2,0,0,100,85432,1042,82
16378,2024,5,5,0,0,100,131900,1224,111
16379,2024,17,17,0,0,100,152025,1540,99
16380,2024,4,4,0,0,100,164200,1043,153
16381,2024,5,5,0,0,100,151840,1476,95
16382,2024,6,6,0,0,100,189954,1370,132
16383,2024,5,5,0,0,100,153940,1435,110
16384,2024,10,10,0,0,100,197973,1352,146
16385,2024,7,7,0,0,100,199800,2049,93
16387,2024,7,7,0,0,100,182200,1267,127
16388,2024,8,8,0,0,100,165826,1967,86
16390,2024,3,3,0,0,100,111167,917,116
16392,2024,2,2,0,0,100,153400,1155,128
16393,2024,22,22,0,0,100,172430,1719,104
16394,2024,2,2,0,0,100,150416,918,174
16395,2024,2,2,0,0,100,126500,1732,78
16396,2024,1,1,0,0,100,77000,1013,76
16397,2024,3,3,0,0,100,176403,1040,184
16398,2024,3,3,0,0,100,166533,1411,118
16399,2024,1,1,0,0,100,92000,893,103
16400,2024,24,24,0,0,100,194865,1542,115
16401,2024,1,1,0,0,100,262400,1458,180
16402,2024,5,5,0,0,100,205450,1686,115
16403,2024,4,4,0,0,100,64875,776,77
16404,2024,3,3,0,0,100,209524,1206,158
16406,2024,6,6,0,0,100,172983,1488,116
16408,2024,7,7,0,0,100,182143,1035,152
16409,2024,9,9,0,0,100,114514,1108,110
16412,2024,5,5,0,0,100,187208,1506,133
16413,2024,3,3,0,0,100,139667,996,141
16414,2024,8,8,0,0,100,103027,993,105
16415,2024,10,10,0,0,100,148256,1526,96
16416,2024,3,3,0,0,100,107115,1167,85
16418,2024,10,10,0,0,100,151805,1510,101
16419,2024,4,4,0,0,100,70750,962,74
16420,2024,2,2,0,0,100,112975,950,107
16421,2024,6,6,0,0,100,126833,1022,112
16422,2024,4,4,0,0,100,152602,1120,132
16423,2024,7,7,0,0,100,103286,1284,88
16424,2024,6,6,0,0,100,178784,1794,105
16425,2024,6,6,0,0,100,156667,1464,111
17002,2024,1,1,0,0,100,120000,1412,85
17003,2024,53,53,0,0,100,276609,3006,95
17004,2024,5,5,0,0,100,436600,7128,74
17005,2024,2,2,0,0,100,139043,891,161
17007,2024,3,3,0,0,100,451000,2364,204
17008,2024,12,12,0,0,100,210045,2222,107
17009,2024,24,24,0,0,100,294756,2966,100
17010,2024,61,56,5,8,92,398415,3995,99
17011,2024,5,5,0,0,100,250200,1894,143
17012,2024,2,2,0,0,100,61500,830,75
17013,2024,10,10,0,0,100,111988,1026,103
17015,2024,15,15,0,0,100,246299,2342,112
17016,2024,6,6,0,0,100,113333,1301,87
17017,2024,12,12,0,0,100,156085,1650,101
17018,2024,15,15,0,0,100,222825,1985,117
17019,2024,28,28,0,0,100,708388,7182,100
17020,2024,2,2,0,0,100,132500,1240,107
17021,2024,63,57,6,10,90,239791,2708,90
17022,2024,14,14,0,0,100,145052,1336,107
17023,2024,4,4,0,0,100,194318,1994,109
17024,2024,27,27,0,0,100,121486,1400,89
17025,2024,5,5,0,0,100,200220,1451,130
17026,2024,3,3,0,0,100,111667,1568,85
17027,2024,7,7,0,0,100,154445,1509,129
17028,2024,138,96,42,30,70,293528,3771,79
17029,2024,2,2,0,0,100,168750,1305,130
17030,2024,2,2,0,0,100,128500,1195,121
17031,2024,3,3,0,0,100,154842,1327,115
17032,2024,10,10,0,0,100,297615,2687,116
17033,2024,1,1,0,0,100,112526,1184,95
17034,2024,4,4,0,0,100,251750,2000,123
17035,2024,2,2,0,0,100,94250,846,102
17036,2024,11,11,0,0,100,240657,2002,124
17037,2024,4,4,0,0,100,77875,841,98
17038,2024,5,5,0,0,100,144444,1542,93
17039,2024,1,1,0,0,100,260541,1974,132
17041,2024,23,23,0,0,100,188100,1817,105
17042,2024,4,4,0,0,100,182375,1558,132
17043,2024,9,9,0,0,100,135889,1325,98
17044,2024,16,16,0,0,100,191172,1848,104
17045,2024,14,14,0,0,100,196636,1566,126
17046,2024,8,8,0,0,100,119938,1285,93
17047,2024,5,5,0,0,100,141150,1555,100
17048,2024,4,4,0,0,100,133250,1174,114
17049,2024,1,1,0,0,100,91352,1142,80
17050,2024,5,5,0,0,100,233321,1404,188
17051,2024,66,66,0,0,100,869548,7991,108
17052,2024,10,10,0,0,100,166188,1496,109
17053,2024,12,12,0,0,100,112044,1306,86
17054,2024,2,2,0,0,100,55770,652,102
17055,2024,3,3,0,0,100,92799,1207,78
17056,2024,5,5,0,0,100,171740,1808,91
17057,2024,8,8,0,0,100,209456,2160,98
17058,2024,49,47,2,4,96,187522,2297,89
17059,2024,16,16,0,0,100,421972,3141,131
17060,2024,2,2,0,0,100,105250,1270,94
17062,2024,7,7,0,0,100,113884,1143,109
17063,2024,1,1,0,0,100,185000,1321,140
17064,2024,59,59,0,0,100,339829,3305,103
17065,2024,16,16,0,0,100,312185,2728,117
17066,2024,2,2,0,0,100,404500,2080,182
17067,2024,1,1,0,0,100,80000,503,159
17068,2024,4,4,0,0,100,169500,1799,100
17069,2024,6,6,0,0,100,127453,1266,99
17070,2024,11,11,0,0,100,125982,1229,106
17071,2024,1,1,0,0,100,83000,512,162
17072,2024,16,16,0,0,100,155738,1513,106
17073,2024,14,14,0,0,100,179420,1764,99
17074,2024,9,9,0,0,100,197383,1495,136
17075,2024,14,14,0,0,100,228179,2144,104
17076,2024,3,3,0,0,100,234667,2042,119
17077,2024,12,12,0,0,100,166875,2549,90
17078,2024,5,5,0,0,100,182234,2026,114
17079,2024,26,26,0,0,100,228250,2217,108
17080,2024,17,17,0,0,100,194823,1893,107
17081,2024,4,4,0,0,100,175125,1711,106
17082,2024,2,2,0,0,100,165000,1704,98
17083,2024,8,8,0,0,100,195288,1652,121
17085,2024,1,1,0,0,100,167000,2257,74
17086,2024,33,33,0,0,100,190455,1822,107
17087,2024,1,1,0,0,100,238000,1919,124
17089,2024,9,9,0,0,100,226312,2122,103
17091,2024,30,30,0,0,100,225658,2395,96
17092,2024,3,3,0,0,100,150143,1385,117
17093,2024,71,67,4,6,94,257756,3374,79
17094,2024,130,96,34,26,74,354402,5100,73
17097,2024,12,12,0,0,100,200658,2690,80
17098,2024,12,12,0,0,100,185046,1984,97
17099,2024,10,10,0,0,100,155460,1412,110
17100,2024,10,10,0,0,100,135238,1363,100
17101,2024,7,7,0,0,100,128564,1301,98
17102,2024,7,7,0,0,100,218691,2332,94
17104,2024,10,10,0,0,100,115832,1148,97
17105,2024,5,5,0,0,100,109200,1453,86
17106,2024,2,2,0,0,100,173800,1830,96
17107,2024,16,16,0,0,100,213298,2235,93
17108,2024,2,2,0,0,100,251565,2100,122
17109,2024,16,14,2,12,88,362824,3199,116
17110,2024,5,5,0,0,100,208400,1567,132
17111,2024,10,10,0,0,100,167481,1465,110
17112,2024,7,7,0,0,100,224186,1949,114
17113,2024,7,7,0,0,100,138643,1443,98
17114,2024,3,3,0,0,100,140667,1171,119
17115,2024,2,2,0,0,100,88500,944,88
17116,2024,3,3,0,0,100,121333,1256,102
17117,2024,1,1,0,0,100,55000,550,100
17118,2024,5,5,0,0,100,141780,1681,93
17119,2024,11,11,0,0,100,247316,2198,112
17120,2024,24,24,0,0,100,200253,2057,96
17121,2024,35,34,1,3,97,764660,7621,102
17122,2024,3,3,0,0,100,146667,1430,123
17124,2024,3,3,0,0,100,167833,1146,140
17125,2024,6,6,0,0,100,149300,1212,117
17126,2024,2,2,0,0,100,141445,1750,80
17127,2024,40,24,16,40,60,137584,1794,76
17128,2024,9,9,0,0,100,189742,1812,104
17129,2024,1,1,0,0,100,130500,1450,90
17130,2024,1,1,0,0,100,255006,1977,129
17131,2024,25,24,1,4,96,195144,2047,98
17132,2024,3,3,0,0,100,165783,1335,128
17133,2024,7,7,0,0,100,136753,1342,111
17134,2024,3,3,0,0,100,117000,1307,89
17135,2024,1,1,0,0,100,104600,654,160
17136,2024,15,15,0,0,100,259145,2632,99
17137,2024,3,3,0,0,100,146000,1386,111
17138,2024,9,9,0,0,100,138187,1361,114
17139,2024,1,1,0,0,100,120000,1538,78
17140,2024,95,86,9,9,91,273873,3789,76
17141,2024,2,2,0,0,100,346625,2362,162
17142,2024,56,50,6,11,89,365398,3562,104
17143,2024,5,5,0,0,100,176968,1542,103
17145,2024,1,1,0,0,100,80000,690,116
17146,2024,59,53,6,10,90,231493,2415,96
17147,2024,10,10,0,0,100,165100,1653,100
17148,2024,4,4,0,0,100,179867,1548,114
17149,2024,1,1,0,0,100,60000,517,116
17150,2024,7,7,0,0,100,106343,872,129
17151,2024,14,13,1,7,93,160154,1781,87
17152,2024,15,14,1,7,93,171987,1808,92
17153,2024,35,35,0,0,100,259705,2770,93
17154,2024,7,7,0,0,100,181857,1763,107
17155,2024,48,46,2,4,96,263091,2706,97
17156,2024,1,1,0,0,100,32000,667,48
17157,2024,2,2,0,0,100,121000,899,127
17158,2024,24,24,0,0,100,263156,2799,96
17159,2024,2,2,0,0,100,207225,1792,117
17160,2024,8,8,0,0,100,171792,1801,98
17161,2024,63,59,4,6,94,753497,7456,104
17162,2024,4,4,0,0,100,164468,994,159
17163,2024,4,4,0,0,100,171225,1808,97
17164,2024,26,26,0,0,100,210267,1992,105
17165,2024,6,6,0,0,100,171400,1392,144
17166,2024,12,12,0,0,100,237561,1971,120
17167,2024,9,9,0,0,100,142867,1121,147
17168,2024,101,83,18,18,82,327283,4030,83
17171,2024,10,10,0,0,100,186542,1699,107
17172,2024,33,33,0,0,100,176727,1538,121
17173,2024,3,2,1,33,67,90442,1004,91
17174,2024,10,10,0,0,100,205113,1697,123
17175,2024,4,4,0,0,100,161546,1784,91
17176,2024,1,1,0,0,100,80000,635,126
17177,2024,3,3,0,0,100,97632,833,113
17179,2024,11,9,2,18,82,191992,2030,96
17180,2024,1,1,0,0,100,64900,914,71
17181,2024,6,6,0,0,100,205850,1816,120
17182,2024,4,4,0,0,100,127752,1425,98
17183,2024,17,17,0,0,100,199383,1905,99
17184,2024,7,7,0,0,100,198929,2073,97
17185,2024,26,26,0,0,100,228885,2803,89
17186,2024,12,12,0,0,100,216096,2090,104
17187,2024,3,3,0,0,100,159393,1282,123
17188,2024,5,5,0,0,100,211868,1983,125
17190,2024,34,31,3,9,91,380664,3766,97
17191,2024,3,3,0,0,100,184167,1732,101
17192,2024,7,7,0,0,100,173657,1404,125
17193,2024,30,30,0,0,100,284757,3275,90
17194,2024,40,40,0,0,100,282698,3114,96
17195,2024,2,2,0,0,100,155000,1491,106
17196,2024,5,5,0,0,100,208027,1687,125
17197,2024,32,26,6,19,81,138956,1998,86
17198,2024,2,2,0,0,100,157000,1818,106
17199,2024,1,1,0,0,100,129000,1194,108
17200,2024,119,95,24,20,80,383084,3781,98
17201,2024,2,2,0,0,100,133000,1427,95
17202,2024,5,5,0,0,100,137500,1824,88
17203,2024,11,11,0,0,100,311833,2281,131
17204,2024,5,5,0,0,100,132373,1265,107
17205,2024,2,2,0,0,100,255126,2676,95
17206,2024,5,5,0,0,100,134500,1162,132
17207,2024,25,25,0,0,100,742785,6577,117
17208,2024,12,12,0,0,100,229719,2377,98
17209,2024,2,2,0,0,100,178500,1226,136
17210,2024,8,8,0,0,100,122450,937,127
17211,2024,5,5,0,0,100,128094,1558,81
17212,2024,5,5,0,0,100,168970,1849,100
17214,2024,1,1,0,0,100,219000,1991,110
17215,2024,1,1,0,0,100,224000,2036,110
17216,2024,12,12,0,0,100,198049,1638,119
17217,2024,5,5,0,0,100,127846,954,128
17218,2024,58,46,12,21,79,163296,1934,85
17219,2024,92,86,6,7,93,197710,2467,84
17220,2024,3,3,0,0,100,231767,2019,109
17221,2024,16,16,0,0,100,129409,1303,102
17222,2024,46,46,0,0,100,407166,3942,102
17224,2024,28,27,1,4,96,122629,1203,103
17225,2024,97,88,9,9,91,274987,4430,68
17226,2024,8,8,0,0,100,162351,1470,107
17227,2024,3,3,0,0,100,128383,1298,91
17228,2024,45,39,6,13,87,312703,3041,102
17229,2024,3,3,0,0,100,80000,732,109
17230,2024,89,76,13,15,85,268557,3419,81
17232,2024,21,20,1,5,95,229332,2099,120
17233,2024,1,1,0,0,100,204900,1708,120
17234,2024,1,1,0,0,100,140000,1207,116
17235,2024,8,8,0,0,100,160131,1258,124
17236,2024,13,10,3,23,77,100684,1165,91
17237,2024,7,7,0,0,100,193228,1845,109
17239,2024,2,2,0,0,100,197500,1838,108
17240,2024,46,41,5,11,89,125531,1467,89
17241,2024,23,23,0,0,100,150318,1602,98
17242,2024,7,7,0,0,100,257507,2019,134
17243,2024,10,10,0,0,100,123843,1095,123
17244,2024,7,6,1,14,86,217507,2167,97
17245,2024,1,1,0,0,100,269930,4029,67
17246,2024,7,7,0,0,100,198232,1649,126
17247,2024,11,10,1,9,91,303860,3055,98
17248,2024,17,16,1,6,94,194964,2287,89
17249,2024,1,1,0,0,100,211500,1175,180
17250,2024,5,5,0,0,100,142000,1263,107
17252,2024,3,3,0,0,100,209882,4583,90
17253,2024,16,16,0,0,100,175756,1839,101
17254,2024,2,2,0,0,100,181500,1500,149
17255,2024,11,11,0,0,100,198564,2209,90
17256,2024,1,1,0,0,100,240000,1846,130
17257,2024,19,19,0,0,100,108734,962,117
17258,2024,3,3,0,0,100,74333,854,90
17259,2024,1,1,0,0,100,142000,2029,70
17260,2024,5,5,0,0,100,126800,1437,93
17261,2024,4,4,0,0,100,107147,811,130
17262,2024,8,8,0,0,100,116522,2040,61
17263,2024,4,4,0,0,100,200500,1232,140
17264,2024,69,62,7,10,90,379864,3669,106
17265,2024,13,13,0,0,100,209649,2139,96
17266,2024,4,4,0,0,100,97250,966,107
17267,2024,17,16,1,6,94,288657,2583,112
17268,2024,2,2,0,0,100,51000,628,76
17269,2024,4,4,0,0,100,180975,2207,88
17270,2024,12,12,0,0,100,112099,2254,56
17271,2024,8,8,0,0,100,91600,820,114
17273,2024,14,14,0,0,100,135931,1269,108
17274,2024,96,60,36,38,62,342118,3867,89
17275,2024,13,13,0,0,100,231751,1939,123
17277,2024,6,6,0,0,100,148933,1417,106
17278,2024,10,10,0,0,100,199020,1915,107
17279,2024,7,7,0,0,100,141757,1512,109
17280,2024,9,9,0,0,100,232878,2028,127
17281,2024,2,2,0,0,100,146000,1102,140
17282,2024,2,2,0,0,100,140500,794,196
17283,2024,59,56,3,5,95,154946,1572,102
17284,2024,17,17,0,0,100,191823,2153,93
17285,2024,17,17,0,0,100,215018,1718,128
17286,2024,24,24,0,0,100,761635,7242,107
17288,2024,3,3,0,0,100,119867,1418,82
17289,2024,4,4,0,0,100,299264,2106,150
17290,2024,7,7,0,0,100,103950,1180,95
17291,2024,84,65,19,23,77,324926,3545,94
17292,2024,5,5,0,0,100,147116,1617,94
17293,2024,2,2,0,0,100,183805,1515,122
17294,2024,1,1,0,0,100,198000,1253,158
17295,2024,7,6,1,14,86,136107,1326,108
17296,2024,20,20,0,0,100,175218,1705,105
17297,2024,25,22,3,12,88,679426,7366,95
17298,2024,11,11,0,0,100,213585,1688,131
17299,2024,425,192,233,55,45,165892,2405,72
17300,2024,1228,448,780,64,36,313853,4805,67
17301,2024,3,3,0,0,100,92230,1177,95
17302,2024,3,3,0,0,100,236333,1962,113
17303,2024,15,15,0,0,100,183573,1658,116
17304,2024,6,6,0,0,100,192952,1760,113
17305,2024,6,6,0,0,100,197250,1623,124
17306,2024,600,253,347,58,42,286520,4117,71
17307,2024,23,23,0,0,100,199082,1864,105
17308,2024,27,25,2,7,93,204183,2083,95
17309,2024,25,25,0,0,100,116069,1103,109
17310,2024,10,10,0,0,100,191984,1989,100
17311,2024,20,20,0,0,100,302596,3157,97
17312,2024,12,12,0,0,100,112833,1238,98
17313,2024,5,5,0,0,100,158000,1661,96
17314,2024,7,7,0,0,100,145036,1552,93
17315,2024,16,16,0,0,100,281266,3183,94
17316,2024,5,5,0,0,100,127335,1330,104
17317,2024,4,4,0,0,100,105212,1363,74
17318,2024,22,21,1,5,95,471621,5943,80
17319,2024,1,1,0,0,100,145000,1465,99
17320,2024,7,7,0,0,100,207086,1594,123
17321,2024,6,6,0,0,100,141917,1444,96
17322,2024,9,9,0,0,100,181072,1705,112
17323,2024,42,42,0,0,100,280212,4024,75
17325,2024,6,6,0,0,100,155049,1716,93
17326,2024,2,2,0,0,100,278000,1664,169
17327,2024,2,2,0,0,100,125000,1184,104
17328,2024,16,16,0,0,100,169502,1511,112
17329,2024,9,9,0,0,100,188644,2026,96
17330,2024,24,24,0,0,100,154072,1692,87
17331,2024,12,12,0,0,100,129285,1209,113
17332,2024,5,5,0,0,100,164683,1541,111
17333,2024,206,117,89,43,57,263378,4220,66
17336,2024,23,23,0,0,100,285092,2513,114
17337,2024,126,123,3,2,98,251727,3676,72
17338,2024,15,14,1,7,93,166045,1718,98
17339,2024,8,8,0,0,100,146812,1279,110
17340,2024,16,16,0,0,100,156134,1580,107
17342,2024,5,5,0,0,100,117432,1395,100
17344,2024,22,22,0,0,100,124084,1254,99
17345,2024,4,4,0,0,100,134176,1057,118
17346,2024,21,21,0,0,100,225978,1852,122
17347,2024,122,103,19,16,84,129300,1496,90
17348,2024,5,5,0,0,100,192588,1522,125
17349,2024,25,25,0,0,100,224894,2127,104
17350,2024,8,8,0,0,100,138562,1362,99
17351,2024,28,28,0,0,100,197979,2510,88
17353,2024,30,30,0,0,100,276024,2669,105
17354,2024,5,5,0,0,100,161860,1310,133
17355,2024,4,4,0,0,100,170250,1676,104
17356,2024,4,4,0,0,100,132400,2260,97
17357,2024,2,2,0,0,100,143776,901,136
17358,2024,7,7,0,0,100,131296,1631,90
17359,2024,13,13,0,0,100,192109,1872,104
17360,2024,75,75,0,0,100,734037,7484,105
17361,2024,6,6,0,0,100,140838,1579,98
17362,2024,4,4,0,0,100,180750,2230,89
17363,2024,4,4,0,0,100,146500,1596,96
17364,2024,2,2,0,0,100,107790,1440,79
17365,2024,4,4,0,0,100,187888,1421,136
17366,2024,9,9,0,0,100,130344,1240,111
17367,2024,4,4,0,0,100,146000,1027,136
17369,2024,38,21,17,45,55,593790,7661,77
17372,2024,3,3,0,0,100,177623,1451,124
17373,2024,22,22,0,0,100,304828,2632,126
17374,2024,3,3,0,0,100,147864,1473,105
17375,2024,22,22,0,0,100,189427,2240,85
17376,2024,22,22,0,0,100,313283,2928,111
17377,2024,2,2,0,0,100,63508,788,82
17378,2024,5,5,0,0,100,178600,1327,138
17379,2024,1,1,0,0,100,160000,1905,84
17380,2024,141,97,44,31,69,339778,5147,68
17381,2024,3,3,0,0,100,128043,1517,88
17382,2024,8,8,0,0,100,222088,1763,121
17383,2024,4,4,0,0,100,136700,1254,103
17384,2024,1,1,0,0,100,92000,1082,85
17385,2024,166,150,16,10,90,282585,3707,79
17386,2024,1,1,0,0,100,40000,1250,32
17387,2024,23,22,1,4,96,201936,2135,95
17388,2024,6,6,0,0,100,193957,1658,119
17389,2024,5,5,0,0,100,225440,2136,109
17390,2024,1,1,0,0,100,182000,2068,88
17391,2024,15,15,0,0,100,331603,3481,95
17393,2024,16,15,1,6,94,209759,2005,109
17394,2024,12,12,0,0,100,163701,1216,134
17395,2024,7,7,0,0,100,183667,1785,104
17396,2024,14,14,0,0,100,247175,2356,106
17397,2024,28,27,1,4,96,185469,1794,106
17398,2024,1,1,0,0,100,90000,1286,70
17400,2024,2,2,0,0,100,107500,1267,80
17401,2024,2,2,0,0,100,113700,1046,119
17402,2024,1,1,0,0,100,215000,1654,130
17403,2024,2,2,0,0,100,128500,1796,74
17404,2024,6,6,0,0,100,225400,1824,121
17405,2024,2,2,0,0,100,81125,1516,56
17406,2024,5,5,0,0,100,187340,3183,72
17407,2024,56,53,3,5,95,312313,3089,106
17408,2024,12,12,0,0,100,180833,1623,114
17409,2024,44,40,4,9,91,305494,3066,99
17410,2024,7,7,0,0,100,182504,1373,133
17411,2024,27,27,0,0,100,303562,3943,82
17412,2024,11,11,0,0,100,224650,2073,108
17413,2024,13,13,0,0,100,414287,3399,119
17414,2024,62,60,2,3,97,325205,3393,96
17415,2024,347,242,105,30,70,183139,2158,86
17416,2024,1,1,0,0,100,58000,644,90
17417,2024,2,2,0,0,100,127500,1244,97
17418,2024,5,5,0,0,100,201820,1448,145
17420,2024,20,20,0,0,100,296446,2984,99
17421,2024,132,113,19,14,86,233695,2692,90
17423,2024,3,3,0,0,100,146570,1175,134
17424,2024,3,3,0,0,100,197982,1440,134
17425,2024,35,35,0,0,100,257933,2643,98
17426,2024,8,8,0,0,100,147446,1218,131
17427,2024,2,2,0,0,100,142200,857,164
17428,2024,6,6,0,0,100,88833,777,113
17429,2024,24,24,0,0,100,238098,2588,94
17430,2024,4,4,0,0,100,104234,1181,84
17431,2024,11,11,0,0,100,173862,1765,94
17432,2024,4,4,0,0,100,199300,1824,112
17433,2024,3,3,0,0,100,100667,1134,94
17434,2024,98,87,11,11,89,168807,1976,90
17435,2024,3,3,0,0,100,201500,1455,144
17436,2024,8,8,0,0,100,160502,1563,111
17437,2024,2,2,0,0,100,234030,2964,82
17438,2024,4,4,0,0,100,117378,1075,119
17439,2024,12,12,0,0,100,121508,1478,83
17440,2024,5,4,1,20,80,151285,1619,93
17441,2024,15,15,0,0,100,209902,1879,114
17442,2024,6,6,0,0,100,261167,1823,126
17443,2024,23,23,0,0,100,269726,2560,109
17444,2024,28,28,0,0,100,183505,2056,93
17445,2024,2,2,0,0,100,189550,1368,139
17446,2024,10,10,0,0,100,153955,1190,136
17447,2024,24,24,0,0,100,221431,2558,89
17448,2024,18,18,0,0,100,141769,1524,96
17449,2024,115,69,46,40,60,178460,2174,83
17450,2024,1,1,0,0,100,139200,1200,116
17451,2024,4,4,0,0,100,93988,1151,87
17452,2024,97,80,17,18,82,282046,3521,86
17453,2024,19,19,0,0,100,222377,2007,112
17454,2024,4,4,0,0,100,214750,1054,202
17455,2024,7,7,0,0,100,220329,2163,107
17457,2024,28,28,0,0,100,173375,2169,92
17458,2024,4,4,0,0,100,181621,1616,122
17459,2024,9,9,0,0,100,112258,1177,96
17460,2024,10,10,0,0,100,259885,1872,137
17461,2024,149,95,54,36,64,327793,4601,75
17462,2024,7,7,0,0,100,221620,1824,124
17463,2024,14,14,0,0,100,275504,2823,99
17464,2024,3,3,0,0,100,145500,1258,126
17465,2024,2,2,0,0,100,149500,1126,133
17466,2024,20,20,0,0,100,330371,2844,123
17467,2024,1,1,0,0,100,127000,1155,110
17468,2024,2,2,0,0,100,116410,1774,69
17469,2024,3,3,0,0,100,99667,1048,87
17470,2024,1,1,0,0,100,267000,1734,154
17471,2024,3,3,0,0,100,87667,1774,56
17472,2024,19,19,0,0,100,251696,2688,94
17473,2024,4,4,0,0,100,96750,1041,94
17474,2024,9,9,0,0,100,125106,1256,95
17476,2024,3,3,0,0,100,82633,1339,64
17477,2024,1,1,0,0,100,148000,925,160
17479,2024,2,2,0,0,100,120500,1212,113
17480,2024,5,5,0,0,100,303400,2188,139
17481,2024,3,3,0,0,100,241800,2044,123
17482,2024,7,7,0,0,100,175518,1641,109
17483,2024,31,31,0,0,100,226001,2638,86
17484,2024,30,27,3,10,90,211453,2557,83
17485,2024,21,21,0,0,100,368877,4039,95
17486,2024,21,21,0,0,100,355276,5093,76
18001,2024,5,5,0,0,100,126000,1505,91
18002,2024,7,7,0,0,100,63314,707,92
18003,2024,29,29,0,0,100,113024,1294,91
18004,2024,18,18,0,0,100,134861,1268,105
18005,2024,6,6,0,0,100,142928,1523,95
18006,2024,6,6,0,0,100,97567,1067,94
18007,2024,1,1,0,0,100,240000,1500,160
18008,2024,9,9,0,0,100,187222,1573,119
18009,2024,4,4,0,0,100,119932,1536,83
18011,2024,37,36,1,3,97,126924,1320,98
18012,2024,9,9,0,0,100,90744,887,97
18013,2024,2,2,0,0,100,105750,1076,97
18014,2024,1,1,0,0,100,177199,996,178
18015,2024,66,63,3,5,95,113896,1364,84
18016,2024,3,3,0,0,100,51150,739,68
18017,2024,7,7,0,0,100,117971,1224,92
18018,2024,4,4,0,0,100,102382,1263,81
18019,2024,7,7,0,0,100,95429,1282,108
18020,2024,14,14,0,0,100,104610,1122,92
18021,2024,4,4,0,0,100,49750,546,90
18022,2024,12,12,0,0,100,83292,1165,84
18023,2024,17,17,0,0,100,125735,1151,107
18024,2024,2,2,0,0,100,97250,1164,84
18025,2024,6,6,0,0,100,70800,943,76
18026,2024,12,12,0,0,100,120992,1295,93
18027,2024,8,8,0,0,100,111078,1314,98
18028,2024,14,14,0,0,100,184516,2011,95
18029,2024,8,8,0,0,100,107801,1194,98
18030,2024,12,12,0,0,100,90473,1070,84
18031,2024,12,11,1,8,92,63458,774,82
18032,2024,15,15,0,0,100,108160,1272,89
18033,2024,905,452,453,50,50,128054,1697,76
18034,2024,3,3,0,0,100,129000,1562,83
18035,2024,12,12,0,0,100,163690,1652,98
18036,2024,4,4,0,0,100,128143,2025,90
18037,2024,18,18,0,0,100,211911,1570,108
18038,2024,11,11,0,0,100,76704,926,83
18039,2024,3,3,0,0,100,81667,1267,69
18040,2024,3,3,0,0,100,78333,833,104
18041,2024,6,6,0,0,100,103332,1090,90
18042,2024,4,4,0,0,100,76250,997,80
18043,2024,4,4,0,0,100,126211,1837,70
18044,2024,6,6,0,0,100,61417,810,82
18045,2024,6,6,0,0,100,63617,590,106
18046,2024,1,1,0,0,100,63000,1575,40
18047,2024,12,12,0,0,100,122250,1197,95
18048,2024,6,6,0,0,100,101750,1027,104
18049,2024,7,7,0,0,100,106521,1211,83
18050,2024,45,44,1,2,98,150155,1609,94
18051,2024,2,2,0,0,100,271500,2231,124
18052,2024,7,7,0,0,100,201543,1439,111
18053,2024,5,5,0,0,100,86200,880,98
18054,2024,1,1,0,0,100,240000,1500,160
18055,2024,22,22,0,0,100,88045,1051,79
18056,2024,3,3,0,0,100,87000,880,100
18057,2024,34,34,0,0,100,75379,869,91
18058,2024,20,20,0,0,100,72701,873,87
18059,2024,12,12,0,0,100,78215,794,94
18061,2024,3,3,0,0,100,73543,1694,46
18062,2024,4,4,0,0,100,91526,921,114
18064,2024,3,3,0,0,100,116500,934,123
18065,2024,9,9,0,0,100,89528,963,93
18066,2024,9,9,0,0,100,94104,868,112
18067,2024,9,9,0,0,100,93222,827,113
18069,2024,3,3,0,0,100,81167,990,79
18070,2024,6,6,0,0,100,110000,840,122
18072,2024,2,2,0,0,100,80000,726,99
18073,2024,3,3,0,0,100,85333,784,116
18074,2024,3,3,0,0,100,59000,892,63
18075,2024,10,10,0,0,100,117925,1084,106
18076,2024,8,8,0,0,100,81272,999,84
18077,2024,6,6,0,0,100,102000,998,107
18079,2024,5,5,0,0,100,112800,1160,89
18080,2024,1,1,0,0,100,230000,3770,61
18081,2024,5,5,0,0,100,98400,1081,102
18082,2024,9,9,0,0,100,157650,1537,92
18083,2024,16,16,0,0,100,88961,1050,87
18084,2024,5,5,0,0,100,123692,1107,107
18085,2024,1,1,0,0,100,90000,692,130
18086,2024,5,5,0,0,100,68620,856,74
18087,2024,39,38,1,3,97,82018,963,88
18088,2024,2,2,0,0,100,56500,1026,58
18089,2024,4,4,0,0,100,87375,1164,76
18090,2024,2,2,0,0,100,92250,1652,55
18091,2024,5,5,0,0,100,144100,1418,99
18092,2024,2,2,0,0,100,99000,1102,93
18093,2024,1,1,0,0,100,30868,343,90
18094,2024,6,6,0,0,100,114000,1349,86
18095,2024,1,1,0,0,100,110000,2115,52
18096,2024,19,19,0,0,100,103397,1278,80
18097,2024,20,19,1,5,95,174821,1653,111
18098,2024,2,2,0,0,100,78500,748,99
18099,2024,2,2,0,0,100,69250,929,84
18100,2024,15,15,0,0,100,96680,1118,87
18101,2024,3,3,0,0,100,99667,1459,54
18102,2024,4,4,0,0,100,99750,883,132
18103,2024,20,19,1,5,95,78038,959,82
18104,2024,2,2,0,0,100,55925,788,68
18105,2024,7,7,0,0,100,89356,866,107
18106,2024,3,3,0,0,100,148327,955,152
18107,2024,1,1,0,0,100,158879,1961,81
18108,2024,45,45,0,0,100,110059,1231,93
18109,2024,22,21,1,5,95,87982,1146,82
18110,2024,14,14,0,0,100,122107,1140,93
18111,2024,2,2,0,0,100,133045,1358,98
18112,2024,11,11,0,0,100,118690,982,115
18113,2024,2,2,0,0,100,75550,822,80
18115,2024,13,13,0,0,100,117720,948,105
18116,2024,5,5,0,0,100,109600,1398,81
18117,2024,6,6,0,0,100,112750,1141,98
18118,2024,25,25,0,0,100,102313,1144,89
18119,2024,2,2,0,0,100,106500,1602,66
18120,2024,10,10,0,0,100,75140,929,85
18121,2024,1,1,0,0,100,60000,857,70
18122,2024,3,3,0,0,100,168333,1412,124
18124,2024,6,6,0,0,100,230700,1988,102
18125,2024,15,15,0,0,100,90335,1156,77
18126,2024,17,17,0,0,100,118498,1315,91
18127,2024,21,21,0,0,100,78297,1024,79
18128,2024,1,1,0,0,100,153400,1420,108
18129,2024,2,2,0,0,100,115250,1156,99
18130,2024,6,6,0,0,100,48117,793,63
18132,2024,1,1,0,0,100,150000,1579,95
18133,2024,16,16,0,0,100,83524,1053,78
18134,2024,7,7,0,0,100,78180,908,85
18135,2024,6,6,0,0,100,185200,1691,98
18136,2024,3,3,0,0,100,126000,1158,121
18137,2024,9,9,0,0,100,67844,1048,70
18138,2024,24,24,0,0,100,168891,1648,99
18139,2024,6,6,0,0,100,66425,1101,60
18140,2024,22,22,0,0,100,99409,1010,100
18141,2024,96,93,3,3,97,114631,1386,84
18142,2024,4,4,0,0,100,156389,1906,88
18143,2024,5,5,0,0,100,129945,1140,131
18144,2024,6,6,0,0,100,102500,1200,99
18145,2024,21,21,0,0,100,109601,1205,96
18146,2024,4,4,0,0,100,69250,848,78
18147,2024,3,3,0,0,100,79633,1150,67
18148,2024,18,18,0,0,100,115808,1224,96
18149,2024,8,8,0,0,100,114988,1228,92
18150,2024,6,6,0,0,100,168083,1375,119
18151,2024,10,10,0,0,100,76000,1104,73
18152,2024,1,1,0,0,100,88010,936,94
18153,2024,5,5,0,0,100,58700,935,61
18154,2024,4,4,0,0,100,66250,738,80
18155,2024,8,8,0,0,100,136991,1610,83
18156,2024,12,12,0,0,100,105076,997,108
18157,2024,10,10,0,0,100,138395,1491,93
18158,2024,6,6,0,0,100,160429,1430,108
18159,2024,14,14,0,0,100,157711,1356,106
18160,2024,18,18,0,0,100,68404,877,80
18161,2024,7,7,0,0,100,77104,879,90
18162,2024,2,2,0,0,100,47500,973,52
18163,2024,4,4,0,0,100,76000,1162,86
18164,2024,1,1,0,0,100,205250,1866,110
18165,2024,13,13,0,0,100,98854,1715,73
18166,2024,4,4,0,0,100,142638,1577,91
18167,2024,3,3,0,0,100,67833,1121,61
18168,2024,3,3,0,0,100,171000,1422,110
18170,2024,6,6,0,0,100,107633,1216,90
18171,2024,1,1,0,0,100,135000,1350,100
18172,2024,17,16,1,6,94,112916,1089,93
18173,2024,1,1,0,0,100,42000,560,75
18175,2024,14,14,0,0,100,58643,724,84
18176,2024,6,6,0,0,100,97833,921,103
18177,2024,1,1,0,0,100,90000,978,92
18178,2024,1,1,0,0,100,92000,1211,76
18179,2024,8,8,0,0,100,193388,1562,120
18180,2024,11,11,0,0,100,202935,1882,110
18181,2024,4,4,0,0,100,115625,1678,71
18182,2024,1,1,0,0,100,110000,775,142
18183,2024,1,1,0,0,100,22500,562,40
18184,2024,6,6,0,0,100,75283,875,89
18185,2024,1,1,0,0,100,55000,679,81
18186,2024,3,3,0,0,100,102621,1137,79
18187,2024,10,10,0,0,100,65131,903,76
18188,2024,6,6,0,0,100,57359,821,68
18189,2024,1,1,0,0,100,173800,1461,119
18190,2024,8,8,0,0,100,117930,1182,96
18191,2024,1,1,0,0,100,113000,1256,90
18192,2024,7,7,0,0,100,113500,1169,112
18193,2024,2,2,0,0,100,142500,1047,144
18194,2024,7,7,0,0,100,92857,1214,75
18195,2024,5,5,0,0,100,112400,753,138
18196,2024,1,1,0,0,100,177500,2367,75
18197,2024,156,134,22,14,86,94344,1225,82
18198,2024,2,2,0,0,100,106875,1354,80
18199,2024,1,1,0,0,100,30000,375,80
18201,2024,6,6,0,0,100,200367,1609,126
18203,2024,2,2,0,0,100,156540,1566,105
18204,2024,1,1,0,0,100,258000,2168,119
18205,2024,104,100,4,4,96,185204,1796,104
18206,2024,12,12,0,0,100,202000,1712,123
18207,2024,86,74,12,14,86,95548,1259,78
18208,2024,6,6,0,0,100,147117,1338,120
18209,2024,1,1,0,0,100,145000,1768,82
18210,2024,4,4,0,0,100,109000,1090,110
18211,2024,7,7,0,0,100,182246,1451,125
18212,2024,6,6,0,0,100,146475,1411,101
18213,2024,47,46,1,2,98,136119,1574,90
18214,2024,7,7,0,0,100,115857,1132,104
18215,2024,2,2,0,0,100,75000,920,77
18216,2024,5,5,0,0,100,84555,858,107
18217,2024,4,4,0,0,100,72000,691,106
18218,2024,6,6,0,0,100,146956,1244,121
18219,2024,3,3,0,0,100,95167,479,208
18220,2024,5,5,0,0,100,79000,1053,79
18221,2024,4,4,0,0,100,101000,718,119
18223,2024,32,32,0,0,100,137295,1379,101
18224,2024,3,3,0,0,100,58200,795,79
18225,2024,2,2,0,0,100,109500,1215,98
18226,2024,1,1,0,0,100,133000,1662,80
18227,2024,3,3,0,0,100,185451,1518,113
18228,2024,7,7,0,0,100,77860,1251,70
18229,2024,4,4,0,0,100,130473,1559,74
18230,2024,7,7,0,0,100,102052,943,104
18231,2024,9,9,0,0,100,130111,1101,109
18232,2024,4,4,0,0,100,76875,1129,87
18233,2024,20,19,1,5,95,96355,1319,89
18234,2024,11,11,0,0,100,58926,860,72
18235,2024,10,10,0,0,100,126462,1369,91
18237,2024,4,4,0,0,100,148075,1363,103
18238,2024,1,1,0,0,100,65000,650,100
18240,2024,8,8,0,0,100,99038,791,118
18241,2024,18,15,3,17,83,175878,1815,100
18242,2024,39,38,1,3,97,75811,967,77
18243,2024,8,8,0,0,100,71675,1063,63
18245,2024,3,3,0,0,100,39333,687,61
18246,2024,19,19,0,0,100,128132,1342,99
18247,2024,3,3,0,0,100,110996,1110,99
18248,2024,3,3,0,0,100,125000,1549,81
18249,2024,5,5,0,0,100,107393,1575,100
18250,2024,1,1,0,0,100,145000,1082,134
18251,2024,1,1,0,0,100,121000,1235,98
18252,2024,7,7,0,0,100,100943,1296,71
18253,2024,6,6,0,0,100,193417,1500,127
18254,2024,5,5,0,0,100,175900,1582,118
18255,2024,6,6,0,0,100,248808,2116,119
18256,2024,5,5,0,0,100,62800,1038,61
18257,2024,10,10,0,0,100,92850,1058,86
18258,2024,5,5,0,0,100,95080,968,102
18259,2024,5,5,0,0,100,56400,765,79
18260,2024,2,2,0,0,100,94500,768,110
18261,2024,4,4,0,0,100,55750,699,83
18262,2024,2,2,0,0,100,70900,686,114
18263,2024,7,7,0,0,100,94430,1662,71
18264,2024,1,1,0,0,100,78000,433,180
18265,2024,11,11,0,0,100,68264,900,78
18266,2024,5,5,0,0,100,99942,1276,82
18267,2024,33,33,0,0,100,179755,1706,106
18268,2024,5,5,0,0,100,88900,1082,90
18269,2024,6,6,0,0,100,100071,1069,92
18270,2024,15,15,0,0,100,60200,693,85
18271,2024,14,14,0,0,100,212956,1723,124
18272,2024,12,12,0,0,100,91196,1123,87
18273,2024,11,11,0,0,100,78626,1019,78
18275,2024,1,1,0,0,100,85000,720,118
18276,2024,1,1,0,0,100,107000,690,155
18277,2024,1,1,0,0,100,92000,601,153
18278,2024,10,10,0,0,100,105550,1135,98
18279,2024,367,285,82,22,78,79048,1070,75
18280,2024,7,7,0,0,100,151100,1184,131
18281,2024,18,18,0,0,100,154578,1739,97
18282,2024,6,6,0,0,100,130458,1314,100
18284,2024,2,2,0,0,100,78850,1108,59
18285,2024,3,3,0,0,100,167000,1839,92
18286,2024,7,7,0,0,100,122064,1541,80
18287,2024,3,3,0,0,100,147067,2028,66
18288,2024,2,2,0,0,100,134500,1682,80
18289,2024,6,6,0,0,100,100500,1258,83
18290,2024,5,5,0,0,100,167310,1332,112
19001,2024,4,4,0,0,100,111500,1191,94
19002,2024,1,1,0,0,100,28000,333,84
19003,2024,4,4,0,0,100,202838,1810,127
19004,2024,8,8,0,0,100,162758,1837,92
19005,2024,55,54,1,2,98,157091,1615,98
19006,2024,2,2,0,0,100,174590,1642,110
19007,2024,15,15,0,0,100,138105,1469,96
19008,2024,1,1,0,0,100,104800,2096,50
19010,2024,51,35,16,31,69,111734,1293,84
19011,2024,15,13,2,13,87,122532,1139,108
19012,2024,2,2,0,0,100,150000,1772,82
19013,2024,7,7,0,0,100,184250,2294,92
19014,2024,5,5,0,0,100,85740,1505,60
19015,2024,11,11,0,0,100,79025,1122,75
19017,2024,3,3,0,0,100,67333,921,74
19018,2024,4,4,0,0,100,80782,1010,84
19019,2024,22,20,2,9,91,118638,1415,88
19021,2024,2,2,0,0,100,92000,842,96
19022,2024,4,4,0,0,100,131175,1182,108
19023,2024,20,20,0,0,100,111134,1410,82
19024,2024,3,3,0,0,100,126833,1738,70
19025,2024,5,5,0,0,100,125600,1511,87
19026,2024,3,3,0,0,100,340333,1709,176
19027,2024,2,2,0,0,100,133500,938,140
19028,2024,28,25,3,11,89,90564,943,95
19029,2024,9,9,0,0,100,218793,1829,112
19030,2024,8,8,0,0,100,147312,1675,87
19031,2024,807,399,408,51,49,151696,1974,78
19033,2024,18,15,3,17,83,83361,1069,80
19034,2024,2,2,0,0,100,72950,1404,50
19035,2024,9,9,0,0,100,117600,1091,103
19036,2024,30,30,0,0,100,114301,1275,92
19037,2024,16,16,0,0,100,132462,1549,89
19038,2024,9,9,0,0,100,120631,1536,83
19039,2024,2,2,0,0,100,202725,2156,95
19040,2024,2,2,0,0,100,85000,1422,58
19042,2024,8,8,0,0,100,168968,1723,100
19043,2024,6,6,0,0,100,248442,2335,108
19044,2024,1,1,0,0,100,200000,1626,123
19046,2024,1,1,0,0,100,60000,1200,50
19047,2024,4,4,0,0,100,154725,2058,77
19048,2024,2,2,0,0,100,161500,1166,142
19049,2024,7,7,0,0,100,118957,1616,69
19050,2024,1,1,0,0,100,298750,2352,127
19051,2024,4,4,0,0,100,60000,677,94
19052,2024,4,4,0,0,100,103750,1230,87
19054,2024,2,2,0,0,100,96652,1694,58
19055,2024,2,2,0,0,100,40000,540,73
19056,2024,8,8,0,0,100,111105,1096,100
19057,2024,4,4,0,0,100,160798,2152,87
19058,2024,1,1,0,0,100,168000,1846,91
19060,2024,6,6,0,0,100,199233,2217,89
19061,2024,11,9,2,18,82,132955,1559,86
19062,2024,13,12,1,8,92,110198,1090,96
19063,2024,26,25,1,4,96,222453,2199,101
19066,2024,33,26,7,21,79,136681,1508,90
19067,2024,3,3,0,0,100,97563,1625,64
19068,2024,9,8,1,11,89,89219,1844,62
19069,2024,4,4,0,0,100,70892,831,85
19070,2024,7,7,0,0,100,139636,1592,85
19071,2024,3,3,0,0,100,130667,1304,106
19072,2024,26,25,1,4,96,148797,1664,91
19073,2024,33,27,6,18,82,102845,1257,85
19075,2024,3,3,0,0,100,131500,1353,96
19076,2024,3,3,0,0,100,99333,1156,87
19077,2024,1,1,0,0,100,140000,1386,101
19078,2024,10,10,0,0,100,108028,1305,86
19079,2024,4,4,0,0,100,105750,1120,104
19080,2024,6,6,0,0,100,161267,1576,140
19081,2024,10,10,0,0,100,135492,1248,103
19082,2024,9,9,0,0,100,165507,1674,99
19084,2024,1,1,0,0,100,149533,2623,57
19085,2024,3,3,0,0,100,161267,1464,108
19086,2024,2,2,0,0,100,47500,1036,45
19087,2024,5,5,0,0,100,88509,963,104
19089,2024,4,4,0,0,100,137925,1506,92
19090,2024,1,1,0,0,100,90000,1034,87
19093,2024,14,13,1,7,93,214020,2139,110
19094,2024,23,23,0,0,100,111005,1462,81
19095,2024,5,5,0,0,100,45400,547,81
19096,2024,4,4,0,0,100,110727,1298,81
19098,2024,11,11,0,0,100,116170,1312,97
19099,2024,1,1,0,0,100,180000,2571,70
19100,2024,9,9,0,0,100,109667,1416,78
19101,2024,13,12,1,8,92,94995,1199,81
19102,2024,5,5,0,0,100,228319,1854,85
19103,2024,1,1,0,0,100,109913,1832,60
19104,2024,1,1,0,0,100,38000,1267,30
19105,2024,4,4,0,0,100,142500,1630,86
19106,2024,8,7,1,12,88,139280,1809,91
19107,2024,21,16,5,24,76,161519,1847,91
19108,2024,2,2,0,0,100,112000,710,155
19109,2024,5,5,0,0,100,190200,1922,98
19111,2024,1,1,0,0,100,27000,675,40
19112,2024,2,2,0,0,100,180760,1494,122
19113,2024,9,9,0,0,100,127683,1811,74
19114,2024,3,3,0,0,100,68783,1252,64
19115,2024,1,1,0,0,100,150000,789,190
19116,2024,1,1,0,0,100,102800,1285,80
19117,2024,14,14,0,0,100,105007,1524,62
19118,2024,12,12,0,0,100,79392,926,87
19119,2024,2,2,0,0,100,162000,770,163
19120,2024,2,2,0,0,100,147648,1739,90
19121,2024,16,16,0,0,100,161828,1449,103
19122,2024,5,5,0,0,100,113340,1331,75
19123,2024,96,63,33,34,66,159493,1852,86
19124,2024,9,9,0,0,100,173078,1808,94
19125,2024,14,14,0,0,100,103653,1260,81
19126,2024,3,3,0,0,100,165583,1839,109
19128,2024,2,2,0,0,100,189000,1418,133
19129,2024,15,15,0,0,100,102972,1280,85
19130,2024,5,5,0,0,100,79340,907,102
19131,2024,6,6,0,0,100,87500,971,91
19132,2024,1,1,0,0,100,40000,656,61
19133,2024,1,1,0,0,100,40000,506,79
19134,2024,6,5,1,17,83,109223,1032,111
19135,2024,1,1,0,0,100,165000,1941,85
19136,2024,25,25,0,0,100,142528,1473,95
19137,2024,1,1,0,0,100,80000,727,110
19138,2024,6,6,0,0,100,222653,1805,106
19140,2024,3,3,0,0,100,77433,1489,54
19141,2024,2,2,0,0,100,117750,2975,60
19142,2024,2,2,0,0,100,120000,2246,52
19143,2024,7,7,0,0,100,110190,1238,93
19144,2024,6,6,0,0,100,118925,1500,79
19145,2024,5,5,0,0,100,125840,1494,87
19146,2024,29,20,9,31,69,109449,1321,87
19147,2024,3,3,0,0,100,126667,1089,90
19148,2024,14,13,1,7,93,110914,1172,88
19149,2024,1,1,0,0,100,201450,2518,80
19150,2024,3,3,0,0,100,205083,2250,104
19151,2024,5,5,0,0,100,180420,1921,95
19152,2024,5,5,0,0,100,149656,1463,104
19153,2024,48,42,6,12,88,131731,1582,83
19154,2024,3,3,0,0,100,214883,2010,106
19155,2024,2,2,0,0,100,71584,810,86
19156,2024,2,2,0,0,100,110000,1700,68
19157,2024,4,4,0,0,100,90372,1446,66
19159,2024,1,1,0,0,100,58000,806,72
19160,2024,2,2,0,0,100,62750,1214,52
19161,2024,2,2,0,0,100,247210,2734,97
19162,2024,14,14,0,0,100,174142,1736,99
19163,2024,1,1,0,0,100,50000,714,70
19164,2024,19,19,0,0,100,111629,1140,105
19165,2024,5,5,0,0,100,137585,1265,103
19167,2024,1,1,0,0,100,80000,615,130
19168,2024,2,2,0,0,100,44500,577,87
19169,2024,7,7,0,0,100,129643,1468,86
19170,2024,2,2,0,0,100,100150,2043,50
19171,2024,1,1,0,0,100,234000,1786,131
19172,2024,1,1,0,0,100,43000,811,53
19173,2024,1,1,0,0,100,65000,812,80
19174,2024,7,7,0,0,100,100307,897,118
19175,2024,1,1,0,0,100,114000,1481,77
19176,2024,12,12,0,0,100,112653,1129,104
19177,2024,2,2,0,0,100,91500,810,115
19178,2024,8,8,0,0,100,167419,1764,95
19179,2024,2,2,0,0,100,167500,1620,87
19180,2024,2,2,0,0,100,67500,568,122
19181,2024,7,7,0,0,100,119121,1592,75
19182,2024,9,9,0,0,100,166102,1303,119
19184,2024,4,4,0,0,100,188588,2076,95
19186,2024,4,4,0,0,100,175000,1597,105
19187,2024,3,3,0,0,100,117667,1376,97
19188,2024,1,1,0,0,100,115990,1657,70
19190,2024,2,2,0,0,100,90950,990,99
19191,2024,1,1,0,0,100,850000,3400,250
19192,2024,8,7,1,12,88,82050,928,84
19193,2024,3,3,0,0,100,63333,972,66
19194,2024,3,3,0,0,100,195956,1440,127
19195,2024,5,5,0,0,100,172300,1537,113
19196,2024,5,5,0,0,100,171136,2028,85
19198,2024,1,1,0,0,100,186400,2663,70
19199,2024,4,4,0,0,100,62400,794,75
19200,2024,1,1,0,0,100,139500,996,140
19201,2024,1,1,0,0,100,79200,1467,54
19202,2024,19,19,0,0,100,199876,1911,117
19203,2024,18,18,0,0,100,150145,1468,113
19204,2024,4,4,0,0,100,142703,1340,113
19206,2024,1,1,0,0,100,110000,1100,100
19207,2024,9,9,0,0,100,138934,1346,105
19208,2024,4,4,0,0,100,91750,1433,66
19209,2024,1,1,0,0,100,100000,1333,75
19211,2024,12,12,0,0,100,136230,1625,88
19212,2024,1,1,0,0,100,50000,862,58
19213,2024,8,8,0,0,100,128647,1313,100
19214,2024,5,5,0,0,100,62600,908,68
19215,2024,2,2,0,0,100,65000,1160,56
19216,2024,3,3,0,0,100,79333,863,86
19217,2024,1,1,0,0,100,16667,379,44
19219,2024,1,1,0,0,100,279550,1747,160
19220,2024,8,8,0,0,100,106776,1327,94
19222,2024,2,2,0,0,100,140000,1349,92
19225,2024,3,3,0,0,100,160167,1441,136
19226,2024,1,1,0,0,100,38000,500,76
19227,2024,10,10,0,0,100,137106,1557,89
19229,2024,51,50,1,2,98,193780,2022,98
19230,2024,3,3,0,0,100,226917,2156,100
19231,2024,6,6,0,0,100,77833,1091,68
19233,2024,1,1,0,0,100,190000,1979,96
19235,2024,4,4,0,0,100,105350,1845,52
19236,2024,5,5,0,0,100,122550,1249,96
19237,2024,11,10,1,9,91,139614,1261,118
19238,2024,1,1,0,0,100,162800,904,180
19239,2024,8,8,0,0,100,103309,1141,94
19240,2024,3,3,0,0,100,72400,825,80
19241,2024,5,5,0,0,100,136332,1268,107
19242,2024,3,3,0,0,100,227000,1491,136
19243,2024,5,5,0,0,100,143226,1910,75
19244,2024,1,1,0,0,100,80000,615,130
19245,2024,3,3,0,0,100,73018,1328,53
19246,2024,10,10,0,0,100,188240,1756,113
19247,2024,3,3,0,0,100,204705,1436,148
19248,2024,8,8,0,0,100,147031,1410,95
19249,2024,4,4,0,0,100,56758,885,66
19250,2024,4,4,0,0,100,101438,1180,88
19251,2024,4,4,0,0,100,283266,1495,182
19252,2024,11,11,0,0,100,114694,1074,106
19253,2024,3,3,0,0,100,91000,928,96
19254,2024,5,5,0,0,100,119440,1760,61
19255,2024,13,12,1,8,92,121735,1257,99
19256,2024,4,4,0,0,100,105744,1118,104
19257,2024,1,1,0,0,100,64000,1829,35
19258,2024,7,7,0,0,100,67530,1182,56
19259,2024,4,4,0,0,100,121740,1861,68
19260,2024,2,2,0,0,100,148500,2291,76
19261,2024,3,3,0,0,100,102757,953,99
19262,2024,4,4,0,0,100,63375,877,68
19263,2024,5,5,0,0,100,65600,804,77
19264,2024,11,11,0,0,100,60009,1003,67
19265,2024,8,8,0,0,100,95612,1054,99
19269,2024,24,23,1,4,96,101090,1056,104
19270,2024,6,6,0,0,100,176040,1587,110
19271,2024,3,3,0,0,100,112933,1451,78
19272,2024,172,70,102,59,41,84559,1069,81
19273,2024,13,13,0,0,100,154389,1474,105
19274,2024,44,39,5,11,89,202583,1836,114
19275,2024,74,53,21,28,72,104096,1235,85
19276,2024,37,35,2,5,95,103738,1137,94
19277,2024,1,1,0,0,100,32500,650,50
19278,2024,19,19,0,0,100,158575,1770,92
19279,2024,4,4,0,0,100,154840,1731,93
19281,2024,3,3,0,0,100,172473,1958,119
19283,2024,1,1,0,0,100,57250,1272,45
19284,2024,1,1,0,0,100,50000,893,56
19285,2024,18,18,0,0,100,117958,1256,92
19286,2024,13,13,0,0,100,85865,1076,76
19287,2024,1,1,0,0,100,130000,650,200
19288,2024,12,12,0,0,100,141721,1658,86
19289,2024,6,6,0,0,100,189892,1696,112
21001,2024,6,6,0,0,100,232858,2515,92
21002,2024,6,6,0,0,100,179997,1835,102
21003,2024,14,11,3,21,79,283066,3315,93
21004,2024,3,3,0,0,100,86667,786,106
21005,2024,15,15,0,0,100,215480,2280,98
21007,2024,3,3,0,0,100,106333,977,109
21008,2024,3,3,0,0,100,86833,1585,52
21009,2024,4,4,0,0,100,104675,1676,82
21010,2024,5,5,0,0,100,366000,3032,114
21011,2024,1,1,0,0,100,35000,330,106
21012,2024,2,2,0,0,100,112000,1140,103
21013,2024,3,3,0,0,100,228000,2252,119
21014,2024,1,1,0,0,100,120000,2727,44
21016,2024,5,5,0,0,100,206161,2746,95
21017,2024,5,5,0,0,100,116700,1574,76
21020,2024,1,1,0,0,100,96000,1412,68
21021,2024,22,21,1,5,95,290685,2606,117
21022,2024,3,3,0,0,100,147167,1640,92
21023,2024,15,13,2,13,87,80780,940,89
21024,2024,2,2,0,0,100,142500,1222,118
21026,2024,1,1,0,0,100,91700,1638,56
21027,2024,11,10,1,9,91,549900,3420,157
21028,2024,7,7,0,0,100,192339,1776,113
21031,2024,10,10,0,0,100,237335,1758,139
21032,2024,2,2,0,0,100,139150,1345,104
21033,2024,2,2,0,0,100,185050,2740,74
21035,2024,5,5,0,0,100,156408,2060,81
21037,2024,13,13,0,0,100,185034,1921,95
21038,2024,76,47,29,38,62,144196,1622,86
21039,2024,1,1,0,0,100,60000,513,117
21040,2024,1,1,0,0,100,100000,781,128
21041,2024,2,2,0,0,100,165010,1768,92
21042,2024,1,1,0,0,100,220000,2200,100
21043,2024,1,1,0,0,100,143000,812,176
21044,2024,1,1,0,0,100,38000,475,80
21045,2024,7,7,0,0,100,167713,1744,88
21048,2024,3,3,0,0,100,307553,2814,111
21049,2024,2,2,0,0,100,143560,984,130
21050,2024,4,4,0,0,100,79482,997,81
21051,2024,1,1,0,0,100,135000,1421,95
21052,2024,1,1,0,0,100,248500,1172,212
21054,2024,291,127,164,56,44,226685,2800,82
21055,2024,2,2,0,0,100,57500,488,140
21056,2024,12,7,5,42,58,247746,2071,129
21057,2024,1,1,0,0,100,262000,1679,156
21058,2024,1,1,0,0,100,135000,1350,100
21059,2024,8,6,2,25,75,288612,3398,90
21060,2024,12,11,1,8,92,216542,2229,96
21061,2024,2,2,0,0,100,35000,434,79
21062,2024,2,2,0,0,100,155000,1129,135
21064,2024,1,1,0,0,100,116000,1506,77
21065,2024,1,1,0,0,100,94900,1172,81
21066,2024,1,1,0,0,100,120000,1538,78
21067,2024,7,7,0,0,100,206679,2104,100
21068,2024,1,1,0,0,100,481800,2851,169
21069,2024,2,2,0,0,100,135000,1657,95
21070,2024,1,1,0,0,100,110000,1571,70
21071,2024,8,8,0,0,100,213344,2536,100
21072,2024,1,1,0,0,100,228000,1520,150
21074,2024,1,1,0,0,100,220000,2222,99
21075,2024,5,5,0,0,100,121359,972,113
21076,2024,11,11,0,0,100,209804,2275,99
21077,2024,3,3,0,0,100,124028,974,134
21078,2024,1,1,0,0,100,74000,655,113
21079,2024,2,2,0,0,100,138700,1442,98
21080,2024,4,4,0,0,100,176000,1348,132
21081,2024,1,1,0,0,100,170000,1405,121
21083,2024,2,2,0,0,100,123500,1284,75
21085,2024,2,2,0,0,100,59250,710,78
21086,2024,13,12,1,8,92,264236,2678,103
21087,2024,11,11,0,0,100,139278,1516,96
21088,2024,1,1,0,0,100,598000,2781,215
21089,2024,9,9,0,0,100,168422,1377,124
21090,2024,1,1,0,0,100,65000,1048,62
21091,2024,1,1,0,0,100,200000,1250,160
21092,2024,6,6,0,0,100,152804,1934,76
21093,2024,1,1,0,0,100,128500,2008,64
21094,2024,4,4,0,0,100,156250,1297,112
21095,2024,2,2,0,0,100,192075,1752,104
21096,2024,3,3,0,0,100,211667,1693,139
21099,2024,4,4,0,0,100,103000,1348,84
21100,2024,3,3,0,0,100,126167,1536,91
21101,2024,3,3,0,0,100,158537,1375,111
21103,2024,21,20,1,5,95,192487,2076,99
21104,2024,2,2,0,0,100,73000,818,89
21105,2024,5,5,0,0,100,335930,2655,120
21106,2024,7,7,0,0,100,319236,2673,118
21107,2024,13,12,1,8,92,368308,3036,120
21108,2024,3,3,0,0,100,137283,1253,119
21109,2024,4,4,0,0,100,143719,1334,117
21110,2024,2,1,1,50,50,199500,2292,83
21111,2024,1,1,0,0,100,383000,1757,218
21112,2024,3,3,0,0,100,122333,1969,70
21113,2024,1,1,0,0,100,352100,2134,165
21114,2024,1,1,0,0,100,110052,1101,100
21115,2024,4,4,0,0,100,123750,1259,106
21117,2024,3,3,0,0,100,81783,802,104
21122,2024,5,5,0,0,100,198182,2007,95
21124,2024,4,4,0,0,100,119575,1283,89
21125,2024,1,1,0,0,100,64000,762,84
21126,2024,1,1,0,0,100,235300,2064,114
21127,2024,2,2,0,0,100,169500,2165,85
21128,2024,1,1,0,0,100,35000,507,69
21130,2024,3,3,0,0,100,197333,2349,83
21131,2024,3,3,0,0,100,87667,971,93
21134,2024,3,3,0,0,100,87667,1071,84
21135,2024,2,2,0,0,100,117000,702,128
21136,2024,1,1,0,0,100,70000,483,145
21138,2024,7,7,0,0,100,147843,1608,103
21139,2024,5,5,0,0,100,188700,2016,120
21140,2024,1,1,0,0,100,123600,1373,90
21142,2024,2,2,0,0,100,90189,1032,90
21146,2024,2,2,0,0,100,198600,2006,96
21148,2024,3,3,0,0,100,210000,1835,153
21150,2024,4,4,0,0,100,228888,1941,111
21152,2024,3,3,0,0,100,182667,1623,114
21153,2024,2,2,0,0,100,258150,1229,204
21154,2024,67,39,28,42,58,96977,1129,91
21158,2024,1,1,0,0,100,167500,1457,115
21160,2024,1,1,0,0,100,263000,1753,150
21162,2024,7,7,0,0,100,185291,2241,88
21166,2024,122,28,94,77,23,127769,1613,78
21169,2024,2,2,0,0,100,231500,2572,90
21170,2024,7,7,0,0,100,245837,2143,107
21171,2024,166,56,110,66,34,185278,2526,75
21173,2024,4,4,0,0,100,370975,4320,90
21175,2024,6,6,0,0,100,220183,2064,108
21176,2024,1,1,0,0,100,27000,675,40
21177,2024,3,3,0,0,100,120167,1112,106
21179,2024,5,5,0,0,100,289830,2478,115
21181,2024,1,1,0,0,100,86500,1030,84
21182,2024,2,2,0,0,100,143570,1952,74
21183,2024,11,11,0,0,100,228086,2264,103
21185,2024,2,2,0,0,100,374000,2937,140
21186,2024,6,6,0,0,100,184017,2159,86
21187,2024,2,2,0,0,100,160950,1508,108
21189,2024,3,3,0,0,100,124933,993,115
21190,2024,2,2,0,0,100,290000,1794,162
21191,2024,5,5,0,0,100,255600,2261,116
21192,2024,11,9,2,18,82,274369,2648,102
21193,2024,3,3,0,0,100,288100,2441,120
21194,2024,21,20,1,5,95,205435,2163,101
21195,2024,1,1,0,0,100,128250,1757,73
21196,2024,7,7,0,0,100,186424,1981,93
21200,2024,20,18,2,10,90,267567,2448,110
21201,2024,3,3,0,0,100,58000,867,72
21202,2024,2,2,0,0,100,151000,1238,117
21203,2024,2,2,0,0,100,147000,1237,108
21205,2024,1,1,0,0,100,199500,2404,83
21207,2024,1,1,0,0,100,80700,897,90
21208,2024,1,1,0,0,100,273400,2848,96
21209,2024,9,9,0,0,100,351872,3166,110
21210,2024,4,3,1,25,75,215684,1892,102
21211,2024,2,2,0,0,100,248950,1844,137
21212,2024,1,1,0,0,100,73000,521,140
21214,2024,3,3,0,0,100,96725,951,80
21215,2024,1,1,0,0,100,257000,2142,120
21216,2024,1,1,0,0,100,60000,714,84
21218,2024,1,1,0,0,100,258000,1792,144
21219,2024,2,2,0,0,100,343500,2296,152
21221,2024,2,2,0,0,100,50000,804,54
21223,2024,13,11,2,15,85,374945,3319,114
21224,2024,1,1,0,0,100,50000,532,94
21225,2024,1,1,0,0,100,41000,1206,34
21227,2024,3,3,0,0,100,282667,2469,118
21228,2024,3,3,0,0,100,179967,1349,114
21229,2024,1,1,0,0,100,158000,1629,97
21230,2024,3,3,0,0,100,286417,2303,127
21231,2024,2693,343,2350,87,13,166423,2730,61
21232,2024,6,6,0,0,100,99867,909,120
21233,2024,2,2,0,0,100,205100,2316,89
21234,2024,2,2,0,0,100,134500,1495,98
21236,2024,1,1,0,0,100,130000,2167,60
21237,2024,1,1,0,0,100,143910,1345,107
21239,2024,8,8,0,0,100,217484,1965,128
21241,2024,3,3,0,0,100,300233,2320,129
21242,2024,4,2,2,50,50,166125,2146,89
21243,2024,3,3,0,0,100,195000,1379,136
21244,2024,1,1,0,0,100,82000,988,83
21245,2024,10,8,2,20,80,302720,2407,124
21246,2024,5,5,0,0,100,269720,2338,111
21247,2024,12,12,0,0,100,125603,1196,107
21249,2024,14,14,0,0,100,185171,1839,109
21251,2024,6,5,1,17,83,193020,1999,90
21252,2024,2,2,0,0,100,44000,998,60
21253,2024,1,1,0,0,100,110000,846,130
21254,2024,1,1,0,0,100,99000,1320,75
21255,2024,3,3,0,0,100,348454,2446,150
21256,2024,2,2,0,0,100,227000,1656,136
21258,2024,1,1,0,0,100,103000,1108,93
21259,2024,1,1,0,0,100,76100,855,89
21261,2024,6,6,0,0,100,354967,2932,123
21263,2024,16,16,0,0,100,274624,3143,89
21265,2024,4,4,0,0,100,340125,3053,112
21266,2024,2,2,0,0,100,220300,3170,70
21267,2024,2,2,0,0,100,163540,2617,63
21268,2024,2,2,0,0,100,337000,4587,104
21269,2024,2,2,0,0,100,124000,1952,72
21270,2024,2,2,0,0,100,376000,3124,120
21271,2024,6,6,0,0,100,163750,2008,97
21272,2024,3,3,0,0,100,101833,875,124
21273,2024,15,14,1,7,93,225019,2100,104
21274,2024,2,2,0,0,100,50250,1117,45
21275,2024,4,4,0,0,100,125402,1158,122
21276,2024,1,1,0,0,100,110000,1571,70
21277,2024,14,14,0,0,100,163638,1895,92
21278,2024,127,61,66,52,48,262894,2970,86
21280,2024,2,2,0,0,100,65000,772,81
21281,2024,2,2,0,0,100,60500,606,102
21283,2024,2,2,0,0,100,118000,1013,114
21284,2024,2,2,0,0,100,100775,1880,64
21285,2024,4,4,0,0,100,183788,1292,144
21287,2024,1,1,0,0,100,187000,1508,124
21288,2024,3,3,0,0,100,113500,1179,87
21289,2024,2,2,0,0,100,183135,2114,82
21290,2024,8,7,1,12,88,199832,2178,91
21291,2024,6,6,0,0,100,105649,1189,89
21292,2024,54,36,18,33,67,153122,1902,83
21293,2024,3,3,0,0,100,118000,1831,63
21294,2024,2,2,0,0,100,394500,2830,155
21295,2024,35,15,20,57,43,221229,2676,79
21296,2024,3,3,0,0,100,72663,749,98
21297,2024,10,10,0,0,100,336167,2964,115
21298,2024,1,1,0,0,100,174000,1487,117
21299,2024,1,1,0,0,100,50000,714,70
21300,2024,5,5,0,0,100,142770,1731,81
21301,2024,6,6,0,0,100,171567,1571,114
21302,2024,2,2,0,0,100,44000,600,73
21303,2024,1,1,0,0,100,59750,610,98
21304,2024,1,1,0,0,100,85000,691,123
21305,2024,1,1,0,0,100,70755,1011,70
21308,2024,3,3,0,0,100,266800,1755,154
21309,2024,1,1,0,0,100,110000,430,256
21313,2024,1,1,0,0,100,40000,500,80
21315,2024,10,9,1,10,90,368364,2763,131
21316,2024,5,5,0,0,100,88710,1042,86
21317,2024,44,40,4,9,91,210922,2075,102
21319,2024,11,10,1,9,91,269831,2629,108
21320,2024,4,4,0,0,100,206962,2260,102
21322,2024,2,2,0,0,100,83000,929,84
21323,2024,1,1,0,0,100,222000,1432,155
21325,2024,1,1,0,0,100,18000,400,45
21327,2024,7,5,2,29,71,70714,680,103
21329,2024,1,1,0,0,100,200000,1036,193
21330,2024,4,4,0,0,100,199475,2389,84
21331,2024,3,3,0,0,100,174333,1720,101
21332,2024,10,10,0,0,100,145855,1372,117
21333,2024,4,4,0,0,100,128000,1477,87
21334,2024,7,7,0,0,100,116573,1118,103
21335,2024,2,2,0,0,100,95000,1166,82
21336,2024,6,6,0,0,100,131500,1112,129
21337,2024,25,23,2,8,92,129429,1726,81
21338,2024,2,2,0,0,100,92500,816,114
21339,2024,2,2,0,0,100,120000,1257,100
21340,2024,3,3,0,0,100,167933,1775,90
21341,2024,1,1,0,0,100,85000,664,128
21342,2024,3,3,0,0,100,229333,1416,153
21343,2024,3,3,0,0,100,30000,760,43
21344,2024,8,8,0,0,100,130625,1434,97
21345,2024,2,2,0,0,100,43808,575,76
21346,2024,2,2,0,0,100,48750,567,86
21347,2024,4,2,2,50,50,273725,2472,104
21348,2024,1,1,0,0,100,49000,645,76
21349,2024,5,5,0,0,100,139300,1219,109
21351,2024,7,7,0,0,100,225896,2002,116
21352,2024,15,15,0,0,100,205600,2055,104
21353,2024,13,13,0,0,100,254519,2525,101
21354,2024,1,1,0,0,100,215000,1604,134
21355,2024,74,33,41,55,45,194196,2466,79
21356,2024,19,18,1,5,95,156682,1573,99
21357,2024,1,1,0,0,100,143500,1435,100
21358,2024,2,2,0,0,100,188200,1188,144
21360,2024,3,3,0,0,100,82389,1186,70
21361,2024,7,7,0,0,100,152214,1494,98
21363,2024,2,2,0,0,100,142850,1196,118
21364,2024,2,2,0,0,100,163750,1502,113
21367,2024,2,2,0,0,100,137542,1798,78
21368,2024,4,4,0,0,100,316425,2420,133
21369,2024,5,5,0,0,100,253520,2341,108
21370,2024,10,9,1,10,90,333922,2545,131
21371,2024,5,5,0,0,100,162740,1524,103
21372,2024,2,2,0,0,100,88750,732,118
21373,2024,6,6,0,0,100,296604,2166,155
21374,2024,2,2,0,0,100,72500,841,80
21375,2024,2,2,0,0,100,50500,1308,39
21376,2024,1,1,0,0,100,210000,2414,87
21378,2024,1,1,0,0,100,105000,972,108
21379,2024,2,2,0,0,100,41500,704,62
21381,2024,2,2,0,0,100,126500,712,145
21382,2024,3,3,0,0,100,92667,1126,70
21383,2024,21,19,2,10,90,191265,2148,93
21384,2024,1,1,0,0,100,815000,3671,222
21385,2024,6,6,0,0,100,111000,961,112
21386,2024,3,3,0,0,100,58667,807,73
21387,2024,7,7,0,0,100,194432,1893,100
21388,2024,4,4,0,0,100,231062,1844,121
21389,2024,4,4,0,0,100,122200,1063,115
21390,2024,60,56,4,7,93,216159,2439,89
21391,2024,6,6,0,0,100,294008,2591,127
21394,2024,1,1,0,0,100,160820,1608,100
21397,2024,2,2,0,0,100,241000,2890,104
21398,2024,1,1,0,0,100,122000,953,128
21399,2024,2,2,0,0,100,151495,722,186
21401,2024,5,5,0,0,100,295210,2407,115
21402,2024,1,1,0,0,100,36000,720,50
21403,2024,3,3,0,0,100,61667,881,70
21404,2024,6,6,0,0,100,170817,1464,105
21405,2024,8,7,1,12,88,285104,2324,136
21406,2024,3,3,0,0,100,225700,1889,121
21407,2024,5,5,0,0,100,203940,3278,65
21408,2024,14,11,3,21,79,344631,2966,125
21409,2024,5,5,0,0,100,180680,1688,106
21411,2024,6,6,0,0,100,211953,1927,108
21412,2024,14,13,1,7,93,482518,3376,151
21413,2024,2,2,0,0,100,132500,1418,92
21414,2024,1,1,0,0,100,181100,1968,92
21415,2024,2,2,0,0,100,67000,625,107
21416,2024,21,20,1,5,95,194363,2072,99
21417,2024,4,4,0,0,100,151750,1536,100
21418,2024,1,1,0,0,100,31000,431,72
21419,2024,6,6,0,0,100,76376,836,96
21420,2024,1,1,0,0,100,59000,1513,39
21421,2024,1,1,0,0,100,324160,2593,125
21422,2024,4,4,0,0,100,150845,1827,103
21423,2024,9,9,0,0,100,346800,3594,100
21424,2024,2,2,0,0,100,151725,1085,132
21425,2024,55,35,20,36,64,96263,1202,80
21426,2024,1,1,0,0,100,222000,1850,120
21427,2024,1,1,0,0,100,271500,1697,160
21428,2024,3,3,0,0,100,377257,2793,135
21429,2024,3,3,0,0,100,172667,1577,99
21432,2024,4,4,0,0,100,151500,1044,125
21433,2024,4,4,0,0,100,128000,1361,97
21434,2024,3,3,0,0,100,65000,727,91
21435,2024,4,4,0,0,100,98250,1306,75
21436,2024,1,1,0,0,100,181000,1905,95
21437,2024,3,3,0,0,100,260333,1730,164
21439,2024,1,1,0,0,100,162460,1692,96
21440,2024,1,1,0,0,100,200000,2000,100
21441,2024,4,4,0,0,100,189855,2152,100
21442,2024,5,5,0,0,100,189570,1968,98
21444,2024,1,1,0,0,100,90000,776,116
21445,2024,4,4,0,0,100,106750,1056,106
21446,2024,1,1,0,0,100,87000,719,121
21447,2024,1,1,0,0,100,40000,851,47
21449,2024,1,1,0,0,100,85000,955,89
21450,2024,2,2,0,0,100,209000,1596,128
21451,2024,2,2,0,0,100,305975,2395,125
21452,2024,29,23,6,21,79,252566,2652,97
21454,2024,2,2,0,0,100,138910,1514,96
21455,2024,1,1,0,0,100,130000,1806,72
21457,2024,2,2,0,0,100,24000,375,64
21458,2024,9,9,0,0,100,238267,2141,115
21459,2024,2,2,0,0,100,166080,2076,80
21460,2024,2,2,0,0,100,64500,586,110
21461,2024,27,26,1,4,96,126108,1416,91
21462,2024,10,10,0,0,100,422010,3504,118
21464,2024,71,37,34,48,52,206883,2325,84
21465,2024,1,1,0,0,100,55000,509,108
21466,2024,1,1,0,0,100,95000,633,150
21468,2024,2,2,0,0,100,64500,702,96
21469,2024,3,3,0,0,100,242667,1983,124
21473,2024,5,4,1,20,80,264208,3238,100
21474,2024,3,3,0,0,100,96990,1065,99
21475,2024,7,7,0,0,100,161214,1691,99
21476,2024,2,2,0,0,100,206678,1424,144
21477,2024,1,1,0,0,100,215000,3071,70
21478,2024,4,4,0,0,100,144790,1743,83
21479,2024,1,1,0,0,100,52000,722,72
21480,2024,2,2,0,0,100,246450,2668,92
21481,2024,17,13,4,24,76,256184,2498,104
21482,2024,11,11,0,0,100,184627,1640,115
21483,2024,2,2,0,0,100,412750,3349,120
21485,2024,30,18,12,40,60,215065,2576,85
21487,2024,4,4,0,0,100,243075,2504,94
21488,2024,1,1,0,0,100,49000,907,54
21490,2024,2,2,0,0,100,134500,1122,124
21491,2024,1,1,0,0,100,52250,1066,49
21492,2024,6,5,1,17,83,340634,3479,84
21493,2024,7,7,0,0,100,132129,1981,79
21494,2024,1,1,0,0,100,245000,1021,240
21496,2024,22,20,2,9,91,138326,1778,83
21497,2024,3,3,0,0,100,146667,1566,101
21499,2024,2,2,0,0,100,152750,1036,141
21500,2024,5,5,0,0,100,132800,1477,90
21501,2024,20,17,3,15,85,185240,1981,94
21502,2024,10,10,0,0,100,130420,1534,87
21504,2024,2,2,0,0,100,181350,1964,92
21505,2024,9,9,0,0,100,121111,1154,101
21506,2024,7,7,0,0,100,236975,2393,99
21508,2024,6,6,0,0,100,260025,2593,104
21511,2024,2,2,0,0,100,134050,1222,112
21512,2024,8,8,0,0,100,153150,2106,73
21514,2024,2,2,0,0,100,53270,880,64
21515,2024,81,35,46,57,43,192932,2491,78
21517,2024,5,4,1,20,80,226866,2486,92
21518,2024,4,4,0,0,100,121050,1158,110
21519,2024,3,3,0,0,100,82333,1016,83
21520,2024,1,1,0,0,100,167500,1457,115
21521,2024,11,11,0,0,100,333305,2696,120
21522,2024,1,1,0,0,100,54000,1227,44
21523,2024,1,1,0,0,100,112000,889,126
21524,2024,1,1,0,0,100,64000,762,84
21525,2024,6,6,0,0,100,123526,1719,77
21527,2024,3,3,0,0,100,388077,2505,146
21528,2024,2,2,0,0,100,50900,760,70
21529,2024,1,1,0,0,100,90000,989,91
21530,2024,3,3,0,0,100,227333,1292,137
21531,2024,4,4,0,0,100,62400,1035,62
21532,2024,3,3,0,0,100,337977,2444,140
21534,2024,8,8,0,0,100,285000,2659,105
21535,2024,10,8,2,20,80,256435,2845,91
21536,2024,8,8,0,0,100,86750,1080,87
21537,2024,2,2,0,0,100,108030,972,88
21538,2024,2,2,0,0,100,54300,511,108
21540,2024,121,64,57,47,53,222607,2837,80
21541,2024,3,3,0,0,100,250928,2689,92
21542,2024,4,4,0,0,100,245800,2508,99
21544,2024,2,2,0,0,100,155500,975,140
21545,2024,8,7,1,12,88,103822,1179,84
21546,2024,3,3,0,0,100,115850,1830,71
21547,2024,1,1,0,0,100,80000,620,129
21548,2024,7,7,0,0,100,106708,1279,86
21550,2024,3,3,0,0,100,116867,1407,80
21554,2024,23,6,17,74,26,97685,1384,73
21555,2024,9,8,1,11,89,322589,2408,140
21556,2024,2,2,0,0,100,204250,2884,112
21557,2024,1,1,0,0,100,35000,614,57
21558,2024,10,9,1,10,90,266426,2603,108
21559,2024,4,4,0,0,100,227000,1944,126
21560,2024,1,1,0,0,100,145000,1450,100
21561,2024,4,4,0,0,100,160440,1520,104
21562,2024,1,1,0,0,100,240000,3529,68
21564,2024,1,1,0,0,100,222000,2242,99
21565,2024,5,5,0,0,100,230010,2390,98
21568,2024,8,8,0,0,100,104794,1540,68
21569,2024,5,5,0,0,100,211606,1548,122
21571,2024,1,1,0,0,100,222800,1120,199
21572,2024,1,1,0,0,100,134000,1811,74
21573,2024,4,4,0,0,100,183238,2119,88
21574,2024,2,2,0,0,100,107650,1163,92
21575,2024,1,1,0,0,100,120000,1043,115
21576,2024,2,2,0,0,100,163855,1566,103
21577,2024,10,10,0,0,100,225380,1747,130
21578,2024,3,3,0,0,100,182167,1827,103
21579,2024,1,1,0,0,100,75000,765,98
21581,2024,1,1,0,0,100,128000,1306,98
21582,2024,7,7,0,0,100,173250,1631,111
21583,2024,1,1,0,0,100,136360,1515,90
21584,2024,24,24,0,0,100,165176,1944,98
21585,2024,9,9,0,0,100,206889,2668,78
21586,2024,2,2,0,0,100,285420,2498,115
21587,2024,3,3,0,0,100,160600,1737,93
21589,2024,3,3,0,0,100,184333,1962,97
21590,2024,14,13,1,7,93,250463,2862,90
21591,2024,11,10,1,9,91,257773,2615,109
21593,2024,1,1,0,0,100,80000,571,140
21595,2024,1,1,0,0,100,293600,3262,90
21596,2024,4,4,0,0,100,334625,2322,147
21597,2024,1,1,0,0,100,212600,1772,120
21598,2024,3,3,0,0,100,168667,1523,111
21599,2024,28,26,2,7,93,164561,1754,99
21601,2024,2,2,0,0,100,110750,1577,63
21603,2024,26,18,8,31,69,132752,1612,87
21604,2024,3,3,0,0,100,160167,1147,134
21605,2024,17,16,1,6,94,253800,2579,100
21606,2024,18,17,1,6,94,230238,2256,106
21607,2024,26,21,5,19,81,140288,1657,91
21608,2024,2,2,0,0,100,87850,1136,65
21609,2024,3,3,0,0,100,215000,1953,111
21610,2024,5,5,0,0,100,163360,1461,122
21611,2024,11,11,0,0,100,155364,1751,93
21613,2024,3,3,0,0,100,113833,1929,66
21614,2024,2,2,0,0,100,224600,1328,182
21615,2024,1,1,0,0,100,23000,460,50
21617,2024,115,37,78,68,32,217666,2509,85
21618,2024,9,9,0,0,100,155896,1359,125
21619,2024,1,1,0,0,100,95000,1056,90
21620,2024,5,5,0,0,100,158265,1608,111
21622,2024,3,3,0,0,100,118650,1383,87
21623,2024,11,11,0,0,100,233219,2410,104
21625,2024,1,1,0,0,100,175000,1367,128
21628,2024,4,4,0,0,100,108888,1214,92
21629,2024,2,2,0,0,100,45500,1244,40
21630,2024,1,1,0,0,100,145000,1036,140
21632,2024,8,8,0,0,100,286000,2488,120
21633,2024,2,2,0,0,100,166000,1197,142
21634,2024,2,2,0,0,100,140000,1331,95
21635,2024,1,1,0,0,100,60000,667,90
21636,2024,6,6,0,0,100,75267,1432,72
21637,2024,3,3,0,0,100,79000,810,101
21638,2024,11,11,0,0,100,237765,1914,147
21639,2024,3,3,0,0,100,222333,1865,111
21641,2024,6,6,0,0,100,132167,1088,120
21642,2024,7,7,0,0,100,121371,1499,90
21643,2024,2,2,0,0,100,196920,2274,86
21644,2024,3,3,0,0,100,247813,1897,134
21645,2024,12,12,0,0,100,157425,1419,109
21648,2024,2,2,0,0,100,207500,2535,82
21650,2024,2,2,0,0,100,320332,2610,122
21651,2024,1,1,0,0,100,290100,2590,112
21652,2024,3,3,0,0,100,260923,2330,94
21653,2024,1,1,0,0,100,325000,1087,299
21656,2024,5,5,0,0,100,155100,2135,72
21657,2024,16,15,1,6,94,340919,3016,114
21659,2024,1,1,0,0,100,290650,2742,106
21661,2024,20,16,4,20,80,214697,2363,90
21663,2024,17,14,3,18,82,146638,1446,101
21664,2024,2,2,0,0,100,82100,745,110
21665,2024,2,2,0,0,100,151750,1146,130
21666,2024,3,3,0,0,100,156000,1236,131
21667,2024,5,5,0,0,100,224874,2223,102
21669,2024,2,2,0,0,100,114500,1390,90
21670,2024,7,7,0,0,100,125579,1295,88
21671,2024,3,2,1,33,67,80667,841,92
21673,2024,5,5,0,0,100,131100,1114,139
21674,2024,5,5,0,0,100,66000,764,91
21676,2024,2,2,0,0,100,116500,1516,76
21677,2024,2,2,0,0,100,140000,1714,78
21678,2024,3,3,0,0,100,204000,1307,146
21679,2024,3,3,0,0,100,148600,1994,75
21680,2024,6,6,0,0,100,150167,1349,118
21682,2024,3,3,0,0,100,255267,2371,108
21683,2024,7,7,0,0,100,78928,1059,76
21684,2024,1,1,0,0,100,208900,2611,80
21685,2024,2,2,0,0,100,202500,1124,160
21686,2024,2,2,0,0,100,88000,782,120
21687,2024,1,1,0,0,100,72500,1812,40
21688,2024,1,1,0,0,100,288000,1200,240
21689,2024,1,1,0,0,100,285750,1681,170
21690,2024,4,4,0,0,100,137925,1157,118
21691,2024,2,2,0,0,100,144000,2486,58
21692,2024,5,5,0,0,100,294200,2538,151
21693,2024,3,3,0,0,100,28333,1430,19
21695,2024,1,1,0,0,100,221000,1535,144
21696,2024,1,1,0,0,100,195000,1573,124
21698,2024,7,7,0,0,100,258307,2541,106
21699,2024,14,14,0,0,100,192821,2040,102
21702,2024,4,4,0,0,100,202000,1415,136
21703,2024,1,1,0,0,100,83700,1674,50
21707,2024,1,1,0,0,100,138000,1340,103
21708,2024,5,5,0,0,100,259972,2316,113
21709,2024,1,1,0,0,100,59000,1283,46
21710,2024,9,9,0,0,100,84808,969,83
21711,2024,2,2,0,0,100,137550,1680,82
21712,2024,3,3,0,0,100,209533,2070,112
21713,2024,4,3,1,25,75,102175,1236,90
21714,2024,3,3,0,0,100,255500,2693,93
21715,2024,6,6,0,0,100,110726,1139,102
21716,2024,2,1,1,50,50,334073,2517,124
21717,2024,5,5,0,0,100,66500,581,114
22001,2024,6,6,0,0,100,122695,1284,100
22002,2024,9,9,0,0,100,183700,1931,98
22003,2024,11,11,0,0,100,227487,1997,114
22004,2024,48,46,2,4,96,145983,1666,90
22005,2024,21,19,2,10,90,107613,1332,83
22006,2024,6,6,0,0,100,120825,1053,117
22008,2024,13,13,0,0,100,201111,1926,102
22009,2024,3,3,0,0,100,119117,1681,70
22011,2024,9,9,0,0,100,152628,1428,110
22012,2024,11,11,0,0,100,195906,2374,83
22013,2024,39,39,0,0,100,144841,1556,89
22014,2024,19,19,0,0,100,179143,1729,107
22015,2024,18,18,0,0,100,150272,1588,93
22016,2024,7,6,1,14,86,481589,6987,70
22018,2024,8,8,0,0,100,131611,1369,95
22019,2024,3,3,0,0,100,212995,1462,147
22020,2024,34,32,2,6,94,154469,1551,105
22021,2024,11,11,0,0,100,207621,1876,108
22023,2024,5,5,0,0,100,88872,1314,68
22024,2024,6,6,0,0,100,89967,1253,72
22025,2024,37,37,0,0,100,113409,1296,91
22026,2024,8,8,0,0,100,213125,2797,87
22028,2024,14,14,0,0,100,189750,2011,94
22029,2024,9,9,0,0,100,150944,1428,115
22030,2024,8,8,0,0,100,226964,1970,116
22031,2024,15,15,0,0,100,69357,919,86
22032,2024,30,29,1,3,97,137683,1542,91
22033,2024,10,10,0,0,100,171234,2170,81
22034,2024,11,11,0,0,100,154547,1630,98
22035,2024,9,9,0,0,100,174111,2145,91
22036,2024,2,2,0,0,100,54000,640,84
22037,2024,7,7,0,0,100,51697,830,73
22039,2024,9,9,0,0,100,106178,1138,91
22040,2024,1,1,0,0,100,428220,2049,209
22041,2024,3,3,0,0,100,91333,1120,83
22042,2024,6,6,0,0,100,259121,2083,120
22043,2024,2,2,0,0,100,146625,1426,104
22044,2024,8,8,0,0,100,210608,1942,111
22045,2024,6,6,0,0,100,187333,1713,106
22046,2024,96,96,0,0,100,116300,1207,100
22047,2024,12,11,1,8,92,162283,1380,118
22048,2024,19,19,0,0,100,183347,2208,89
22049,2024,15,15,0,0,100,247687,2586,100
22050,2024,250,92,158,63,37,205347,2788,75
22052,2024,3,3,0,0,100,61333,725,88
22053,2024,9,9,0,0,100,136383,1429,100
22054,2024,81,59,22,27,73,319756,3893,88
22055,2024,91,62,29,32,68,263143,3192,87
22056,2024,14,14,0,0,100,159716,1553,104
22057,2024,3,3,0,0,100,235539,1807,134
22059,2024,6,6,0,0,100,182167,1568,110
22060,2024,10,10,0,0,100,142901,1337,104
22061,2024,27,27,0,0,100,123716,1367,89
22062,2024,10,10,0,0,100,147130,1200,116
22063,2024,4,4,0,0,100,200000,1646,108
22064,2024,5,4,1,20,80,116400,978,111
22065,2024,25,25,0,0,100,172203,1723,103
22067,2024,28,28,0,0,100,156163,1785,94
22068,2024,6,5,1,17,83,147667,1281,112
22069,2024,2,2,0,0,100,182900,2772,66
22070,2024,124,56,68,55,45,138237,2101,71
22071,2024,6,6,0,0,100,188117,1951,98
22072,2024,8,8,0,0,100,117952,1430,90
22073,2024,5,5,0,0,100,100710,1446,70
22074,2024,10,10,0,0,100,110795,1298,87
22075,2024,5,5,0,0,100,111300,1351,94
22076,2024,14,14,0,0,100,247114,2134,119
22077,2024,14,14,0,0,100,221388,2201,115
22079,2024,23,23,0,0,100,157989,1796,94
22081,2024,46,39,7,15,85,173774,2182,82
22082,2024,7,7,0,0,100,258124,2498,103
22083,2024,8,8,0,0,100,140977,1220,120
22084,2024,30,30,0,0,100,201000,1913,103
22085,2024,7,7,0,0,100,229743,2896,77
22086,2024,8,8,0,0,100,163238,1857,93
22087,2024,7,7,0,0,100,94429,1109,78
22088,2024,3,3,0,0,100,86070,850,103
22090,2024,13,13,0,0,100,209377,2164,101
22091,2024,3,3,0,0,100,116333,1544,80
22092,2024,11,11,0,0,100,63266,1226,51
22093,2024,181,132,49,27,73,210692,2456,88
22094,2024,29,24,5,17,83,479607,4976,100
22095,2024,1,1,0,0,100,91643,1206,76
22096,2024,8,8,0,0,100,175125,2214,80
22097,2024,13,13,0,0,100,200400,1986,100
22098,2024,11,11,0,0,100,158024,1948,86
22099,2024,10,10,0,0,100,118100,1213,97
22101,2024,8,8,0,0,100,136919,1482,88
22103,2024,7,7,0,0,100,230886,2336,98
22104,2024,9,9,0,0,100,133926,1469,89
22105,2024,19,19,0,0,100,194016,2032,91
22106,2024,81,65,16,20,80,213765,2356,94
22107,2024,33,32,1,3,97,101189,1306,82
22108,2024,1,1,0,0,100,150000,1685,89
22109,2024,7,6,1,14,86,298136,4324,95
22110,2024,7,7,0,0,100,189429,2013,96
22111,2024,5,5,0,0,100,289950,2903,106
22112,2024,7,7,0,0,100,138595,1184,114
22113,2024,270,195,75,28,72,208057,2359,88
22114,2024,10,10,0,0,100,121888,1049,113
22115,2024,7,7,0,0,100,125129,1017,122
22116,2024,14,14,0,0,100,194819,1851,103
22117,2024,19,19,0,0,100,201091,2046,100
22118,2024,62,57,5,8,92,235306,2367,103
22119,2024,17,17,0,0,100,148289,1899,80
22121,2024,25,23,2,8,92,169672,1837,100
22122,2024,12,12,0,0,100,90014,1022,89
22124,2024,4,4,0,0,100,73500,942,75
22127,2024,26,23,3,12,88,308326,2845,110
22128,2024,13,13,0,0,100,125566,1119,109
22131,2024,21,21,0,0,100,98971,1282,76
22132,2024,3,3,0,0,100,78000,912,85
22133,2024,5,5,0,0,100,206300,1578,132
22134,2024,19,18,1,5,95,278567,2681,106
22135,2024,34,34,0,0,100,152068,1583,100
22136,2024,116,94,22,19,81,142807,1555,94
22137,2024,37,36,1,3,97,96203,1030,96
22138,2024,8,8,0,0,100,73801,942,88
22139,2024,1,1,0,0,100,134950,1350,100
22140,2024,6,6,0,0,100,210756,2369,88
22141,2024,1,1,0,0,100,155000,2013,77
22143,2024,27,21,6,22,78,214152,2704,84
22144,2024,10,10,0,0,100,164300,1750,92
22145,2024,9,9,0,0,100,146913,1438,106
22146,2024,7,7,0,0,100,73256,885,85
22147,2024,38,35,3,8,92,128771,1498,86
22148,2024,8,8,0,0,100,61438,667,92
22149,2024,12,12,0,0,100,103536,1010,99
22150,2024,7,7,0,0,100,155200,1577,101
22152,2024,9,9,0,0,100,234276,1899,124
22153,2024,10,10,0,0,100,127100,1562,82
22155,2024,17,17,0,0,100,134938,1419,99
22156,2024,6,6,0,0,100,72833,958,80
22157,2024,12,12,0,0,100,105364,1208,100
22158,2024,36,35,1,3,97,127029,1374,91
22160,2024,5,5,0,0,100,169333,1545,112
22161,2024,34,34,0,0,100,187403,1858,103
22162,2024,131,80,51,39,61,269350,3239,86
22163,2024,13,13,0,0,100,97661,1121,82
22164,2024,23,23,0,0,100,155415,1618,96
22165,2024,2,2,0,0,100,189500,2068,92
22166,2024,38,36,2,5,95,290992,3082,101
22168,2024,157,86,71,45,55,307801,3707,87
22169,2024,1,1,0,0,100,170000,1478,115
22170,2024,14,14,0,0,100,141812,1755,81
22171,2024,46,45,1,2,98,193477,2018,98
22172,2024,47,40,7,15,85,181040,2200,84
22174,2024,4,4,0,0,100,242000,2800,87
22175,2024,19,19,0,0,100,189766,1631,109
22176,2024,73,66,7,10,90,185861,1903,98
22177,2024,11,11,0,0,100,201584,2167,104
22178,2024,16,16,0,0,100,168645,2014,88
22179,2024,37,21,16,43,57,217409,3599,65
22180,2024,17,16,1,6,94,189644,1738,113
22181,2024,9,9,0,0,100,102422,1581,68
22182,2024,28,28,0,0,100,204828,2034,110
22183,2024,49,47,2,4,96,108629,1201,93
22184,2024,21,21,0,0,100,129062,1612,90
22185,2024,30,30,0,0,100,166944,1661,103
22186,2024,118,78,40,34,66,400394,4537,90
22187,2024,179,147,32,18,82,264534,2854,94
22188,2024,9,8,1,11,89,160556,1652,93
22189,2024,10,10,0,0,100,123969,1078,107
22190,2024,38,37,1,3,97,249225,2465,102
22193,2024,21,19,2,10,90,148389,1662,92
22194,2024,59,52,7,12,88,211303,2343,91
22195,2024,48,44,4,8,92,188925,2066,93
22196,2024,15,15,0,0,100,161961,1964,91
22197,2024,26,26,0,0,100,290039,2417,122
22198,2024,55,48,7,13,87,305957,2901,102
22199,2024,16,16,0,0,100,145278,1713,88
22200,2024,7,7,0,0,100,196714,1898,103
22201,2024,15,15,0,0,100,246670,3257,83
22202,2024,8,8,0,0,100,132361,1030,120
22203,2024,54,53,1,2,98,128043,1438,91
22204,2024,13,13,0,0,100,126781,1453,92
22205,2024,4,4,0,0,100,224226,2236,103
22206,2024,36,33,3,8,92,171719,1844,98
22207,2024,41,41,0,0,100,162474,1703,98
22208,2024,25,25,0,0,100,147720,1771,88
22209,2024,54,46,8,15,85,300948,3347,92
22210,2024,43,43,0,0,100,399135,3868,100
22211,2024,47,44,3,6,94,192997,2011,99
22212,2024,16,16,0,0,100,160233,1636,100
22213,2024,39,36,3,8,92,286526,2844,103
22214,2024,56,55,1,2,98,230260,2509,95
22215,2024,128,112,16,12,88,185421,2027,91
22216,2024,16,16,0,0,100,121416,1181,104
22217,2024,4,4,0,0,100,110000,1569,94
22218,2024,20,20,0,0,100,289076,3120,100
22219,2024,24,24,0,0,100,127218,1460,89
22220,2024,24,24,0,0,100,117782,1205,100
22221,2024,25,25,0,0,100,222663,2769,84
22222,2024,82,69,13,16,84,225266,2589,89
22223,2024,20,20,0,0,100,150144,1559,97
22224,2024,15,15,0,0,100,197564,2403,86
22225,2024,53,47,6,11,89,151645,1737,95
22226,2024,32,32,0,0,100,222757,2387,96
22227,2024,14,14,0,0,100,150910,1546,92
22228,2024,24,24,0,0,100,116944,1529,85
22229,2024,13,13,0,0,100,106127,1177,94
22231,2024,12,12,0,0,100,93788,1548,75
22232,2024,25,25,0,0,100,263837,2622,102
22233,2024,32,32,0,0,100,213493,2157,96
22234,2024,5,5,0,0,100,208000,2420,85
22235,2024,4,4,0,0,100,114750,1882,66
22236,2024,5,5,0,0,100,162700,1764,90
22237,2024,19,19,0,0,100,173586,1838,98
22238,2024,10,10,0,0,100,138780,1622,94
22239,2024,18,18,0,0,100,216813,2028,112
22240,2024,15,14,1,7,93,119133,1318,97
22241,2024,15,15,0,0,100,101494,1205,82
22242,2024,27,27,0,0,100,277561,3045,96
22243,2024,16,16,0,0,100,126780,1334,104
22244,2024,16,16,0,0,100,97716,1123,92
22245,2024,11,11,0,0,100,174645,1866,96
22246,2024,17,17,0,0,100,189724,1810,102
22248,2024,23,23,0,0,100,187784,1694,111
22249,2024,10,10,0,0,100,124678,1285,99
22250,2024,11,9,2,18,82,146400,1585,96
22251,2024,87,77,10,11,89,242445,2575,94
22254,2024,14,14,0,0,100,135914,1473,88
22255,2024,12,12,0,0,100,144342,1470,104
22256,2024,18,18,0,0,100,164194,1815,106
22257,2024,4,4,0,0,100,118625,2107,63
22258,2024,37,36,1,3,97,194055,1985,102
22259,2024,36,35,1,3,97,212594,2287,93
22260,2024,11,11,0,0,100,145158,1336,101
22261,2024,5,5,0,0,100,269750,1986,139
22262,2024,26,22,4,15,85,179472,2102,85
22263,2024,8,8,0,0,100,118162,1289,92
22264,2024,26,26,0,0,100,150250,1556,100
22265,2024,14,14,0,0,100,180401,1794,99
22266,2024,55,52,3,5,95,105553,1103,93
22267,2024,12,12,0,0,100,132775,1262,103
22268,2024,11,11,0,0,100,213613,1806,124
22269,2024,5,5,0,0,100,116580,1402,84
22271,2024,5,5,0,0,100,155800,1522,103
22272,2024,26,24,2,8,92,282692,2625,100
22273,2024,19,19,0,0,100,230812,2726,92
22274,2024,3,3,0,0,100,165583,2548,68
22275,2024,10,9,1,10,90,146297,1387,106
22277,2024,20,18,2,10,90,151392,2018,86
22278,2024,830,333,497,60,40,142816,1896,76
22279,2024,9,9,0,0,100,153922,1435,107
22280,2024,17,17,0,0,100,240394,2478,99
22281,2024,7,7,0,0,100,142614,1634,90
22282,2024,101,56,45,45,55,375322,4849,77
22283,2024,16,16,0,0,100,126576,1558,88
22284,2024,6,6,0,0,100,61495,1000,67
22285,2024,6,6,0,0,100,84968,945,103
22286,2024,7,7,0,0,100,200502,1861,101
22287,2024,10,10,0,0,100,166273,1674,103
22288,2024,4,4,0,0,100,110019,1101,102
22289,2024,3,3,0,0,100,110333,1304,95
22291,2024,3,3,0,0,100,141000,1646,84
22293,2024,6,6,0,0,100,126792,1446,88
22294,2024,5,5,0,0,100,84806,1227,70
22295,2024,11,11,0,0,100,98298,1158,83
22296,2024,3,3,0,0,100,49833,641,76
22299,2024,9,9,0,0,100,191492,2102,93
22300,2024,5,5,0,0,100,159600,1505,104
22302,2024,18,15,3,17,83,392081,5249,78
22304,2024,5,5,0,0,100,181192,2067,88
22305,2024,4,4,0,0,100,120525,1292,107
22306,2024,7,7,0,0,100,255071,2424,107
22307,2024,24,24,0,0,100,200073,1947,108
22308,2024,8,8,0,0,100,110938,1488,77
22309,2024,1,1,0,0,100,42000,525,80
22310,2024,3,3,0,0,100,130833,1761,75
22311,2024,12,12,0,0,100,210809,2172,94
22312,2024,2,2,0,0,100,79000,1119,72
22313,2024,7,7,0,0,100,73003,926,80
22314,2024,5,5,0,0,100,103600,1213,92
22315,2024,1,1,0,0,100,115000,1554,74
22316,2024,13,13,0,0,100,84707,1213,77
22317,2024,2,2,0,0,100,223500,2399,97
22318,2024,6,6,0,0,100,138183,2124,82
22319,2024,10,8,2,20,80,252725,3747,68
22320,2024,1,1,0,0,100,170400,2662,64
22321,2024,29,29,0,0,100,110001,1366,80
22322,2024,7,7,0,0,100,111628,1458,74
22323,2024,11,11,0,0,100,202818,2006,103
22324,2024,19,19,0,0,100,298600,2955,106
22325,2024,95,56,39,41,59,278495,3803,79
22326,2024,6,6,0,0,100,163819,1603,106
22327,2024,17,17,0,0,100,227794,2289,98
22328,2024,10,10,0,0,100,100014,1109,85
22330,2024,3,3,0,0,100,107617,888,102
22331,2024,3,3,0,0,100,67337,837,85
22332,2024,4,4,0,0,100,138750,1556,87
22333,2024,9,9,0,0,100,133743,1466,90
22334,2024,3,3,0,0,100,161000,1354,124
22335,2024,5,5,0,0,100,95370,1303,73
22337,2024,10,10,0,0,100,120460,1328,92
22338,2024,8,8,0,0,100,203157,1644,123
22339,2024,39,31,8,21,79,198693,2593,87
22340,2024,18,18,0,0,100,167529,1667,103
22341,2024,7,7,0,0,100,184135,1779,99
22342,2024,9,9,0,0,100,246403,2326,100
22343,2024,84,58,26,31,69,262942,3173,90
22344,2024,13,13,0,0,100,94805,1081,88
22345,2024,10,10,0,0,100,158728,2293,79
22346,2024,4,3,1,25,75,161988,2035,89
22347,2024,12,12,0,0,100,358762,2573,129
22348,2024,4,4,0,0,100,150250,1956,79
22349,2024,24,23,1,4,96,287208,2851,100
22350,2024,3,3,0,0,100,66667,1044,62
22351,2024,11,11,0,0,100,134816,1181,112
22352,2024,1,1,0,0,100,37000,1028,36
22353,2024,38,27,11,29,71,418224,4949,89
22354,2024,12,12,0,0,100,172608,1788,97
22356,2024,6,6,0,0,100,155992,1708,98
22358,2024,8,8,0,0,100,182046,1837,101
22359,2024,4,4,0,0,100,213333,1843,121
22360,2024,94,82,12,13,87,188912,2168,89
22361,2024,10,10,0,0,100,159704,1700,91
22362,2024,42,28,14,33,67,165178,2032,89
22363,2024,23,23,0,0,100,272840,2579,110
22364,2024,25,21,4,16,84,225808,2612,86
22365,2024,1,1,0,0,100,250000,2137,117
22366,2024,5,5,0,0,100,184000,1871,103
22368,2024,9,9,0,0,100,420742,4549,112
22369,2024,6,6,0,0,100,130890,1320,96
22370,2024,4,4,0,0,100,171500,1821,93
22371,2024,5,5,0,0,100,100000,1281,81
22372,2024,22,21,1,5,95,198100,2238,90
22373,2024,2,2,0,0,100,71325,682,108
22375,2024,9,9,0,0,100,167167,1481,102
22376,2024,10,10,0,0,100,134808,1498,84
22377,2024,22,22,0,0,100,293859,2608,116
22378,2024,2,2,0,0,100,68500,833,79
22379,2024,24,20,4,17,83,252854,2979,89
22380,2024,11,10,1,9,91,167964,2359,83
22381,2024,1,1,0,0,100,132000,1650,80
22383,2024,2,2,0,0,100,131500,2352,73
22384,2024,12,12,0,0,100,124681,1154,109
22385,2024,15,15,0,0,100,270574,2836,97
22386,2024,7,7,0,0,100,135929,1033,124
22387,2024,16,16,0,0,100,154009,1703,92
22388,2024,13,13,0,0,100,168928,1765,96
22389,2024,36,33,3,8,92,196735,2124,98
22390,2024,7,7,0,0,100,147571,1463,103
22391,2024,14,14,0,0,100,173835,1625,110
23001,2024,12,12,0,0,100,78751,953,85
23002,2024,12,12,0,0,100,88414,963,94
23003,2024,3,3,0,0,100,99000,791,96
23004,2024,8,8,0,0,100,64540,791,86
23005,2024,2,2,0,0,100,132500,910,145
23006,2024,6,6,0,0,100,120819,1115,105
23007,2024,4,4,0,0,100,90185,752,118
23008,2024,51,37,14,27,73,64184,836,77
23010,2024,1,1,0,0,100,85000,1000,85
23011,2024,3,3,0,0,100,96667,1031,98
23012,2024,3,3,0,0,100,65833,998,66
23013,2024,12,12,0,0,100,83675,904,94
23014,2024,2,2,0,0,100,145250,1802,80
23015,2024,12,12,0,0,100,62050,942,73
23016,2024,1,1,0,0,100,76500,490,156
23017,2024,5,5,0,0,100,43560,554,80
23018,2024,5,5,0,0,100,83600,864,102
23019,2024,1,1,0,0,100,67000,705,95
23020,2024,3,2,1,33,67,46000,674,75
23021,2024,12,12,0,0,100,78944,741,102
23022,2024,14,14,0,0,100,53571,811,65
23024,2024,5,5,0,0,100,117376,1157,105
23025,2024,11,11,0,0,100,105458,1008,104
23026,2024,7,7,0,0,100,103336,921,111
23027,2024,2,2,0,0,100,78500,940,90
23029,2024,7,7,0,0,100,61414,925,70
23030,2024,32,27,5,16,84,85264,812,96
23031,2024,13,13,0,0,100,107313,1202,97
23032,2024,6,6,0,0,100,91813,1221,67
23035,2024,9,9,0,0,100,88778,1561,66
23036,2024,20,19,1,5,95,75745,958,80
23037,2024,3,3,0,0,100,74591,743,126
23038,2024,2,2,0,0,100,34950,744,47
23039,2024,12,12,0,0,100,94383,846,106
23040,2024,1,1,0,0,100,130000,1083,120
23041,2024,5,5,0,0,100,79860,745,109
23045,2024,8,8,0,0,100,62741,752,81
23046,2024,5,5,0,0,100,45620,876,50
23047,2024,8,8,0,0,100,86749,998,99
23048,2024,6,6,0,0,100,101633,1079,90
23049,2024,4,4,0,0,100,103232,1291,72
23050,2024,2,2,0,0,100,85600,1415,90
23052,2024,7,7,0,0,100,103923,1195,90
23053,2024,1,1,0,0,100,94240,1178,80
23054,2024,1,1,0,0,100,51000,1133,45
23055,2024,4,4,0,0,100,131411,1292,106
23056,2024,12,12,0,0,100,98850,1367,84
23057,2024,8,8,0,0,100,65703,674,96
23058,2024,1,1,0,0,100,105000,583,180
23059,2024,2,2,0,0,100,35500,742,52
23060,2024,3,3,0,0,100,267100,2256,117
23061,2024,10,10,0,0,100,85770,900,98
23062,2024,12,12,0,0,100,62017,980,69
23063,2024,1,1,0,0,100,61790,1123,55
23064,2024,9,9,0,0,100,76222,1085,72
23065,2024,1,1,0,0,100,85000,497,171
23066,2024,4,4,0,0,100,107576,1151,100
23067,2024,3,3,0,0,100,107000,804,157
23068,2024,3,3,0,0,100,92333,598,162
23069,2024,6,6,0,0,100,44817,558,82
23070,2024,12,12,0,0,100,86941,1196,79
23071,2024,4,4,0,0,100,141875,1269,111
23072,2024,5,5,0,0,100,77290,885,100
23073,2024,4,4,0,0,100,75375,731,105
23074,2024,3,3,0,0,100,138050,968,132
23075,2024,14,14,0,0,100,128895,1233,102
23076,2024,15,15,0,0,100,106456,974,108
23077,2024,11,10,1,9,91,138745,2349,97
23078,2024,1,1,0,0,100,80220,1337,60
23079,2024,30,24,6,20,80,87301,1005,89
23080,2024,2,2,0,0,100,70000,634,110
23081,2024,3,3,0,0,100,50000,517,95
23082,2024,5,5,0,0,100,119537,1048,111
23083,2024,1,1,0,0,100,60000,517,116
23084,2024,2,2,0,0,100,50000,756,68
23086,2024,3,3,0,0,100,113167,1124,112
23087,2024,10,10,0,0,100,107285,1159,91
23089,2024,13,12,1,8,92,89713,1177,80
23090,2024,8,8,0,0,100,78138,1238,66
23091,2024,6,6,0,0,100,50548,630,90
23092,2024,5,5,0,0,100,93623,1071,92
23093,2024,14,14,0,0,100,102859,954,112
23095,2024,14,14,0,0,100,98467,1242,86
23096,2024,159,109,50,31,69,103965,1205,89
23097,2024,4,4,0,0,100,81691,1235,106
23098,2024,1,1,0,0,100,55000,470,117
23099,2024,8,8,0,0,100,144444,1206,118
23100,2024,3,3,0,0,100,110000,877,117
23101,2024,9,9,0,0,100,126661,1454,96
23102,2024,6,6,0,0,100,133245,1024,112
23103,2024,5,5,0,0,100,74090,861,84
23104,2024,1,1,0,0,100,30000,638,47
23105,2024,11,11,0,0,100,64048,798,85
23106,2024,4,4,0,0,100,104500,950,104
23107,2024,2,2,0,0,100,77000,1250,96
23108,2024,2,2,0,0,100,55000,519,114
23109,2024,4,4,0,0,100,70750,712,104
23111,2024,3,3,0,0,100,81333,1048,77
23112,2024,17,17,0,0,100,97295,1407,77
23113,2024,7,7,0,0,100,78126,789,100
23114,2024,6,6,0,0,100,72500,1431,56
23115,2024,8,8,0,0,100,57375,763,73
23116,2024,9,9,0,0,100,66428,903,77
23117,2024,3,3,0,0,100,57000,590,103
23118,2024,6,6,0,0,100,80290,954,82
23120,2024,6,6,0,0,100,117233,1256,89
23123,2024,7,7,0,0,100,104692,1040,89
23124,2024,13,13,0,0,100,106629,1169,95
23127,2024,3,3,0,0,100,32020,468,66
23128,2024,3,3,0,0,100,101783,1016,114
23129,2024,1,1,0,0,100,163500,1514,108
23130,2024,6,6,0,0,100,61910,891,72
23131,2024,10,10,0,0,100,93328,1544,88
23132,2024,5,5,0,0,100,86270,725,112
23133,2024,5,5,0,0,100,75600,1151,74
23134,2024,4,4,0,0,100,63005,914,64
23136,2024,4,4,0,0,100,120500,1092,106
23137,2024,8,7,1,12,88,75750,894,84
23138,2024,5,5,0,0,100,94950,928,100
23139,2024,12,12,0,0,100,81416,894,99
23141,2024,8,8,0,0,100,76869,1011,81
23142,2024,6,6,0,0,100,82776,1116,87
23143,2024,3,3,0,0,100,109500,1033,114
23144,2024,7,7,0,0,100,66214,824,75
23145,2024,4,4,0,0,100,84612,1034,73
23146,2024,8,8,0,0,100,100206,884,117
23147,2024,4,4,0,0,100,74734,895,71
23148,2024,3,3,0,0,100,50500,1152,43
23149,2024,12,12,0,0,100,100925,887,112
23150,2024,3,3,0,0,100,65200,819,80
23151,2024,11,11,0,0,100,125759,1227,111
23152,2024,2,2,0,0,100,229180,1782,118
23154,2024,10,10,0,0,100,81836,1041,75
23158,2024,3,3,0,0,100,84127,814,92
23159,2024,2,2,0,0,100,113750,1420,96
23160,2024,2,2,0,0,100,140486,1182,121
23162,2024,4,4,0,0,100,74800,1060,90
23164,2024,7,7,0,0,100,96486,898,111
23165,2024,16,16,0,0,100,91376,1226,78
23167,2024,5,4,1,20,80,73826,829,81
23168,2024,8,8,0,0,100,89681,874,100
23169,2024,4,4,0,0,100,102125,776,128
23170,2024,3,3,0,0,100,139167,1446,95
23171,2024,1,1,0,0,100,38000,1727,22
23173,2024,2,2,0,0,100,45000,538,82
23174,2024,5,5,0,0,100,111690,1173,107
23175,2024,1,1,0,0,100,150000,556,270
23176,2024,54,44,10,19,81,111305,1227,92
23177,2024,19,19,0,0,100,118580,1139,98
23178,2024,2,2,0,0,100,65100,846,74
23179,2024,4,4,0,0,100,113625,1139,102
23180,2024,5,5,0,0,100,113642,1300,89
23181,2024,6,6,0,0,100,140599,1139,105
23182,2024,2,2,0,0,100,92000,850,114
23184,2024,1,1,0,0,100,185500,1438,129
23185,2024,4,4,0,0,100,91750,834,104
23186,2024,1,1,0,0,100,50000,476,105
23187,2024,2,2,0,0,100,103928,644,138
23188,2024,9,9,0,0,100,82092,1387,74
23189,2024,13,13,0,0,100,82969,888,91
23190,2024,4,4,0,0,100,121750,1703,65
23191,2024,3,3,0,0,100,144553,1474,99
23192,2024,24,24,0,0,100,111551,1169,96
23193,2024,24,24,0,0,100,149349,1399,105
23194,2024,1,1,0,0,100,82570,794,104
23195,2024,10,10,0,0,100,97383,1108,87
23196,2024,3,3,0,0,100,115667,1271,90
23197,2024,7,7,0,0,100,117424,1085,115
23198,2024,1,1,0,0,100,75000,1250,60
23199,2024,7,7,0,0,100,41675,800,60
23200,2024,5,5,0,0,100,84405,1145,88
23202,2024,3,3,0,0,100,94755,1001,85
23203,2024,1,1,0,0,100,35000,357,98
23204,2024,2,2,0,0,100,52500,911,52
23205,2024,2,2,0,0,100,83900,984,80
23206,2024,7,7,0,0,100,151045,1268,122
23207,2024,1,1,0,0,100,73300,1047,70
23208,2024,3,3,0,0,100,48833,990,51
23209,2024,5,5,0,0,100,82511,936,91
23210,2024,4,4,0,0,100,90625,746,106
23211,2024,3,3,0,0,100,79500,1086,78
23212,2024,1,1,0,0,100,51000,1133,45
23213,2024,6,6,0,0,100,130790,1510,79
23214,2024,4,4,0,0,100,67050,1001,70
23216,2024,5,5,0,0,100,129600,1968,82
23217,2024,10,10,0,0,100,83399,944,86
23218,2024,5,5,0,0,100,73140,704,102
23219,2024,12,12,0,0,100,150276,1544,99
23220,2024,7,7,0,0,100,71100,791,88
23221,2024,4,4,0,0,100,130645,1168,95
23222,2024,1,1,0,0,100,245283,1251,196
23223,2024,7,7,0,0,100,87309,812,101
23225,2024,4,4,0,0,100,100500,1238,77
23226,2024,3,3,0,0,100,97865,1098,93
23228,2024,1,1,0,0,100,28000,350,80
23229,2024,3,3,0,0,100,73020,746,87
23232,2024,4,4,0,0,100,198672,1251,153
23233,2024,1,1,0,0,100,250467,2456,102
23234,2024,1,1,0,0,100,46800,390,120
23235,2024,14,14,0,0,100,107660,1052,103
23236,2024,7,7,0,0,100,67585,649,101
23237,2024,1,1,0,0,100,130300,1737,75
23238,2024,3,3,0,0,100,100467,1747,68
23239,2024,12,12,0,0,100,66186,940,76
23240,2024,10,10,0,0,100,118479,1522,84
23241,2024,2,2,0,0,100,150000,833,158
23242,2024,7,7,0,0,100,58343,760,77
23243,2024,2,2,0,0,100,77858,1250,66
23244,2024,12,12,0,0,100,86042,908,91
23245,2024,12,12,0,0,100,107864,1245,88
23246,2024,3,3,0,0,100,62533,762,80
23247,2024,18,16,2,11,89,82261,1005,81
23248,2024,6,6,0,0,100,137700,1606,94
23249,2024,2,2,0,0,100,177715,1734,122
23250,2024,5,5,0,0,100,59050,737,83
23251,2024,2,2,0,0,100,212000,1616,127
23252,2024,4,4,0,0,100,52704,865,65
23254,2024,3,3,0,0,100,68467,1020,70
23255,2024,2,2,0,0,100,109000,1138,106
23257,2024,7,7,0,0,100,58514,712,80
23258,2024,5,5,0,0,100,62692,1211,62
23259,2024,2,2,0,0,100,123500,982,126
23260,2024,3,3,0,0,100,164333,2003,91
23261,2024,1,1,0,0,100,76000,844,90
23262,2024,2,2,0,0,100,27750,731,44
23263,2024,4,4,0,0,100,62125,721,90
23265,2024,3,3,0,0,100,75333,1147,63
23266,2024,3,3,0,0,100,40100,755,58
24001,2024,7,7,0,0,100,128063,1566,93
24002,2024,15,15,0,0,100,164959,1655,103
24004,2024,2,2,0,0,100,258648,2758,92
24005,2024,5,4,1,20,80,189201,1886,94
24006,2024,2,2,0,0,100,118500,1855,78
24007,2024,6,6,0,0,100,168880,1638,95
24008,2024,8,7,1,12,88,129762,1285,96
24009,2024,5,5,0,0,100,179206,2020,87
24010,2024,14,14,0,0,100,176924,1843,104
24011,2024,6,6,0,0,100,160783,3456,70
24012,2024,3,3,0,0,100,366333,3187,125
24014,2024,3,3,0,0,100,220000,2094,105
24015,2024,4,4,0,0,100,232350,2238,103
24016,2024,6,5,1,17,83,147975,1428,110
24018,2024,1,1,0,0,100,135000,519,260
24019,2024,2,2,0,0,100,102764,1432,72
24020,2024,10,9,1,10,90,116942,1536,79
24021,2024,9,9,0,0,100,123471,1482,82
24022,2024,4,4,0,0,100,215560,1980,97
24023,2024,7,7,0,0,100,140709,1740,76
24024,2024,1,1,0,0,100,260000,2955,88
24025,2024,4,4,0,0,100,208050,2300,91
24026,2024,38,38,0,0,100,215700,2095,95
24027,2024,5,5,0,0,100,176976,1801,113
24028,2024,32,32,0,0,100,182079,1906,100
24029,2024,8,8,0,0,100,192452,2101,101
24030,2024,6,6,0,0,100,199947,1753,112
24031,2024,1,1,0,0,100,129000,1387,93
24032,2024,2,2,0,0,100,131024,1304,101
24034,2024,2,2,0,0,100,228070,1719,130
24035,2024,19,19,0,0,100,150739,1538,92
24036,2024,2,2,0,0,100,362225,2654,126
24037,2024,452,300,152,34,66,144364,1709,83
24038,2024,5,5,0,0,100,165658,1396,112
24039,2024,3,3,0,0,100,231000,1496,175
24040,2024,7,6,1,14,86,239214,2036,116
24042,2024,2,2,0,0,100,126966,1146,128
24043,2024,2,2,0,0,100,324830,2250,154
24045,2024,3,3,0,0,100,140000,1917,82
24046,2024,1,1,0,0,100,230000,1704,135
24048,2024,1,1,0,0,100,54000,982,55
24050,2024,2,2,0,0,100,182050,2086,110
24051,2024,1,1,0,0,100,97000,1617,60
24052,2024,1,1,0,0,100,370000,2937,126
24053,2024,91,74,17,19,81,198811,1999,98
24054,2024,3,3,0,0,100,188000,2012,92
24055,2024,13,13,0,0,100,275403,1726,154
24056,2024,3,3,0,0,100,46000,1013,45
24057,2024,1,1,0,0,100,235000,2938,80
24059,2024,3,3,0,0,100,145559,1626,86
24060,2024,2,2,0,0,100,105000,1088,109
24062,2024,1,1,0,0,100,200200,1726,116
24063,2024,2,2,0,0,100,246206,2388,104
24064,2024,36,34,2,6,94,171517,1808,103
24066,2024,3,3,0,0,100,209227,2265,90
24067,2024,53,53,0,0,100,160015,1618,99
24068,2024,24,24,0,0,100,182639,1792,111
24069,2024,1,1,0,0,100,195000,1489,131
24070,2024,9,8,1,11,89,112488,1427,80
24071,2024,7,7,0,0,100,86704,1065,88
24073,2024,7,7,0,0,100,203349,2559,84
24074,2024,7,7,0,0,100,315685,2422,137
24075,2024,5,5,0,0,100,175088,1800,121
24076,2024,2,2,0,0,100,246150,2138,115
24080,2024,3,3,0,0,100,138667,1678,95
24081,2024,7,6,1,14,86,248996,2278,115
24082,2024,11,11,0,0,100,168000,2117,80
24083,2024,2,2,0,0,100,397500,1492,232
24084,2024,2,2,0,0,100,295000,2356,132
24085,2024,2,2,0,0,100,402568,2278,178
24086,2024,5,5,0,0,100,300800,3307,116
24087,2024,7,7,0,0,100,176657,1715,116
24088,2024,4,4,0,0,100,143500,1577,98
24090,2024,3,3,0,0,100,140939,966,142
24091,2024,12,12,0,0,100,232193,2254,98
24094,2024,1,1,0,0,100,435000,3085,141
24095,2024,2,2,0,0,100,113500,1084,112
24096,2024,10,10,0,0,100,130495,1540,95
24097,2024,8,8,0,0,100,220150,2055,103
24098,2024,35,28,7,20,80,214504,2035,104
24100,2024,5,5,0,0,100,174715,1368,127
24101,2024,6,6,0,0,100,191452,1702,113
24102,2024,43,39,4,9,91,172882,1851,93
24104,2024,5,5,0,0,100,179381,1721,114
24105,2024,1,1,0,0,100,131575,1731,76
24106,2024,8,8,0,0,100,192838,2583,78
24107,2024,4,4,0,0,100,164874,1528,108
24108,2024,6,6,0,0,100,199523,1887,106
24109,2024,6,6,0,0,100,103184,1022,104
24110,2024,1,1,0,0,100,114000,633,180
24111,2024,2,2,0,0,100,52120,686,83
24115,2024,16,16,0,0,100,160657,1602,106
24116,2024,3,3,0,0,100,112833,2078,55
24117,2024,3,3,0,0,100,63500,882,71
24119,2024,1,1,0,0,100,115000,767,150
24120,2024,11,11,0,0,100,109350,1185,97
24121,2024,1,1,0,0,100,175000,1434,122
24124,2024,3,3,0,0,100,91402,1274,69
24126,2024,1,1,0,0,100,371121,2855,130
24128,2024,3,3,0,0,100,138100,1777,76
24129,2024,5,5,0,0,100,154205,2673,111
24130,2024,10,10,0,0,100,174344,1559,107
24132,2024,2,2,0,0,100,635750,3086,202
24133,2024,24,22,2,8,92,124077,1910,85
24134,2024,9,9,0,0,100,132117,1696,80
24135,2024,4,4,0,0,100,96500,1175,83
24136,2024,1,1,0,0,100,299000,2034,147
24137,2024,7,7,0,0,100,98129,1216,93
24138,2024,85,66,19,22,78,145594,1784,82
24139,2024,16,16,0,0,100,266273,1969,132
24140,2024,9,9,0,0,100,249512,2216,107
24141,2024,3,3,0,0,100,153303,1038,136
24142,2024,16,16,0,0,100,214008,2214,103
24143,2024,13,13,0,0,100,138707,1905,82
24145,2024,18,18,0,0,100,275628,2215,109
24146,2024,2,1,1,50,50,107500,2062,50
24147,2024,19,18,1,5,95,156395,1551,102
24148,2024,6,6,0,0,100,207167,1745,120
24150,2024,6,6,0,0,100,159312,1534,104
24152,2024,18,18,0,0,100,305479,2717,121
24153,2024,3,3,0,0,100,263550,2909,90
24154,2024,3,3,0,0,100,68000,1064,69
24155,2024,5,5,0,0,100,202924,1319,160
24156,2024,4,4,0,0,100,172000,1512,103
24157,2024,7,7,0,0,100,165920,1577,94
24158,2024,4,4,0,0,100,195055,1958,98
24159,2024,2,2,0,0,100,85099,1308,68
24160,2024,3,3,0,0,100,220000,1838,121
24161,2024,2,2,0,0,100,171000,1678,106
24162,2024,7,7,0,0,100,122571,1393,94
24163,2024,4,4,0,0,100,114300,1989,81
24164,2024,19,16,3,16,84,165236,1708,107
24165,2024,4,4,0,0,100,174725,1312,124
24167,2024,54,49,5,9,91,184649,1772,103
24168,2024,9,9,0,0,100,178625,2010,93
24171,2024,3,3,0,0,100,183950,1518,128
24172,2024,13,8,5,38,62,127862,1751,67
24174,2024,1,1,0,0,100,260000,2167,120
24175,2024,3,3,0,0,100,256333,1358,180
24177,2024,10,10,0,0,100,164185,1687,105
24179,2024,9,9,0,0,100,191000,2083,95
24180,2024,4,4,0,0,100,101962,971,94
24182,2024,17,17,0,0,100,181965,1516,117
24183,2024,6,6,0,0,100,399667,3041,152
24186,2024,7,7,0,0,100,122236,1129,125
24188,2024,7,7,0,0,100,144086,1688,88
24189,2024,2,2,0,0,100,157500,1601,95
24190,2024,1,1,0,0,100,80000,708,113
24192,2024,1,1,0,0,100,413820,3448,120
24193,2024,5,5,0,0,100,138320,1512,90
24194,2024,17,17,0,0,100,143414,1487,101
24196,2024,14,14,0,0,100,133147,1347,100
24197,2024,8,8,0,0,100,186731,1910,99
24199,2024,6,6,0,0,100,166084,1608,116
24200,2024,4,4,0,0,100,312125,1936,148
24202,2024,1,1,0,0,100,130000,1226,106
24205,2024,1,1,0,0,100,70000,1167,60
24207,2024,5,5,0,0,100,138461,1642,87
24208,2024,1,1,0,0,100,75000,750,100
24210,2024,9,9,0,0,100,108156,1853,67
24211,2024,5,5,0,0,100,222127,2045,104
24212,2024,14,14,0,0,100,181675,1705,110
24214,2024,6,6,0,0,100,148567,1393,103
24215,2024,3,3,0,0,100,152200,1428,97
24217,2024,4,4,0,0,100,397486,2709,148
24218,2024,13,13,0,0,100,177621,1974,111
24220,2024,2,2,0,0,100,232500,1668,140
24222,2024,35,32,3,9,91,175402,1751,98
24223,2024,48,45,3,6,94,166492,1646,96
24224,2024,4,4,0,0,100,436250,2144,201
24225,2024,18,18,0,0,100,173550,1628,107
24226,2024,8,8,0,0,100,186625,1820,105
24227,2024,15,15,0,0,100,130339,1424,88
24228,2024,10,10,0,0,100,162858,1447,110
24229,2024,13,12,1,8,92,133138,1639,89
24232,2024,1,1,0,0,100,48000,800,60
24236,2024,2,2,0,0,100,133915,1456,92
24237,2024,10,10,0,0,100,173095,1761,105
24238,2024,1,1,0,0,100,85000,1349,63
24240,2024,3,3,0,0,100,260333,2024,123
24241,2024,5,5,0,0,100,214591,1792,108
24242,2024,1,1,0,0,100,45000,455,99
24243,2024,11,11,0,0,100,100169,1205,87
24247,2024,4,3,1,25,75,304600,1866,170
24248,2024,4,4,0,0,100,240000,1702,167
24251,2024,2,2,0,0,100,129175,1270,98
24252,2024,6,6,0,0,100,203659,1918,100
24253,2024,29,29,0,0,100,136260,1379,102
24254,2024,4,4,0,0,100,306250,2920,118
24255,2024,2,2,0,0,100,314650,2634,111
24256,2024,28,16,12,43,57,161278,1747,90
24257,2024,5,5,0,0,100,168359,1466,113
24259,2024,19,19,0,0,100,195062,1530,124
24260,2024,6,6,0,0,100,151397,1599,97
24261,2024,2,2,0,0,100,400890,2580,159
24262,2024,4,4,0,0,100,112500,1380,78
24263,2024,4,4,0,0,100,154000,1360,112
24264,2024,22,22,0,0,100,133183,1298,106
24266,2024,23,23,0,0,100,150119,1755,91
24267,2024,3,3,0,0,100,173838,2436,75
24268,2024,7,7,0,0,100,245843,2890,103
24269,2024,9,9,0,0,100,136392,1037,143
24271,2024,4,4,0,0,100,113375,1148,94
24272,2024,2,2,0,0,100,103500,778,140
24273,2024,3,3,0,0,100,140333,1503,92
24274,2024,13,13,0,0,100,177742,1737,105
24276,2024,5,5,0,0,100,545738,3025,165
24277,2024,1,1,0,0,100,255280,1850,138
24278,2024,1,1,0,0,100,128650,1715,75
24279,2024,1,1,0,0,100,336500,2629,128
24280,2024,9,9,0,0,100,185333,1941,89
24281,2024,3,3,0,0,100,473688,2381,200
24282,2024,2,2,0,0,100,180392,2628,73
24284,2024,2,2,0,0,100,312125,1562,191
24285,2024,3,3,0,0,100,144057,1791,96
24286,2024,6,6,0,0,100,155927,1538,102
24287,2024,1,1,0,0,100,107040,1487,72
24288,2024,2,2,0,0,100,452500,3246,140
24289,2024,10,10,0,0,100,229895,2392,99
24290,2024,2,2,0,0,100,232500,1772,131
24291,2024,42,41,1,2,98,161623,1892,91
24292,2024,1,1,0,0,100,205000,2135,96
24293,2024,2,2,0,0,100,247840,2619,104
24294,2024,78,76,2,3,97,132641,1496,94
24295,2024,18,18,0,0,100,161800,1604,109
24296,2024,19,19,0,0,100,154791,1881,87
24297,2024,9,9,0,0,100,172339,1811,92
24299,2024,29,25,4,14,86,114485,1338,88
24300,2024,2,2,0,0,100,126250,962,133
24301,2024,7,7,0,0,100,136493,1338,100
24302,2024,3,3,0,0,100,225667,1575,153
24304,2024,12,11,1,8,92,122029,1326,90
24305,2024,3,3,0,0,100,78333,1043,76
24306,2024,1,1,0,0,100,200000,512,391
24308,2024,12,12,0,0,100,133682,1326,104
24309,2024,42,42,0,0,100,144004,1535,97
24311,2024,41,39,2,5,95,110665,1192,89
24312,2024,43,33,10,23,77,197109,1801,104
24316,2024,12,12,0,0,100,102000,1112,95
24317,2024,1,1,0,0,100,252814,3718,68
24318,2024,2,2,0,0,100,280525,2048,140
24319,2024,6,6,0,0,100,136615,1273,107
24320,2024,13,13,0,0,100,148522,1527,94
24321,2024,6,6,0,0,100,138796,1422,96
24322,2024,412,162,250,61,39,139643,1943,73
24323,2024,1,1,0,0,100,54000,1286,42
24324,2024,2,2,0,0,100,133350,1911,72
24325,2024,8,8,0,0,100,181719,1610,117
24326,2024,2,2,0,0,100,245250,1794,138
24327,2024,1,1,0,0,100,210000,1579,133
24328,2024,21,20,1,5,95,112665,1172,96
24329,2024,15,15,0,0,100,121705,1637,84
24330,2024,9,9,0,0,100,172503,1807,108
24331,2024,6,6,0,0,100,293592,1942,149
24334,2024,3,3,0,0,100,251118,1797,141
24335,2024,24,14,10,42,58,112876,1410,76
24336,2024,3,3,0,0,100,294500,2701,117
24338,2024,6,6,0,0,100,151517,1526,93
24339,2024,4,4,0,0,100,131117,1525,84
24340,2024,38,38,0,0,100,192437,1830,106
24341,2024,5,5,0,0,100,263084,3047,108
24345,2024,6,6,0,0,100,390832,3390,105
24346,2024,3,3,0,0,100,127833,1319,81
24348,2024,1,1,0,0,100,128000,1094,117
24350,2024,18,16,2,11,89,185022,1792,103
24351,2024,4,4,0,0,100,286854,1745,167
24352,2024,36,36,0,0,100,134949,1427,96
24353,2024,10,10,0,0,100,96690,923,110
24354,2024,31,30,1,3,97,144625,1532,96
24355,2024,2,2,0,0,100,143002,1342,98
24356,2024,13,13,0,0,100,242020,2720,105
24357,2024,5,5,0,0,100,151332,1360,107
24359,2024,1,1,0,0,100,877230,2683,327
24360,2024,1,1,0,0,100,86000,956,90
24361,2024,4,4,0,0,100,144750,1586,99
24362,2024,22,22,0,0,100,278447,2005,129
24364,2024,3,3,0,0,100,311563,2717,138
24365,2024,2,2,0,0,100,206550,2542,90
24366,2024,5,5,0,0,100,170000,1937,94
24367,2024,2,2,0,0,100,60000,1812,34
24370,2024,7,7,0,0,100,149045,1318,121
24371,2024,8,8,0,0,100,106415,1112,99
24372,2024,67,54,13,19,81,130816,1537,88
24373,2024,3,3,0,0,100,249780,2343,106
24374,2024,4,4,0,0,100,239052,2135,115
24375,2024,1,1,0,0,100,190500,2215,86
24376,2024,23,23,0,0,100,120109,1297,98
24377,2024,1,1,0,0,100,342857,1399,245
24378,2024,2,2,0,0,100,326000,1666,161
24379,2024,4,4,0,0,100,421125,2965,148
24380,2024,6,6,0,0,100,86083,1140,76
24381,2024,1,1,0,0,100,215000,2905,74
24382,2024,6,6,0,0,100,112159,1525,86
24383,2024,2,2,0,0,100,286475,1896,164
24384,2024,1,1,0,0,100,590000,3391,174
24385,2024,1,1,0,0,100,162000,1688,96
24386,2024,1,1,0,0,100,71819,598,120
24388,2024,8,8,0,0,100,399025,4044,102
24390,2024,3,3,0,0,100,173333,1410,120
24392,2024,2,2,0,0,100,274550,1660,178
24393,2024,1,1,0,0,100,275000,2052,134
24394,2024,2,2,0,0,100,116990,906,130
24395,2024,5,5,0,0,100,241000,2738,108
24396,2024,25,21,4,16,84,195162,1877,101
24397,2024,5,5,0,0,100,116030,1485,87
24398,2024,9,9,0,0,100,120243,1566,80
24399,2024,2,2,0,0,100,143000,1177,118
24401,2024,5,5,0,0,100,99236,1309,83
24404,2024,2,2,0,0,100,140125,1182,119
24405,2024,3,3,0,0,100,152411,1801,92
24406,2024,1,1,0,0,100,295000,1867,158
24407,2024,6,6,0,0,100,193915,1628,122
24408,2024,3,3,0,0,100,86650,815,113
24409,2024,14,14,0,0,100,128150,1407,90
24410,2024,6,6,0,0,100,119172,903,128
24411,2024,1,1,0,0,100,50000,1667,30
24412,2024,9,7,2,22,78,251574,2335,104
24413,2024,4,4,0,0,100,210150,1740,117
24414,2024,4,4,0,0,100,514459,2612,184
24415,2024,2,2,0,0,100,150000,1380,110
24416,2024,5,5,0,0,100,150400,1604,91
24417,2024,12,12,0,0,100,105064,1256,86
24418,2024,15,15,0,0,100,153639,1685,91
24419,2024,6,6,0,0,100,229671,2238,103
24421,2024,3,3,0,0,100,205710,1519,128
24422,2024,3,3,0,0,100,218000,2005,110
24423,2024,1,1,0,0,100,275000,1007,273
24425,2024,4,4,0,0,100,139989,1502,107
24428,2024,6,6,0,0,100,222133,2535,82
24429,2024,3,3,0,0,100,209802,2007,96
24432,2024,8,8,0,0,100,181322,1744,100
24434,2024,1,1,0,0,100,50000,625,80
24436,2024,8,8,0,0,100,137562,1528,90
24437,2024,15,15,0,0,100,257317,2088,122
24438,2024,3,3,0,0,100,171848,1346,132
24442,2024,21,21,0,0,100,116617,1440,83
24443,2024,2,2,0,0,100,255000,2684,116
24444,2024,4,4,0,0,100,106250,1358,82
24445,2024,3,3,0,0,100,331833,1973,160
24448,2024,6,6,0,0,100,146016,1686,96
24449,2024,12,12,0,0,100,143183,1472,98
24450,2024,12,12,0,0,100,194888,1900,112
24451,2024,10,10,0,0,100,141948,1445,100
24452,2024,1,1,0,0,100,70000,1400,50
24453,2024,2,2,0,0,100,72790,1100,58
24454,2024,6,6,0,0,100,163500,1562,113
24455,2024,7,7,0,0,100,192657,1484,129
24456,2024,3,3,0,0,100,232333,1989,114
24457,2024,1,1,0,0,100,30000,385,78
24458,2024,4,4,0,0,100,172562,1607,123
24459,2024,3,2,1,33,67,246005,2115,120
24460,2024,5,5,0,0,100,113442,1465,78
24461,2024,6,6,0,0,100,212667,1463,146
24462,2024,15,15,0,0,100,117517,1388,91
24463,2024,4,4,0,0,100,182250,1792,92
24464,2024,4,4,0,0,100,128280,1176,87
24465,2024,3,3,0,0,100,115667,1313,88
24466,2024,4,4,0,0,100,156000,1684,90
24470,2024,3,3,0,0,100,305518,3313,99
24471,2024,6,6,0,0,100,224993,2191,100
24472,2024,5,5,0,0,100,190670,2125,93
24473,2024,5,5,0,0,100,108780,1322,84
24474,2024,2,2,0,0,100,132035,1497,90
24476,2024,1,1,0,0,100,320000,3265,98
24477,2024,1,1,0,0,100,290000,2900,100
24479,2024,17,17,0,0,100,82007,957,88
24480,2024,3,3,0,0,100,104667,1309,89
24481,2024,5,5,0,0,100,106000,1049,92
24483,2024,2,2,0,0,100,168291,1522,100
24484,2024,6,6,0,0,100,191262,1901,96
24485,2024,5,4,1,20,80,151970,1704,86
24486,2024,8,8,0,0,100,108402,1160,90
24487,2024,14,14,0,0,100,159814,1418,112
24488,2024,3,3,0,0,100,136333,1657,81
24489,2024,9,9,0,0,100,172411,1536,107
24490,2024,22,22,0,0,100,159222,1327,124
24491,2024,10,10,0,0,100,112094,1437,77
24493,2024,6,6,0,0,100,202239,1754,96
24494,2024,7,7,0,0,100,228629,1673,137
24495,2024,1,1,0,0,100,50000,1282,39
24496,2024,1,1,0,0,100,75000,1119,67
24498,2024,24,24,0,0,100,139298,1383,102
24499,2024,7,7,0,0,100,192500,2119,91
24500,2024,1,1,0,0,100,150000,1899,79
24501,2024,3,3,0,0,100,197950,1622,118
24504,2024,3,3,0,0,100,270636,1897,152
24505,2024,4,4,0,0,100,156412,1066,134
24507,2024,1,1,0,0,100,74000,1213,61
24508,2024,1,1,0,0,100,235000,1808,130
24509,2024,6,6,0,0,100,104392,1041,91
24510,2024,3,2,1,33,67,320767,2418,117
24511,2024,6,6,0,0,100,83667,1015,96
24512,2024,1,1,0,0,100,361000,2756,131
24513,2024,4,4,0,0,100,147750,1312,106
24514,2024,4,4,0,0,100,134250,1464,100
24515,2024,2,2,0,0,100,167500,2364,70
24516,2024,12,12,0,0,100,226580,2121,118
24517,2024,2,2,0,0,100,74242,542,135
24518,2024,2,2,0,0,100,173438,1680,91
24519,2024,8,8,0,0,100,157741,1272,94
24520,2024,116,73,43,37,63,192421,2125,89
24521,2024,9,9,0,0,100,187306,1807,105
24522,2024,11,11,0,0,100,186032,2043,94
24523,2024,6,6,0,0,100,212261,1564,139
24524,2024,3,3,0,0,100,211500,1636,130
24525,2024,1,1,0,0,100,317000,1124,282
24526,2024,12,12,0,0,100,114454,1351,85
24527,2024,10,10,0,0,100,135973,1630,90
24528,2024,1,1,0,0,100,52000,1040,50
24529,2024,1,1,0,0,100,133480,1780,75
24531,2024,2,2,0,0,100,237500,1840,126
24532,2024,4,4,0,0,100,511442,3631,149
24533,2024,2,2,0,0,100,230000,3110,70
24534,2024,15,15,0,0,100,236949,1911,137
24535,2024,1,1,0,0,100,224900,1704,132
24536,2024,4,4,0,0,100,190978,1870,104
24537,2024,2,2,0,0,100,427500,2001,211
24538,2024,8,8,0,0,100,117866,1295,89
24540,2024,15,15,0,0,100,224728,2110,107
24542,2024,2,2,0,0,100,209705,1732,127
24543,2024,11,11,0,0,100,128161,1366,101
24544,2024,5,5,0,0,100,318750,4123,82
24547,2024,71,58,13,18,82,165219,1708,90
24548,2024,1,1,0,0,100,48000,800,60
24549,2024,5,5,0,0,100,421892,1875,233
24550,2024,15,15,0,0,100,139601,1365,106
24551,2024,28,28,0,0,100,125808,1256,110
24552,2024,1,1,0,0,100,60000,1333,45
24553,2024,31,31,0,0,100,156171,1553,100
24554,2024,5,5,0,0,100,177834,1203,141
24555,2024,21,21,0,0,100,142151,1295,106
24557,2024,102,68,34,33,67,171534,1853,89
24558,2024,11,11,0,0,100,231475,1981,118
24559,2024,3,3,0,0,100,257833,2346,107
24562,2024,1,1,0,0,100,180000,1935,93
24563,2024,2,2,0,0,100,84000,1444,54
24564,2024,6,6,0,0,100,119808,1283,97
24565,2024,9,9,0,0,100,81255,1021,87
24566,2024,5,5,0,0,100,157138,1552,99
24567,2024,1,1,0,0,100,225000,2344,96
24568,2024,7,7,0,0,100,132465,1403,114
24570,2024,1,1,0,0,100,261500,1743,150
24571,2024,18,16,2,11,89,172091,1584,117
24572,2024,4,4,0,0,100,286000,2228,133
24573,2024,9,9,0,0,100,182856,1228,138
24574,2024,2,2,0,0,100,77000,1216,56
24576,2024,2,2,0,0,100,215000,2634,67
24577,2024,7,7,0,0,100,229616,2215,105
24580,2024,5,5,0,0,100,119520,1348,84
24581,2024,7,7,0,0,100,228358,1716,139
24582,2024,5,5,0,0,100,130200,1175,115
24584,2024,15,15,0,0,100,166784,1502,109
24585,2024,8,8,0,0,100,139402,1442,100
24586,2024,8,8,0,0,100,97994,1106,86
24587,2024,7,7,0,0,100,226367,2978,89
25002,2024,4,4,0,0,100,278125,2056,132
25003,2024,1,1,0,0,100,152400,996,153
25004,2024,8,7,1,12,88,236930,2228,109
25005,2024,1,1,0,0,100,160000,1553,103
25008,2024,8,8,0,0,100,113294,1255,91
25009,2024,3,3,0,0,100,114000,1386,86
25011,2024,4,4,0,0,100,83965,882,98
25012,2024,2,2,0,0,100,286500,2818,104
25013,2024,1,1,0,0,100,134950,1421,95
25014,2024,4,4,0,0,100,170060,1594,102
25015,2024,2,2,0,0,100,205000,1295,165
25016,2024,2,2,0,0,100,211150,2367,88
25018,2024,7,7,0,0,100,161821,1554,107
25019,2024,4,4,0,0,100,136250,946,157
25020,2024,10,6,4,40,60,95410,1109,82
25021,2024,15,15,0,0,100,172376,1687,102
25022,2024,12,12,0,0,100,165154,1487,117
25024,2024,6,4,2,33,67,254941,2493,110
25025,2024,4,4,0,0,100,240000,2124,115
25026,2024,2,2,0,0,100,132000,1413,90
25029,2024,2,2,0,0,100,277450,2926,96
25030,2024,1,1,0,0,100,232500,2612,89
25031,2024,142,68,74,52,48,114378,1305,87
25032,2024,3,3,0,0,100,145000,1023,133
25033,2024,3,3,0,0,100,202000,1851,106
25035,2024,27,21,6,22,78,235465,2459,98
25036,2024,20,14,6,30,70,202275,2170,88
25038,2024,4,4,0,0,100,167950,1574,114
25039,2024,6,5,1,17,83,219465,1808,123
25040,2024,8,6,2,25,75,113558,1407,77
25041,2024,2,2,0,0,100,357500,3622,98
25042,2024,5,5,0,0,100,273046,1909,144
25043,2024,16,14,2,12,88,142555,1672,94
25044,2024,1,1,0,0,100,159750,1087,147
25046,2024,1,1,0,0,100,124500,2649,47
25047,2024,48,31,17,35,65,134808,1696,80
25048,2024,24,20,4,17,83,150436,1649,88
25051,2024,5,5,0,0,100,209440,1674,136
25053,2024,1,1,0,0,100,50000,568,88
25055,2024,1,1,0,0,100,505000,2167,233
25056,2024,1534,167,1367,89,11,150393,2281,68
25057,2024,29,22,7,24,76,105553,1251,85
25058,2024,21,5,16,76,24,123183,1935,64
25059,2024,2,2,0,0,100,119250,1480,80
25060,2024,14,9,5,36,64,194370,2070,97
25061,2024,3,3,0,0,100,166833,1454,96
25062,2024,2,2,0,0,100,329500,2738,119
25063,2024,13,10,3,23,77,178979,1924,94
25066,2024,1,1,0,0,100,182250,2430,75
25067,2024,7,7,0,0,100,201460,1613,120
25070,2024,3,3,0,0,100,254633,1990,133
25071,2024,4,3,1,25,75,157110,1611,99
25073,2024,9,8,1,11,89,285531,2017,136
25074,2024,4,4,0,0,100,234788,1749,134
25075,2024,4,4,0,0,100,361175,3270,120
25077,2024,1,1,0,0,100,344000,2709,127
25078,2024,8,7,1,12,88,162762,1666,108
25079,2024,8,6,2,25,75,185477,1852,101
25082,2024,10,10,0,0,100,167310,1728,98
25084,2024,8,8,0,0,100,224415,2172,110
25085,2024,5,3,2,40,60,219200,2523,81
25086,2024,1,1,0,0,100,265000,2246,118
25087,2024,2,2,0,0,100,118350,819,140
25088,2024,1,1,0,0,100,225800,2110,107
25089,2024,1,1,0,0,100,128000,753,170
25091,2024,5,4,1,20,80,299552,2228,133
25092,2024,1,1,0,0,100,155000,803,193
25095,2024,2,2,0,0,100,227500,3213,72
25096,2024,1,1,0,0,100,315000,1607,196
25097,2024,9,9,0,0,100,178560,1520,116
25098,2024,2,2,0,0,100,359111,2708,118
25099,2024,1,1,0,0,100,325000,2664,122
25100,2024,2,1,1,50,50,255250,2584,96
25101,2024,9,8,1,11,89,251473,2163,115
25103,2024,3,3,0,0,100,201667,2078,97
25105,2024,3,3,0,0,100,186383,1711,106
25106,2024,2,2,0,0,100,316642,2688,124
25107,2024,4,4,0,0,100,149892,1400,111
25108,2024,4,3,1,25,75,270174,3089,88
25109,2024,2,2,0,0,100,115000,1444,76
25110,2024,11,8,3,27,73,356284,3362,110
25111,2024,7,2,5,71,29,171419,2104,81
25112,2024,15,3,12,80,20,120728,2256,55
25114,2024,5,5,0,0,100,118984,1212,98
25115,2024,3,3,0,0,100,189700,1790,113
25116,2024,4,4,0,0,100,169136,1750,100
25117,2024,3,3,0,0,100,272557,1952,139
25119,2024,1,1,0,0,100,365800,2926,125
25120,2024,2,2,0,0,100,128750,1300,104
25121,2024,3,0,3,100,0,133667,2638,53
25122,2024,2,1,1,50,50,121550,1207,96
25124,2024,6,6,0,0,100,192700,2208,102
25125,2024,3,2,1,33,67,150200,1519,103
25126,2024,3,3,0,0,100,200000,1667,122
25127,2024,53,28,25,47,53,199882,2220,90
25131,2024,1,1,0,0,100,328500,3159,104
25132,2024,1,1,0,0,100,146000,1825,80
25133,2024,20,18,2,10,90,347536,2557,138
25136,2024,3,3,0,0,100,281197,2272,148
25139,2024,6,4,2,33,67,245700,2741,90
25141,2024,2,2,0,0,100,120000,793,118
25142,2024,4,2,2,50,50,190250,2359,82
25143,2024,1,1,0,0,100,235200,2329,101
25145,2024,1,1,0,0,100,190000,1462,130
25147,2024,13,10,3,23,77,259928,2324,120
25148,2024,4,4,0,0,100,342368,2693,127
25150,2024,2,2,0,0,100,256000,2204,116
25151,2024,1,1,0,0,100,290000,1487,195
25154,2024,3,2,1,33,67,80830,1303,64
25155,2024,3,1,2,67,33,121333,1262,99
25156,2024,10,9,1,10,90,86474,1025,81
25157,2024,16,6,10,62,38,250819,3136,84
25159,2024,13,12,1,8,92,135022,1407,106
25160,2024,1,1,0,0,100,165000,1833,90
25170,2024,8,7,1,12,88,183125,1714,106
25172,2024,3,2,1,33,67,208830,2172,93
25173,2024,1,1,0,0,100,158000,1423,111
25175,2024,1,1,0,0,100,538835,1585,340
25176,2024,4,3,1,25,75,236230,1692,132
25177,2024,1,1,0,0,100,215000,1792,120
25181,2024,2,2,0,0,100,148760,1663,92
25184,2024,2,2,0,0,100,70375,674,104
25185,2024,1,1,0,0,100,212750,1730,123
25186,2024,7,5,2,29,71,220014,2231,99
25187,2024,3,2,1,33,67,196867,1767,107
25188,2024,7,7,0,0,100,168214,1549,105
25190,2024,21,16,5,24,76,139790,1478,93
25191,2024,3,3,0,0,100,164517,1595,100
25193,2024,36,23,13,36,64,201742,2028,99
25194,2024,2,2,0,0,100,127200,1610,78
25195,2024,10,10,0,0,100,261454,2365,112
25196,2024,22,14,8,36,64,145902,1359,90
25197,2024,12,7,5,42,58,136233,1632,85
25198,2024,3,2,1,33,67,141000,1230,109
25199,2024,2,1,1,50,50,76500,882,112
25200,2024,14,10,4,29,71,225142,2224,101
25201,2024,7,2,5,71,29,287484,3286,88
25202,2024,6,5,1,17,83,278764,2438,114
25203,2024,1,1,0,0,100,130000,2063,63
25204,2024,32,14,18,56,44,285072,3022,96
25207,2024,6,6,0,0,100,160733,1552,100
25208,2024,1,0,1,100,0,251400,1143,220
25212,2024,33,27,6,18,82,271674,2643,103
25213,2024,9,8,1,11,89,303505,2699,117
25214,2024,3,3,0,0,100,241000,2127,110
25215,2024,1,1,0,0,100,150000,1007,149
25216,2024,2,2,0,0,100,182000,1545,115
25217,2024,3,3,0,0,100,290117,2409,120
25219,2024,7,5,2,29,71,148873,1726,91
25220,2024,3,3,0,0,100,217500,2011,113
25221,2024,1,0,1,100,0,174000,2175,80
25222,2024,8,7,1,12,88,241038,2568,102
25223,2024,3,2,1,33,67,142628,1353,115
25224,2024,6,6,0,0,100,103483,1035,104
25226,2024,3,3,0,0,100,172393,1521,113
25227,2024,1,0,1,100,0,224931,2847,79
25228,2024,39,32,7,18,82,168706,1595,103
25229,2024,4,3,1,25,75,238644,2183,117
25230,2024,32,30,2,6,94,135530,1616,84
25231,2024,3,3,0,0,100,185720,1243,148
25232,2024,3,2,1,33,67,143800,1412,95
25233,2024,1,1,0,0,100,205750,2261,91
25234,2024,3,2,1,33,67,239080,2002,117
25235,2024,3,3,0,0,100,250333,1969,126
25236,2024,3,3,0,0,100,221237,1455,156
25237,2024,19,14,5,26,74,129534,1686,83
25238,2024,1,1,0,0,100,276000,2123,130
25239,2024,2,2,0,0,100,183240,2194,85
25240,2024,26,17,9,35,65,296650,3151,100
25242,2024,2,2,0,0,100,157885,1790,86
25243,2024,7,6,1,14,86,191957,2222,94
25245,2024,12,12,0,0,100,250665,2284,111
25246,2024,1,1,0,0,100,100000,1205,83
25247,2024,3,3,0,0,100,109900,1330,103
25248,2024,11,3,8,73,27,130727,1499,87
25251,2024,1,1,0,0,100,43500,1243,35
25252,2024,3,3,0,0,100,335677,3067,107
25253,2024,4,4,0,0,100,248072,2064,132
25254,2024,26,6,20,77,23,192376,2704,71
25255,2024,3,3,0,0,100,218707,2960,75
25256,2024,14,11,3,21,79,241041,2527,94
25257,2024,3,3,0,0,100,229083,1474,162
25258,2024,26,16,10,38,62,217463,2374,93
25259,2024,23,16,7,30,70,223456,2294,101
25261,2024,1,1,0,0,100,203700,1997,102
25262,2024,3,3,0,0,100,231930,1842,129
25263,2024,4,3,1,25,75,252025,2773,89
25264,2024,1,1,0,0,100,55000,470,117
25265,2024,11,7,4,36,64,273716,2395,113
25266,2024,1,1,0,0,100,85000,1076,79
25267,2024,4,4,0,0,100,284860,2584,114
25268,2024,3,3,0,0,100,123567,1111,112
25270,2024,1,1,0,0,100,266100,1835,145
25271,2024,23,16,7,30,70,268847,2749,103
25273,2024,2,2,0,0,100,173600,1980,88
25274,2024,6,3,3,50,50,221358,1696,126
25275,2024,6,6,0,0,100,82033,1353,67
25276,2024,3,3,0,0,100,122950,861,139
25278,2024,8,6,2,25,75,178151,1615,119
25279,2024,2,2,0,0,100,129750,1254,85
25280,2024,3,2,1,33,67,167000,1151,135
25281,2024,1,0,1,100,0,82100,1066,77
25283,2024,1,1,0,0,100,75000,938,80
25284,2024,40,19,21,52,48,99707,1282,75
25285,2024,10,6,4,40,60,269394,2987,95
25286,2024,3,2,1,33,67,242370,2730,86
25287,2024,12,10,2,17,83,317450,2762,119
25288,2024,3,1,2,67,33,321233,3711,93
25289,2024,1,1,0,0,100,317500,2062,154
25293,2024,9,4,5,56,44,314622,3331,96
25295,2024,7,4,3,43,57,306928,3145,99
25296,2024,6,6,0,0,100,311583,2618,127
25298,2024,1,1,0,0,100,120000,811,148
25299,2024,1,1,0,0,100,133000,1023,130
25300,2024,2,2,0,0,100,232950,1394,179
25301,2024,5,3,2,40,60,187200,1731,123
25304,2024,41,31,10,24,76,116570,1228,94
25305,2024,5,4,1,20,80,197390,2219,92
25306,2024,2,2,0,0,100,152900,1256,108
25307,2024,28,10,18,64,36,197781,3345,61
25308,2024,5,4,1,20,80,423600,3671,119
25309,2024,15,8,7,47,53,295824,2965,106
25310,2024,2,2,0,0,100,72200,792,82
25311,2024,2,2,0,0,100,148150,1254,106
25312,2024,1,1,0,0,100,49000,1750,28
25313,2024,2,2,0,0,100,145000,1369,124
25314,2024,2,2,0,0,100,132500,862,158
25315,2024,21,16,5,24,76,95494,1205,83
25316,2024,1,1,0,0,100,290000,2231,130
25317,2024,3,3,0,0,100,202667,1952,106
25318,2024,27,8,19,70,30,202777,3410,63
25320,2024,24,6,18,75,25,252304,3481,76
25321,2024,68,30,38,56,44,237280,3048,78
25322,2024,1,1,0,0,100,241300,1641,147
25323,2024,3,3,0,0,100,79000,680,119
25324,2024,1,1,0,0,100,166000,1644,101
25325,2024,1,1,0,0,100,90000,1525,59
25326,2024,3,3,0,0,100,216933,1508,145
25327,2024,2,2,0,0,100,150950,1688,85
25328,2024,5,5,0,0,100,185374,1759,111
25330,2024,3,3,0,0,100,110967,1087,103
25331,2024,3,3,0,0,100,271250,2485,103
25332,2024,6,5,1,17,83,239917,2074,120
25333,2024,1,1,0,0,100,160000,1882,85
25334,2024,15,11,4,27,73,210903,2033,112
25336,2024,5,5,0,0,100,144920,1679,90
25339,2024,3,1,2,67,33,148312,1866,89
25340,2024,4,4,0,0,100,84375,1944,54
25341,2024,2,2,0,0,100,124650,1457,74
25343,2024,2,2,0,0,100,353606,1072,239
25345,2024,11,11,0,0,100,176109,1464,120
25347,2024,3,3,0,0,100,255394,2743,96
25348,2024,12,5,7,58,42,304025,3525,95
25349,2024,3,3,0,0,100,270097,2989,91
25350,2024,7,7,0,0,100,127571,1125,114
25351,2024,2,1,1,50,50,243500,2776,94
25354,2024,3,3,0,0,100,229950,1798,121
25356,2024,52,24,28,54,46,203591,2293,90
25357,2024,2,2,0,0,100,327500,3320,102
25359,2024,2,2,0,0,100,154500,1137,136
25361,2024,26,8,18,69,31,200696,3756,58
25362,2024,2,1,1,50,50,209000,2534,82
25364,2024,10,9,1,10,90,214723,2381,91
25365,2024,3,3,0,0,100,163033,1449,107
25367,2024,58,32,26,45,55,88084,1165,76
25368,2024,5,4,1,20,80,194124,1836,108
25369,2024,1,1,0,0,100,150000,1744,86
25370,2024,11,10,1,9,91,121414,1259,95
25371,2024,2,2,0,0,100,220750,1288,187
25372,2024,4,4,0,0,100,118725,1144,106
25374,2024,3,3,0,0,100,178480,1988,90
25375,2024,2,2,0,0,100,206000,1890,112
25376,2024,2,1,1,50,50,189000,1681,106
25377,2024,4,3,1,25,75,151810,1778,75
25378,2024,5,5,0,0,100,124835,1421,76
25379,2024,2,2,0,0,100,185258,1446,129
25380,2024,85,27,58,68,32,161003,3821,43
25381,2024,25,17,8,32,68,245705,2554,98
25382,2024,1,1,0,0,100,202500,1220,166
25383,2024,1,1,0,0,100,534060,3683,145
25385,2024,1,1,0,0,100,148900,897,166
25387,2024,4,4,0,0,100,148125,907,163
25388,2024,302,69,233,77,23,97483,1179,78
25389,2024,1,0,1,100,0,240000,2286,105
25390,2024,3,2,1,33,67,207222,3193,73
25391,2024,2,2,0,0,100,207698,1590,125
25392,2024,1,1,0,0,100,361300,2377,152
25393,2024,6,6,0,0,100,101067,1251,82
25394,2024,12,12,0,0,100,165837,1814,94
25395,2024,11,8,3,27,73,291507,2951,99
25397,2024,16,10,6,38,62,203676,2203,97
25400,2024,7,7,0,0,100,172400,1541,124
25401,2024,1,1,0,0,100,65000,419,155
25402,2024,1,1,0,0,100,116100,1548,75
25403,2024,19,7,12,63,37,246481,3363,79
25405,2024,8,7,1,12,88,621175,5296,120
25406,2024,5,5,0,0,100,292144,2336,126
25410,2024,8,6,2,25,75,219546,2240,87
25411,2024,96,27,69,72,28,217993,2829,80
25413,2024,24,8,16,67,33,209999,2675,83
25414,2024,1,1,0,0,100,90000,1125,80
25415,2024,3,3,0,0,100,229767,1896,120
25416,2024,1,1,0,0,100,35000,565,62
25417,2024,8,8,0,0,100,216956,1976,110
25418,2024,8,4,4,50,50,222873,2797,84
25419,2024,2,2,0,0,100,83600,1004,98
25424,2024,17,15,2,12,88,231167,1878,125
25425,2024,2,2,0,0,100,308114,3640,95
25426,2024,4,4,0,0,100,119900,1232,89
25427,2024,5,3,2,40,60,163410,1591,114
25428,2024,10,9,1,10,90,150358,1676,88
25429,2024,10,9,1,10,90,192200,1843,104
25431,2024,1,1,0,0,100,105000,1129,93
25432,2024,21,12,9,43,57,235471,2564,100
25434,2024,72,49,23,32,68,157148,1927,81
25438,2024,9,9,0,0,100,210536,1959,113
25439,2024,2,2,0,0,100,222350,2040,112
25440,2024,5,4,1,20,80,227709,1917,124
25442,2024,9,4,5,56,44,280939,2587,107
25444,2024,1,1,0,0,100,276980,1194,232
25446,2024,2,2,0,0,100,116500,1561,69
25447,2024,2,2,0,0,100,238900,1920,116
25448,2024,14,12,2,14,86,207010,2254,93
25449,2024,2,2,0,0,100,110000,974,148
25450,2024,1,1,0,0,100,40000,333,120
25451,2024,3,3,0,0,100,243000,2927,88
25452,2024,6,5,1,17,83,182617,1678,104
25453,2024,11,11,0,0,100,249245,1877,136
25454,2024,16,8,8,50,50,217967,2332,93
25456,2024,4,4,0,0,100,338262,2362,145
25457,2024,1,1,0,0,100,244500,2810,87
25458,2024,2,2,0,0,100,155500,1407,116
25459,2024,1,0,1,100,0,122000,1937,63
25460,2024,3,3,0,0,100,145667,1433,105
25462,2024,289,44,245,85,15,193827,2675,76
25463,2024,33,17,16,48,52,121375,1372,86
25464,2024,1,1,0,0,100,273500,3335,82
25465,2024,1,1,0,0,100,52500,700,75
25466,2024,5,5,0,0,100,225140,2231,110
25467,2024,15,12,3,20,80,235351,2477,98
25468,2024,6,3,3,50,50,203300,1800,116
25469,2024,4,4,0,0,100,116350,1448,80
25473,2024,5,5,0,0,100,167400,2030,81
25474,2024,1,1,0,0,100,115400,1649,70
25475,2024,5,4,1,20,80,182986,1942,99
25478,2024,1,1,0,0,100,130000,963,135
25479,2024,1,1,0,0,100,140600,1715,82
25481,2024,3,3,0,0,100,157900,1367,111
25482,2024,6,6,0,0,100,189538,1484,126
25485,2024,5,5,0,0,100,153100,1449,104
25486,2024,2,1,1,50,50,296042,2708,106
25489,2024,3,3,0,0,100,202146,2185,99
25490,2024,3,2,1,33,67,164665,1815,93
25492,2024,1,1,0,0,100,200000,1481,135
25493,2024,12,6,6,50,50,209904,2128,99
25494,2024,13,6,7,54,46,268294,2706,101
25495,2024,17,10,7,41,59,161031,1953,82
25496,2024,1,1,0,0,100,38500,1242,31
25497,2024,7,7,0,0,100,176150,1925,94
25498,2024,1,1,0,0,100,49800,356,140
25499,2024,1,1,0,0,100,180000,1978,91
25502,2024,3,3,0,0,100,183483,2266,82
25503,2024,1,1,0,0,100,33620,600,56
25504,2024,1,1,0,0,100,242600,4043,60
25505,2024,13,13,0,0,100,118260,1078,114
25506,2024,1,1,0,0,100,114000,350,326
25507,2024,2,2,0,0,100,162625,1642,94
25508,2024,8,7,1,12,88,169132,1931,94
25510,2024,1,1,0,0,100,144400,2674,54
25511,2024,3,3,0,0,100,172900,1791,93
25512,2024,43,27,16,37,63,235580,2463,96
25513,2024,1,1,0,0,100,735450,3871,190
25514,2024,1,0,1,100,0,70000,946,74
25515,2024,6,4,2,33,67,288024,2051,145
25516,2024,1,1,0,0,100,85000,977,87
25518,2024,2,2,0,0,100,217110,2126,102
25519,2024,8,6,2,25,75,164088,1901,81
25520,2024,3,2,1,33,67,103333,1460,72
25521,2024,2,2,0,0,100,185300,1970,94
25522,2024,2,2,0,0,100,307532,3300,106
25523,2024,6,6,0,0,100,190328,1716,106
25524,2024,7,6,1,14,86,100026,882,120
25525,2024,6,1,5,83,17,346940,3990,82
25526,2024,19,9,10,53,47,99946,1344,78
25527,2024,39,23,16,41,59,173336,1867,94
25528,2024,2,2,0,0,100,168060,1349,122
25529,2024,9,8,1,11,89,160982,1716,97
25532,2024,28,17,11,39,61,222584,2250,103
25534,2024,2,2,0,0,100,296500,2308,129
25535,2024,1,1,0,0,100,248000,1922,129
25536,2024,1,1,0,0,100,165000,1100,150
25537,2024,2,2,0,0,100,293250,1992,144
25538,2024,1,1,0,0,100,217500,2014,108
25539,2024,62,41,21,34,66,137780,1475,91
25540,2024,5,5,0,0,100,134340,1396,94
25542,2024,15,13,2,13,87,258832,2602,105
25546,2024,1,1,0,0,100,218830,1368,160
25547,2024,30,8,22,73,27,110484,1623,84
25548,2024,2,2,0,0,100,126500,1252,100
25550,2024,1,1,0,0,100,271500,3157,86
25551,2024,2,2,0,0,100,92500,2024,38
25552,2024,1,1,0,0,100,60000,571,105
25553,2024,3,3,0,0,100,139467,1042,136
25555,2024,11,9,2,18,82,174684,1783,97
25558,2024,7,6,1,14,86,205865,1772,120
25560,2024,34,31,3,9,91,250188,2454,108
25561,2024,2,1,1,50,50,57225,2046,28
25562,2024,2,2,0,0,100,242500,2421,100
25563,2024,2,2,0,0,100,210525,1672,115
25564,2024,2,1,1,50,50,171100,1674,102
25565,2024,2,1,1,50,50,375300,3443,102
25566,2024,2,2,0,0,100,176248,1884,93
25567,2024,1,1,0,0,100,132775,1006,132
25569,2024,2,2,0,0,100,177685,2585,76
25570,2024,1,1,0,0,100,166500,1936,86
25571,2024,7,4,3,43,57,144479,1893,78
25574,2024,3,3,0,0,100,105946,1065,101
25575,2024,7,7,0,0,100,207850,1660,122
25578,2024,55,25,30,55,45,211284,2527,85
25580,2024,103,61,42,41,59,110071,1201,90
25584,2024,3,3,0,0,100,105540,1849,73
25586,2024,6,5,1,17,83,148083,1646,90
25588,2024,1,1,0,0,100,322300,3581,90
25589,2024,1,1,0,0,100,86500,1081,80
25590,2024,2,2,0,0,100,65000,767,84
25591,2024,2,2,0,0,100,233150,1776,120
25592,2024,7,7,0,0,100,390143,3001,129
25594,2024,3,3,0,0,100,196363,2304,87
25595,2024,1,1,0,0,100,127450,1274,100
25597,2024,2,2,0,0,100,57500,506,114
25598,2024,2,2,0,0,100,148400,1452,102
25599,2024,1,1,0,0,100,214950,1693,127
25600,2024,1,1,0,0,100,285200,2716,105
25601,2024,20,11,9,45,55,203113,2039,100
25602,2024,1,1,0,0,100,70000,707,99
25604,2024,3,3,0,0,100,132917,1591,89
25605,2024,7,6,1,14,86,170868,1703,110
25607,2024,1,1,0,0,100,85000,425,200
25608,2024,2,2,0,0,100,188500,1834,103
25609,2024,8,6,2,25,75,234182,3763,78
25611,2024,7,5,2,29,71,244106,2418,105
25612,2024,8,7,1,12,88,156006,1835,103
25613,2024,1,1,0,0,100,45000,865,52
25614,2024,24,15,9,38,62,119743,1489,79
25615,2024,4,4,0,0,100,202668,1256,162
25616,2024,1,1,0,0,100,233000,1629,143
25617,2024,3,3,0,0,100,231900,2284,100
25618,2024,2,2,0,0,100,131500,1412,92
25619,2024,6,4,2,33,67,198987,3031,84
25621,2024,1,1,0,0,100,362220,2236,162
25622,2024,1,1,0,0,100,223700,3064,73
25623,2024,1,1,0,0,100,235270,2905,81
25624,2024,1,1,0,0,100,230000,1278,180
25626,2024,1,1,0,0,100,157500,1712,92
25627,2024,3,3,0,0,100,134583,1814,79
25631,2024,4,4,0,0,100,253099,2907,91
25632,2024,21,15,6,29,71,142036,1660,91
25633,2024,13,12,1,8,92,160245,1626,103
25634,2024,5,2,3,60,40,257999,2648,101
25635,2024,2,2,0,0,100,142940,1878,88
26001,2024,5,5,0,0,100,344600,3559,107
26002,2024,19,19,0,0,100,205072,2225,101
26003,2024,1,1,0,0,100,80000,625,128
26004,2024,22,21,1,5,95,327681,2498,127
26005,2024,23,22,1,4,96,285983,2592,113
26006,2024,18,16,2,11,89,295152,2391,127
26007,2024,2,2,0,0,100,424500,2858,150
26008,2024,13,13,0,0,100,205781,2375,92
26009,2024,8,8,0,0,100,204780,2410,90
26010,2024,29,27,2,7,93,218117,2148,104
26011,2024,25,24,1,4,96,237880,2548,93
26013,2024,1,1,0,0,100,127000,2352,54
26014,2024,3,3,0,0,100,165583,1666,106
26016,2024,2,2,0,0,100,312500,3350,88
26017,2024,1,1,0,0,100,180000,1748,103
26019,2024,2,2,0,0,100,180415,1242,118
26022,2024,1,1,0,0,100,130000,1444,90
26023,2024,16,16,0,0,100,267605,2540,105
26024,2024,3,3,0,0,100,259954,2269,113
26025,2024,2,2,0,0,100,153750,2108,78
26026,2024,1,1,0,0,100,280870,3053,92
26028,2024,1,1,0,0,100,390000,2868,136
26031,2024,10,9,1,10,90,299054,2317,128
26032,2024,1,1,0,0,100,180200,2468,73
26033,2024,6,6,0,0,100,367005,2780,130
26034,2024,4,4,0,0,100,327036,2936,111
26035,2024,3,3,0,0,100,117933,1920,62
26037,2024,38,38,0,0,100,295034,2898,108
26038,2024,8,8,0,0,100,231658,2344,102
26039,2024,4,3,1,25,75,287220,2799,103
26040,2024,1,1,0,0,100,230000,2614,88
26041,2024,11,10,1,9,91,214076,2066,103
26042,2024,20,20,0,0,100,299157,2652,111
26043,2024,1,1,0,0,100,553625,3219,172
26045,2024,18,15,3,17,83,294997,2734,101
26047,2024,2,2,0,0,100,78500,1194,79
26049,2024,6,4,2,33,67,151233,2009,78
26051,2024,2,2,0,0,100,211075,1164,198
26052,2024,2,2,0,0,100,351930,2474,144
26054,2024,15,14,1,7,93,336966,3209,103
26055,2024,4,4,0,0,100,172426,1525,96
26056,2024,5,5,0,0,100,142225,1602,89
26057,2024,113,52,61,54,46,176442,2197,81
26058,2024,288,97,191,66,34,170017,2201,78
26059,2024,3,3,0,0,100,91500,911,120
26060,2024,1,1,0,0,100,105000,1382,76
26061,2024,6,6,0,0,100,184955,1815,100
26062,2024,3,3,0,0,100,112500,1750,73
26063,2024,34,31,3,9,91,216198,2658,82
26064,2024,62,51,11,18,82,267354,2871,96
26065,2024,6,6,0,0,100,372567,3040,118
26066,2024,1,1,0,0,100,185000,2256,82
26068,2024,2,2,0,0,100,357500,2797,128
26069,2024,1,1,0,0,100,255000,3493,73
26070,2024,4,4,0,0,100,329075,3384,98
26071,2024,7,7,0,0,100,191301,2055,94
26072,2024,7,7,0,0,100,259407,2611,101
26073,2024,2,2,0,0,100,312065,2902,107
26074,2024,9,6,3,33,67,164826,2164,82
26075,2024,1,1,0,0,100,45000,600,75
26077,2024,8,7,1,12,88,247956,2626,93
26078,2024,11,11,0,0,100,231285,2548,91
26079,2024,11,11,0,0,100,344291,3156,113
26081,2024,2,2,0,0,100,325835,3160,86
26082,2024,2,2,0,0,100,270000,3597,76
26083,2024,9,9,0,0,100,205746,2274,89
26084,2024,28,26,2,7,93,263348,2785,104
26085,2024,24,21,3,12,88,246938,2353,103
26086,2024,13,8,5,38,62,107034,1176,99
26087,2024,15,15,0,0,100,226941,1976,121
26088,2024,58,57,1,2,98,265367,2667,101
26091,2024,3,3,0,0,100,172592,1648,93
26092,2024,5,3,2,40,60,162175,1360,126
26093,2024,5,5,0,0,100,576091,3135,165
26094,2024,7,7,0,0,100,243279,1987,117
26095,2024,5,4,1,20,80,289400,2728,103
26096,2024,22,21,1,5,95,241600,2449,94
26097,2024,2,2,0,0,100,316500,3792,86
26098,2024,1,1,0,0,100,182500,2173,84
26099,2024,2,2,0,0,100,835000,4344,208
26100,2024,3,3,0,0,100,267767,2688,103
26101,2024,2,2,0,0,100,806350,3824,210
26102,2024,1,1,0,0,100,142500,1307,109
26103,2024,9,9,0,0,100,285064,2807,99
26104,2024,1,1,0,0,100,370000,7708,48
26105,2024,4,4,0,0,100,61591,875,68
26106,2024,11,11,0,0,100,221691,2568,90
26107,2024,7,6,1,14,86,256113,2507,100
26108,2024,92,45,47,51,49,172195,2152,79
26110,2024,6,6,0,0,100,344667,3132,120
26111,2024,3,3,0,0,100,433527,3644,123
26112,2024,2,2,0,0,100,323500,2892,106
26113,2024,67,39,28,42,58,220049,2504,89
26114,2024,51,38,13,25,75,255680,2743,93
26115,2024,5,5,0,0,100,305048,2293,137
26116,2024,44,33,11,25,75,191679,2189,92
26118,2024,8,7,1,12,88,217499,1894,124
26119,2024,5,4,1,20,80,213722,2334,89
26121,2024,11,11,0,0,100,264058,2442,103
26123,2024,2,2,0,0,100,195750,2409,88
26124,2024,48,45,3,6,94,315052,2874,108
26125,2024,8,8,0,0,100,274494,2322,126
26127,2024,3,3,0,0,100,417952,2653,143
26129,2024,11,11,0,0,100,225495,2236,103
26131,2024,2,2,0,0,100,132162,1954,70
26133,2024,1,1,0,0,100,210000,3043,69
26135,2024,1,1,0,0,100,240000,2526,95
26136,2024,1,1,0,0,100,25000,758,33
26137,2024,1,1,0,0,100,160000,2000,80
26138,2024,17,15,2,12,88,260361,2511,105
26139,2024,18,17,1,6,94,331160,2729,120
26140,2024,7,7,0,0,100,370934,2757,133
26141,2024,1,1,0,0,100,270000,4737,57
26142,2024,2,2,0,0,100,209000,1902,118
26143,2024,18,13,5,28,72,135884,1505,94
26144,2024,16,15,1,6,94,279760,2627,114
26145,2024,4,4,0,0,100,284393,1780,156
26146,2024,17,16,1,6,94,500465,3389,140
26148,2024,8,8,0,0,100,215838,2012,103
26149,2024,9,7,2,22,78,191706,2220,91
26152,2024,2,2,0,0,100,175000,2857,60
26153,2024,1,1,0,0,100,87000,1426,61
26154,2024,6,6,0,0,100,90843,1183,79
26155,2024,6,6,0,0,100,189525,1844,119
26156,2024,3,3,0,0,100,206261,2120,97
26157,2024,7,6,1,14,86,177631,3000,78
26159,2024,2,2,0,0,100,260000,3103,84
26160,2024,12,11,1,8,92,199775,1873,118
26161,2024,1,1,0,0,100,150000,2381,63
26162,2024,8,7,1,12,88,175323,1413,119
26164,2024,1,1,0,0,100,200000,3846,52
26165,2024,98,74,24,24,76,184452,2100,87
26166,2024,46,34,12,26,74,190173,1908,98
26167,2024,11,10,1,9,91,212227,2937,86
26168,2024,5,4,1,20,80,169466,1979,88
26169,2024,9,9,0,0,100,235165,2076,141
26170,2024,34,32,2,6,94,290887,2635,114
26171,2024,2,2,0,0,100,173375,2052,80
26172,2024,5,5,0,0,100,217700,1948,113
26173,2024,5,5,0,0,100,295980,2232,144
26174,2024,5,5,0,0,100,266940,2532,106
26175,2024,1,1,0,0,100,386000,5514,70
26176,2024,10,10,0,0,100,361320,3125,121
26177,2024,8,8,0,0,100,233375,2262,106
26178,2024,7,7,0,0,100,245357,2467,126
26179,2024,21,21,0,0,100,301629,2351,126
26181,2024,1,1,0,0,100,280000,1879,149
26182,2024,20,19,1,5,95,260985,2784,98
26183,2024,9,9,0,0,100,321328,3240,101
26185,2024,3,3,0,0,100,429000,3679,115
26186,2024,1,1,0,0,100,148270,1257,118
26188,2024,17,14,3,18,82,187993,2262,80
26189,2024,1,1,0,0,100,214900,2528,85
26191,2024,23,18,5,22,78,314667,2786,116
26192,2024,1,1,0,0,100,245000,1885,130
26193,2024,19,3,16,84,16,108504,2337,45
26194,2024,7,7,0,0,100,150534,1740,87
26195,2024,4,4,0,0,100,289375,2446,109
26196,2024,10,9,1,10,90,391297,3134,123
26197,2024,31,28,3,10,90,335048,3085,107
26198,2024,489,212,277,57,43,183787,2133,84
26199,2024,1,1,0,0,100,60000,1071,56
26200,2024,2,2,0,0,100,67500,1099,62
26201,2024,1,1,0,0,100,253802,6043,42
26202,2024,2,2,0,0,100,382975,3254,116
26203,2024,1,1,0,0,100,310600,3016,103
26204,2024,1,1,0,0,100,165000,1650,100
26205,2024,1,1,0,0,100,366000,2672,137
26206,2024,22,15,7,32,68,260083,2525,99
26207,2024,4,4,0,0,100,259728,2447,108
26208,2024,17,17,0,0,100,371054,3326,113
26209,2024,1,1,0,0,100,165000,3300,50
26210,2024,9,8,1,11,89,151511,1785,96
26211,2024,15,14,1,7,93,311534,2949,105
26212,2024,7,5,2,29,71,277743,2577,109
26213,2024,7,7,0,0,100,177540,1974,91
26215,2024,5,5,0,0,100,225000,2344,128
26216,2024,8,8,0,0,100,179312,2198,89
26217,2024,3,3,0,0,100,382843,2355,168
26218,2024,43,30,13,30,70,253175,2636,99
26220,2024,86,35,51,59,41,196295,2778,72
26221,2024,4,4,0,0,100,108900,1552,85
26223,2024,3,3,0,0,100,205100,3770,72
26224,2024,1,1,0,0,100,337500,1630,207
26225,2024,3,3,0,0,100,171900,1625,103
26226,2024,3,3,0,0,100,313667,2911,109
26229,2024,1,1,0,0,100,270000,2250,120
26231,2024,27,21,6,22,78,277810,2690,102
26232,2024,6,6,0,0,100,247316,2300,117
26233,2024,1,1,0,0,100,170000,1848,92
26234,2024,10,9,1,10,90,269915,2730,107
26235,2024,124,82,42,34,66,173314,1988,89
26236,2024,2,2,0,0,100,172500,2677,64
26238,2024,2,2,0,0,100,92250,1434,70
26239,2024,1,1,0,0,100,635000,4233,150
26240,2024,3,3,0,0,100,144523,2472,65
26241,2024,1,1,0,0,100,333500,3403,98
26243,2024,10,7,3,30,70,257307,3116,86
26244,2024,2,2,0,0,100,365305,3162,118
26247,2024,4,4,0,0,100,281500,2199,121
26248,2024,3,3,0,0,100,222133,2453,89
26249,2024,10,9,1,10,90,347742,2496,139
26250,2024,26,24,2,8,92,275016,2617,112
26251,2024,7,7,0,0,100,191464,2145,89
26252,2024,90,50,40,44,56,197908,2228,88
26253,2024,1,1,0,0,100,135000,1985,68
26256,2024,2,2,0,0,100,370000,3696,85
26257,2024,1,1,0,0,100,180000,1915,94
26258,2024,12,12,0,0,100,314852,2460,122
26261,2024,11,10,1,9,91,260985,2544,99
26262,2024,1,1,0,0,100,195000,2378,82
26263,2024,1,0,1,100,0,90500,3481,26
26264,2024,2,2,0,0,100,88500,1406,62
26268,2024,2,1,1,50,50,804950,4806,135
26271,2024,30,28,2,7,93,253480,2605,97
26272,2024,2,2,0,0,100,215860,2156,101
26273,2024,8,8,0,0,100,352622,2738,124
26275,2024,21,20,1,5,95,320251,3080,101
26276,2024,3,3,0,0,100,314600,3408,93
26277,2024,2,2,0,0,100,203385,2800,72
26278,2024,5,5,0,0,100,229928,3171,72
26279,2024,1,1,0,0,100,95000,1792,53
26281,2024,453,168,285,63,37,149468,1941,78
26282,2024,5,5,0,0,100,281190,3528,82
26284,2024,3,3,0,0,100,312143,2723,117
26285,2024,2,2,0,0,100,620330,3794,144
26287,2024,4,4,0,0,100,436250,3138,136
26288,2024,1,1,0,0,100,277110,4330,64
26289,2024,25,24,1,4,96,195171,2229,93
26290,2024,14,7,7,50,50,136292,2299,57
26291,2024,1,1,0,0,100,240000,5106,47
26292,2024,10,10,0,0,100,247870,3056,80
26293,2024,2,2,0,0,100,298700,2877,118
26294,2024,3,3,0,0,100,283500,2141,126
26295,2024,11,10,1,9,91,192282,1889,106
26298,2024,7,7,0,0,100,244946,2138,117
26300,2024,1,1,0,0,100,81000,736,110
26301,2024,42,34,8,19,81,220051,2361,94
26302,2024,2,2,0,0,100,182500,1906,98
26303,2024,1,1,0,0,100,209200,2324,90
26304,2024,1,1,0,0,100,222920,2623,85
26305,2024,7,6,1,14,86,275879,2498,111
26306,2024,5,3,2,40,60,164290,2264,68
26307,2024,26,16,10,38,62,165077,1965,82
26308,2024,1,1,0,0,100,55000,1375,40
26310,2024,3,3,0,0,100,338303,2566,132
26311,2024,11,11,0,0,100,222957,2522,88
26312,2024,21,15,6,29,71,241886,2516,96
26313,2024,43,40,3,7,93,295402,2779,108
26314,2024,2,2,0,0,100,267500,2904,90
26315,2024,4,3,1,25,75,249375,1718,136
26316,2024,3,3,0,0,100,281867,3540,92
26317,2024,10,10,0,0,100,277215,2763,103
26319,2024,4,4,0,0,100,312044,3557,90
26320,2024,11,5,6,55,45,158325,1817,97
26321,2024,4,4,0,0,100,253906,3050,74
26322,2024,8,5,3,38,62,169858,2132,80
26323,2024,15,14,1,7,93,249857,2424,107
26324,2024,69,51,18,26,74,231204,2521,95
26325,2024,44,38,6,14,86,185345,2045,93
26326,2024,12,12,0,0,100,376577,3284,125
26327,2024,2,2,0,0,100,294750,2800,110
26328,2024,1,1,0,0,100,380000,9500,40
26329,2024,2,2,0,0,100,325000,2837,113
26330,2024,13,13,0,0,100,212990,2246,95
26331,2024,3,3,0,0,100,277563,2229,129
26332,2024,28,27,1,4,96,181077,1914,96
26333,2024,48,23,25,52,48,119918,1479,79
26334,2024,1,1,0,0,100,252890,3328,76
26335,2024,3,3,0,0,100,181783,3137,62
26336,2024,5,5,0,0,100,152897,2919,59
26337,2024,24,19,5,21,79,209631,2140,97
26338,2024,12,11,1,8,92,317572,2158,142
26339,2024,9,8,1,11,89,338506,2943,114
26340,2024,5,4,1,20,80,79700,1035,72
26341,2024,7,7,0,0,100,186907,2066,103
26342,2024,2,2,0,0,100,396118,2766,144
26343,2024,2,2,0,0,100,337500,2750,122
26344,2024,1,1,0,0,100,295765,3607,82
26345,2024,24,23,1,4,96,274924,2701,100
26347,2024,72,33,39,54,46,185674,2248,84
26348,2024,16,16,0,0,100,264513,2621,105
26351,2024,1,1,0,0,100,170000,2429,70
26352,2024,3,3,0,0,100,276595,2179,120
26353,2024,13,10,3,23,77,192869,2171,93
26355,2024,5,5,0,0,100,353000,2937,117
26356,2024,1,1,0,0,100,303000,2780,109
26357,2024,23,20,3,13,87,245840,2512,101
26358,2024,8,8,0,0,100,297712,2198,136
26360,2024,8,7,1,12,88,257798,3139,97
26361,2024,5,4,1,20,80,91200,1953,51
26362,2024,885,199,686,78,22,168141,2264,74
26364,2024,4,3,1,25,75,182489,2501,87
26365,2024,3,3,0,0,100,211167,2625,82
26367,2024,10,10,0,0,100,243270,2492,104
26373,2024,2,2,0,0,100,240000,2464,98
26376,2024,5,5,0,0,100,257224,3055,89
26377,2024,11,11,0,0,100,320810,2767,124
26379,2024,4,4,0,0,100,259262,2492,108
26380,2024,5,5,0,0,100,249157,1957,132
26381,2024,3,3,0,0,100,237100,2528,94
26382,2024,7,7,0,0,100,311971,3226,103
27001,2024,2,2,0,0,100,220500,2208,114
27002,2024,10,10,0,0,100,118301,1385,106
27003,2024,15,15,0,0,100,192667,1839,104
27004,2024,2,2,0,0,100,302930,2468,123
27005,2024,10,10,0,0,100,213383,1917,116
27006,2024,4,4,0,0,100,188275,2430,76
27008,2024,13,13,0,0,100,177548,2038,90
27009,2024,2,2,0,0,100,205100,2081,84
27010,2024,2,2,0,0,100,206310,1806,115
27011,2024,10,10,0,0,100,135516,1487,95
27012,2024,1,1,0,0,100,132000,1610,82
27013,2024,8,8,0,0,100,224118,1806,123
27014,2024,10,10,0,0,100,198585,2066,111
27015,2024,9,9,0,0,100,205624,2232,91
27016,2024,83,56,27,33,67,133881,1782,80
27017,2024,6,6,0,0,100,174833,1798,97
27018,2024,11,11,0,0,100,162245,2010,79
27019,2024,1,1,0,0,100,88000,587,150
27020,2024,18,18,0,0,100,189769,1775,108
27021,2024,7,7,0,0,100,210255,1905,114
27022,2024,36,33,3,8,92,182474,2127,88
27023,2024,8,8,0,0,100,189746,2191,84
27025,2024,8,8,0,0,100,185215,1742,116
27026,2024,4,4,0,0,100,206321,1939,104
27027,2024,2,2,0,0,100,222500,1960,108
27028,2024,6,6,0,0,100,143050,1405,106
27031,2024,10,10,0,0,100,229730,1910,120
27032,2024,16,16,0,0,100,200417,1863,114
27033,2024,4,4,0,0,100,199703,1767,116
27034,2024,6,6,0,0,100,182583,1953,95
27035,2024,5,5,0,0,100,145338,1723,100
27036,2024,4,4,0,0,100,169550,1735,100
27037,2024,10,10,0,0,100,116810,1591,76
27038,2024,3,3,0,0,100,117333,1366,94
27039,2024,3,3,0,0,100,251333,3867,81
27040,2024,9,9,0,0,100,315889,2026,127
27042,2024,1,1,0,0,100,177000,1221,145
27043,2024,10,10,0,0,100,165764,1341,112
27044,2024,15,15,0,0,100,178707,1796,104
27045,2024,12,12,0,0,100,228921,2079,110
27046,2024,2,2,0,0,100,165000,1880,102
27047,2024,3,3,0,0,100,122717,1410,89
27048,2024,3,3,0,0,100,185667,2212,86
27049,2024,67,67,0,0,100,164649,1889,103
27050,2024,7,7,0,0,100,163964,1587,105
27051,2024,27,27,0,0,100,155108,1819,88
27052,2024,5,5,0,0,100,195800,1970,99
27053,2024,3,3,0,0,100,165500,1786,93
27054,2024,6,6,0,0,100,146583,1304,116
27055,2024,3,3,0,0,100,140655,2267,77
27056,2024,126,88,38,30,70,163655,2000,81
27057,2024,4,4,0,0,100,133750,1898,72
27059,2024,4,4,0,0,100,192000,1731,116
27061,2024,2,2,0,0,100,204500,1661,121
27062,2024,13,13,0,0,100,174415,1778,106
27063,2024,4,4,0,0,100,309962,2596,119
27064,2024,9,9,0,0,100,203332,2321,97
27065,2024,81,51,30,37,63,175470,2305,74
27066,2024,5,5,0,0,100,242922,2013,132
27067,2024,12,10,2,17,83,225300,2269,98
27068,2024,3,3,0,0,100,152333,1591,97
27069,2024,7,7,0,0,100,118786,1093,110
27070,2024,15,15,0,0,100,155727,1800,89
27071,2024,2,2,0,0,100,335000,2680,125
27072,2024,5,5,0,0,100,304322,2377,127
27073,2024,13,13,0,0,100,214364,1848,118
27074,2024,1,1,0,0,100,130000,549,237
27075,2024,6,6,0,0,100,92224,996,91
27076,2024,3,3,0,0,100,133000,2252,65
27077,2024,3,3,0,0,100,132333,1628,75
27078,2024,3,3,0,0,100,272117,2019,142
27079,2024,4,4,0,0,100,165500,2113,76
27081,2024,2,2,0,0,100,232500,2824,84
27082,2024,20,20,0,0,100,154557,2140,76
27083,2024,5,5,0,0,100,226084,1952,122
27085,2024,22,22,0,0,100,233986,1862,129
27089,2024,10,10,0,0,100,229082,2109,113
27090,2024,33,33,0,0,100,214461,2089,104
27091,2024,7,7,0,0,100,181711,2106,90
27095,2024,7,7,0,0,100,210286,1679,123
27096,2024,6,6,0,0,100,137558,2040,72
27097,2024,3,3,0,0,100,220000,2258,99
27099,2024,4,4,0,0,100,218000,1970,116
27100,2024,11,8,3,27,73,229449,2293,99
27101,2024,3,3,0,0,100,286667,2540,119
27102,2024,9,8,1,11,89,230728,2652,95
27103,2024,24,24,0,0,100,221308,2310,102
27104,2024,10,10,0,0,100,229365,2033,113
27105,2024,35,31,4,11,89,197983,2178,92
27106,2024,5,5,0,0,100,184500,2073,91
27107,2024,16,16,0,0,100,175706,1887,92
27108,2024,16,16,0,0,100,149017,1936,80
27109,2024,3,3,0,0,100,211700,2244,95
27110,2024,6,6,0,0,100,170529,1497,114
27111,2024,2,2,0,0,100,168000,2303,75
27112,2024,59,57,2,3,97,124378,1466,92
27113,2024,2,2,0,0,100,138000,1098,156
27114,2024,10,10,0,0,100,238150,2023,120
27115,2024,2,2,0,0,100,162000,1888,90
27116,2024,50,48,2,4,96,140205,1552,88
27117,2024,12,12,0,0,100,123833,1201,112
27118,2024,9,9,0,0,100,185683,1601,118
27119,2024,21,21,0,0,100,225983,2245,105
27120,2024,4,4,0,0,100,137000,2006,67
27123,2024,5,4,1,20,80,333300,2547,136
27124,2024,9,9,0,0,100,368733,2718,161
27125,2024,5,5,0,0,100,155630,1735,91
27126,2024,12,12,0,0,100,174463,1618,110
27127,2024,5,5,0,0,100,171700,1987,85
27129,2024,1,1,0,0,100,90000,545,165
27130,2024,4,4,0,0,100,132529,1394,94
27132,2024,7,7,0,0,100,192893,1904,101
27133,2024,10,10,0,0,100,281570,2481,129
27134,2024,2,2,0,0,100,153750,1603,106
27135,2024,6,6,0,0,100,148633,1382,106
27136,2024,1,1,0,0,100,330000,2538,130
27137,2024,5,5,0,0,100,122516,1103,111
27138,2024,6,6,0,0,100,162650,2149,79
27139,2024,1,1,0,0,100,155000,1938,80
27140,2024,4,4,0,0,100,209425,1959,100
27141,2024,1,1,0,0,100,150000,815,184
27142,2024,3,3,0,0,100,231000,1889,127
27144,2024,6,6,0,0,100,174150,2164,84
27146,2024,9,9,0,0,100,248178,2298,105
27147,2024,10,10,0,0,100,238117,2368,109
27148,2024,4,4,0,0,100,108750,1276,85
27149,2024,2,2,0,0,100,267500,1878,130
27151,2024,13,12,1,8,92,152116,1822,93
27152,2024,4,4,0,0,100,167000,2082,78
27153,2024,4,4,0,0,100,162515,1996,85
27154,2024,6,6,0,0,100,227167,2418,91
27155,2024,1,1,0,0,100,95280,1562,61
27156,2024,6,6,0,0,100,108583,1479,72
27157,2024,15,15,0,0,100,167130,1764,95
27158,2024,12,12,0,0,100,217177,2020,113
27161,2024,9,9,0,0,100,162511,1816,94
27162,2024,2,2,0,0,100,139900,1666,84
27163,2024,1,1,0,0,100,80000,1429,56
27164,2024,4,4,0,0,100,184871,1676,112
27165,2024,67,60,7,10,90,139202,1800,82
27167,2024,8,8,0,0,100,187208,1926,98
27168,2024,2,2,0,0,100,272000,1420,198
27169,2024,15,15,0,0,100,285011,2667,112
27170,2024,20,18,2,10,90,128162,1813,74
27171,2024,4,4,0,0,100,250000,1944,130
27174,2024,18,18,0,0,100,188590,2176,90
27177,2024,4,4,0,0,100,180000,1900,89
27179,2024,4,4,0,0,100,173125,1958,88
27180,2024,13,13,0,0,100,224907,2256,105
27181,2024,7,7,0,0,100,195700,2163,92
27183,2024,22,21,1,5,95,218628,2705,97
27184,2024,2,2,0,0,100,196500,1918,100
27185,2024,4,4,0,0,100,189000,2231,81
27187,2024,5,5,0,0,100,168800,2032,105
27188,2024,17,17,0,0,100,195609,1942,101
27189,2024,2,2,0,0,100,218000,1814,123
27190,2024,3,3,0,0,100,269733,3021,96
27191,2024,18,18,0,0,100,225425,2146,105
27192,2024,4,4,0,0,100,201500,2300,91
27193,2024,13,13,0,0,100,187036,2228,83
27194,2024,4,4,0,0,100,169875,1356,128
27196,2024,6,6,0,0,100,202123,1734,111
27198,2024,61,61,0,0,100,159392,1780,97
27199,2024,2,2,0,0,100,188750,2194,86
27200,2024,2,2,0,0,100,149000,2274,75
27201,2024,2,2,0,0,100,200050,1616,126
27202,2024,7,7,0,0,100,193572,1887,107
27203,2024,6,6,0,0,100,232833,2222,103
27204,2024,2,2,0,0,100,137700,2522,75
27205,2024,5,5,0,0,100,207650,1762,119
27206,2024,6,6,0,0,100,174415,1592,110
27207,2024,6,6,0,0,100,198750,2269,103
27208,2024,2,2,0,0,100,69750,916,75
27209,2024,7,7,0,0,100,142771,1902,71
27210,2024,7,7,0,0,100,168371,1636,105
27212,2024,3,3,0,0,100,183667,1755,105
27213,2024,50,50,0,0,100,221404,2136,108
27214,2024,6,6,0,0,100,223450,2137,112
27215,2024,3,3,0,0,100,363000,2047,169
27216,2024,4,4,0,0,100,155650,1847,100
27217,2024,9,9,0,0,100,109967,1393,78
27218,2024,17,17,0,0,100,180221,1891,96
27219,2024,8,8,0,0,100,215784,1858,115
27220,2024,5,3,2,40,60,220130,1676,155
27222,2024,1,1,0,0,100,120000,3333,36
27224,2024,3,3,0,0,100,208617,2065,110
27226,2024,47,43,4,9,91,164940,1957,92
27227,2024,6,6,0,0,100,232667,2369,98
27228,2024,3,3,0,0,100,252367,2105,130
27229,2024,570,227,343,60,40,135779,1877,71
27230,2024,40,33,7,18,82,190098,2303,90
27231,2024,4,4,0,0,100,319950,2488,138
27232,2024,3,3,0,0,100,183667,1475,124
27233,2024,11,11,0,0,100,204845,2034,110
27234,2024,3,3,0,0,100,139510,1765,81
27235,2024,1,1,0,0,100,175000,1989,88
27237,2024,3,3,0,0,100,187033,2017,104
27238,2024,10,10,0,0,100,203120,1897,108
27239,2024,4,4,0,0,100,195500,1916,114
27240,2024,4,4,0,0,100,199750,1520,140
27241,2024,2,2,0,0,100,112250,1424,76
27242,2024,20,20,0,0,100,136870,1670,84
27243,2024,13,13,0,0,100,211505,2760,78
27245,2024,6,6,0,0,100,239812,2421,97
27246,2024,28,27,1,4,96,134509,1600,85
27247,2024,6,6,0,0,100,136000,1393,100
27248,2024,2,2,0,0,100,114950,1546,72
27249,2024,15,15,0,0,100,193900,2258,92
27251,2024,6,6,0,0,100,156530,2068,78
27252,2024,4,4,0,0,100,347037,2656,123
27254,2024,13,13,0,0,100,319335,2277,143
27256,2024,4,4,0,0,100,130375,1699,71
27258,2024,1,1,0,0,100,205000,2847,72
27259,2024,2,2,0,0,100,233000,2286,102
27260,2024,12,12,0,0,100,235988,2155,113
27261,2024,3,3,0,0,100,112667,1548,82
27263,2024,9,9,0,0,100,223722,1992,123
27266,2024,2,2,0,0,100,174500,2072,84
27267,2024,5,5,0,0,100,143433,1872,79
27269,2024,2,2,0,0,100,129750,1132,116
27271,2024,5,5,0,0,100,209000,1862,128
27273,2024,5,5,0,0,100,230400,2169,109
27275,2024,70,28,42,60,40,126711,1838,69
27276,2024,3,3,0,0,100,125222,1172,124
27277,2024,2,2,0,0,100,150500,1863,78
27278,2024,27,27,0,0,100,204746,2049,103
27279,2024,35,30,5,14,86,190795,2256,85
27280,2024,6,6,0,0,100,213071,2301,96
27281,2024,1,1,0,0,100,132000,1467,90
27282,2024,3,3,0,0,100,166167,1870,91
27284,2024,104,72,32,31,69,199921,2529,86
27285,2024,5,5,0,0,100,522166,3531,142
27286,2024,10,10,0,0,100,182575,2271,91
27287,2024,8,8,0,0,100,206344,2094,115
27288,2024,3,3,0,0,100,164333,1581,105
27289,2024,1,1,0,0,100,77000,1242,62
27290,2024,8,8,0,0,100,156267,1515,99
27294,2024,12,12,0,0,100,231562,1852,127
27295,2024,3,3,0,0,100,213000,2676,81
27298,2024,2,2,0,0,100,189250,1776,109
27299,2024,49,34,15,31,69,139130,1903,74
27300,2024,12,12,0,0,100,117642,1536,73
27301,2024,20,20,0,0,100,204542,2150,103
27302,2024,17,17,0,0,100,165500,1838,90
27304,2024,1,1,0,0,100,300000,3614,83
27306,2024,22,22,0,0,100,207609,2231,94
27307,2024,5,5,0,0,100,201200,1877,107
27309,2024,7,7,0,0,100,248514,2878,95
27310,2024,10,10,0,0,100,166719,1813,96
27311,2024,10,10,0,0,100,194030,1930,99
27312,2024,3,3,0,0,100,368333,3347,160
27313,2024,8,8,0,0,100,221775,1951,119
27315,2024,1,1,0,0,100,198890,2235,89
27316,2024,14,14,0,0,100,181013,1845,99
27317,2024,3,3,0,0,100,192250,2453,90
27318,2024,1,1,0,0,100,215000,1748,123
27320,2024,1,1,0,0,100,165000,1571,105
27322,2024,10,10,0,0,100,170000,1706,110
27323,2024,6,6,0,0,100,133975,1402,96
27324,2024,5,5,0,0,100,179346,1760,109
27325,2024,2,2,0,0,100,53750,395,138
27326,2024,1,1,0,0,100,260000,1538,169
27327,2024,4,4,0,0,100,182250,1758,102
27329,2024,9,9,0,0,100,211328,1797,123
27330,2024,3,3,0,0,100,169333,2280,82
27331,2024,3,3,0,0,100,181453,1657,121
27332,2024,5,5,0,0,100,162770,2036,88
27333,2024,6,6,0,0,100,194182,2371,85
27334,2024,1,1,0,0,100,230000,2110,109
27335,2024,19,19,0,0,100,216356,2267,95
27336,2024,3,3,0,0,100,160167,1723,87
27337,2024,5,5,0,0,100,180800,1795,101
27338,2024,7,7,0,0,100,163514,1803,92
27339,2024,10,10,0,0,100,172600,2064,90
27340,2024,8,8,0,0,100,238156,1640,152
27341,2024,3,3,0,0,100,160500,1697,93
27342,2024,2,2,0,0,100,254000,3166,75
27343,2024,13,13,0,0,100,286686,2121,140
27345,2024,10,10,0,0,100,202023,1551,160
27346,2024,1,1,0,0,100,245000,3267,75
27347,2024,9,9,0,0,100,233917,1931,120
27348,2024,18,17,1,6,94,189031,1975,96
27349,2024,6,6,0,0,100,165250,1696,96
27350,2024,12,12,0,0,100,159336,1799,86
27351,2024,13,13,0,0,100,178197,1894,97
27353,2024,2,2,0,0,100,217000,2366,92
27354,2024,4,4,0,0,100,208250,2120,101
27355,2024,36,25,11,31,69,171839,2224,76
27358,2024,4,4,0,0,100,264000,2177,152
27359,2024,2,2,0,0,100,58000,788,74
27360,2024,6,6,0,0,100,192587,1950,104
27361,2024,4,4,0,0,100,174750,2605,57
27364,2024,2,2,0,0,100,116000,2036,64
27365,2024,16,15,1,6,94,174888,2023,90
27366,2024,1,1,0,0,100,180000,1636,110
27367,2024,24,24,0,0,100,204598,1968,105
27368,2024,6,6,0,0,100,222500,2126,110
27369,2024,2,2,0,0,100,382500,2416,136
27370,2024,4,4,0,0,100,176250,1492,123
27371,2024,1,1,0,0,100,274000,2264,121
27372,2024,6,6,0,0,100,175092,2281,84
27373,2024,2,2,0,0,100,142600,2786,52
27374,2024,7,7,0,0,100,175136,1813,98
27375,2024,213,145,68,32,68,162227,2066,80
27376,2024,4,4,0,0,100,258125,1977,130
27377,2024,9,9,0,0,100,145783,1698,87
27378,2024,18,18,0,0,100,175286,1858,93
27379,2024,4,4,0,0,100,158762,1822,112
27380,2024,6,6,0,0,100,206862,1740,109
27381,2024,5,5,0,0,100,166200,2106,95
27382,2024,3,3,0,0,100,291433,2314,123
27383,2024,5,5,0,0,100,183000,1563,121
27384,2024,6,6,0,0,100,291317,2356,126
27385,2024,14,11,3,21,79,195741,1989,99
27386,2024,10,9,1,10,90,127641,1763,77
27388,2024,8,8,0,0,100,169214,2036,88
27389,2024,8,8,0,0,100,245062,1889,130
27390,2024,12,12,0,0,100,204423,1913,110
27391,2024,20,20,0,0,100,147429,1543,91
27392,2024,3,3,0,0,100,185000,2015,82
27393,2024,2,2,0,0,100,340200,2449,139
27394,2024,4,4,0,0,100,180575,2671,68
27396,2024,4,4,0,0,100,116000,1428,84
27397,2024,14,14,0,0,100,229384,2441,101
27398,2024,24,24,0,0,100,180582,1819,104
27399,2024,3,3,0,0,100,104000,1971,54
27400,2024,5,5,0,0,100,152570,2016,81
27401,2024,1,1,0,0,100,185000,2033,91
27403,2024,3,3,0,0,100,167833,1820,88
27404,2024,1,1,0,0,100,230000,1533,150
27406,2024,10,9,1,10,90,168750,1974,85
27407,2024,4,4,0,0,100,138580,1586,80
27408,2024,9,9,0,0,100,230367,1987,111
27410,2024,11,11,0,0,100,217668,2229,100
27411,2024,3,3,0,0,100,168197,1226,144
27412,2024,15,15,0,0,100,187529,1831,107
27413,2024,10,10,0,0,100,102700,1156,93
27414,2024,10,10,0,0,100,168280,1742,98
27415,2024,2,2,0,0,100,208000,1875,110
27417,2024,12,12,0,0,100,179854,1828,112
27418,2024,4,4,0,0,100,177438,2297,79
27419,2024,5,5,0,0,100,209700,2448,88
27420,2024,3,3,0,0,100,170667,1620,114
27421,2024,5,5,0,0,100,254960,2148,105
27422,2024,8,8,0,0,100,176888,2056,94
27423,2024,5,5,0,0,100,312736,1840,150
27424,2024,2,2,0,0,100,238500,2434,98
27425,2024,26,25,1,4,96,144762,1631,88
27426,2024,22,22,0,0,100,216561,2505,98
27427,2024,6,6,0,0,100,97333,1490,70
27428,2024,56,44,12,21,79,162826,2079,82
27429,2024,4,4,0,0,100,199625,2262,94
27430,2024,2,2,0,0,100,168000,3028,62
27431,2024,15,10,5,33,67,81035,1074,75
27432,2024,11,11,0,0,100,169673,2037,91
27433,2024,1,1,0,0,100,160000,476,336
27435,2024,3,3,0,0,100,207300,2026,102
27436,2024,2,2,0,0,100,136000,1498,92
27437,2024,5,5,0,0,100,159371,1571,91
27438,2024,20,17,3,15,85,143286,1923,79
27439,2024,13,13,0,0,100,213762,2177,103
27440,2024,8,8,0,0,100,283247,2346,116
27441,2024,2,2,0,0,100,123500,2898,45
27442,2024,5,5,0,0,100,104700,1499,67
27444,2024,7,7,0,0,100,198214,1519,128
27445,2024,2,2,0,0,100,179450,1940,92
27446,2024,3,3,0,0,100,181400,1466,121
27447,2024,9,9,0,0,100,190276,1706,114
27448,2024,50,39,11,22,78,215160,2502,84
27451,2024,4,4,0,0,100,187875,1918,102
27453,2024,17,17,0,0,100,123826,1748,76
27454,2024,2,2,0,0,100,174000,1642,112
27455,2024,2,2,0,0,100,165500,2130,78
27456,2024,10,10,0,0,100,245525,2230,110
27457,2024,7,7,0,0,100,149714,1615,96
27458,2024,20,20,0,0,100,187415,1890,98
27460,2024,2,2,0,0,100,289000,2342,125
27462,2024,2,2,0,0,100,175000,2217,82
27463,2024,7,7,0,0,100,233200,2556,102
27464,2024,5,5,0,0,100,205200,1911,112
27465,2024,4,4,0,0,100,240008,2386,100
27466,2024,3,3,0,0,100,158000,1396,112
27467,2024,101,68,33,33,67,148570,1914,80
27468,2024,8,8,0,0,100,138150,1273,104
27469,2024,48,45,3,6,94,202283,2089,102
27470,2024,13,13,0,0,100,137492,1912,78
27471,2024,2,2,0,0,100,269000,2450,105
27472,2024,2,2,0,0,100,197000,1828,114
27473,2024,10,10,0,0,100,240500,2914,86
27474,2024,16,16,0,0,100,178590,1900,90
27475,2024,3,3,0,0,100,189400,1537,136
27476,2024,4,4,0,0,100,135250,1696,78
27477,2024,5,5,0,0,100,174114,2089,85
27478,2024,11,11,0,0,100,255026,2368,108
27480,2024,10,10,0,0,100,161373,1848,88
27481,2024,5,5,0,0,100,233700,1869,122
27482,2024,2,2,0,0,100,192150,1608,110
27483,2024,3,3,0,0,100,186333,1974,97
27485,2024,14,14,0,0,100,106503,1413,78
27486,2024,5,5,0,0,100,215150,1765,117
27487,2024,9,9,0,0,100,121944,1591,79
27489,2024,8,8,0,0,100,176312,1843,97
27490,2024,5,5,0,0,100,132600,1568,87
27492,2024,4,4,0,0,100,152082,1895,84
27493,2024,42,42,0,0,100,185588,2124,91
27496,2024,5,5,0,0,100,152200,1607,94
27497,2024,5,5,0,0,100,202576,1762,111
27498,2024,2,2,0,0,100,151850,1180,135
27500,2024,17,15,2,12,88,185198,1888,101
27501,2024,6,6,0,0,100,227333,1684,135
27502,2024,24,24,0,0,100,113765,1182,93
27504,2024,9,9,0,0,100,234722,2137,118
27505,2024,7,7,0,0,100,264374,2366,118
27507,2024,36,34,2,6,94,176030,1989,93
27508,2024,4,4,0,0,100,174250,2084,64
27511,2024,4,4,0,0,100,243328,2132,118
27512,2024,6,6,0,0,100,174542,1519,117
27514,2024,5,5,0,0,100,140600,1574,93
27516,2024,21,21,0,0,100,197679,1792,106
27517,2024,13,13,0,0,100,258153,1966,133
27518,2024,5,5,0,0,100,179600,1706,111
27520,2024,3,3,0,0,100,198563,1995,106
27521,2024,2,2,0,0,100,210000,1904,114
27522,2024,8,8,0,0,100,234579,1799,139
27524,2024,7,7,0,0,100,212732,1684,128
27525,2024,2,2,0,0,100,191000,1706,112
27527,2024,4,4,0,0,100,131000,1700,94
27528,2024,49,42,7,14,86,246229,2308,106
27529,2024,1,1,0,0,100,658400,2195,300
27530,2024,1,1,0,0,100,350000,1591,220
27531,2024,1,1,0,0,100,75000,1339,56
27533,2024,5,5,0,0,100,230360,2420,97
27534,2024,7,7,0,0,100,208861,2063,102
27535,2024,4,4,0,0,100,164999,1723,94
27536,2024,4,4,0,0,100,175562,1997,90
27537,2024,6,5,1,17,83,199917,2092,98
27538,2024,4,4,0,0,100,219875,2568,85
27539,2024,3,3,0,0,100,234333,2425,96
27540,2024,3,3,0,0,100,200333,3454,66
27541,2024,5,5,0,0,100,256220,2517,110
27542,2024,11,10,1,9,91,170864,1787,101
27543,2024,9,9,0,0,100,183833,2173,88
27544,2024,2,2,0,0,100,255500,1928,129
27545,2024,1,1,0,0,100,80000,615,130
27546,2024,2,2,0,0,100,174850,2264,78
27547,2024,10,10,0,0,100,193815,1858,109
27548,2024,11,11,0,0,100,161382,2017,86
27550,2024,3,3,0,0,100,132464,2798,51
27552,2024,3,3,0,0,100,156333,1403,129
27553,2024,8,8,0,0,100,177745,1811,86
27554,2024,30,29,1,3,97,214806,2266,98
27555,2024,1,1,0,0,100,372500,3079,121
27556,2024,1,1,0,0,100,216038,3858,56
27557,2024,6,6,0,0,100,217833,2090,102
27558,2024,3,3,0,0,100,165333,2021,83
27560,2024,6,6,0,0,100,188288,1964,99
27561,2024,8,8,0,0,100,263378,2263,114
27562,2024,36,24,12,33,67,184715,2275,82
27563,2024,8,8,0,0,100,188126,1779,110
27564,2024,4,4,0,0,100,135350,1429,96
27565,2024,6,6,0,0,100,154235,1862,87
27567,2024,2,2,0,0,100,461000,2862,149
27568,2024,4,4,0,0,100,154375,1661,94
27569,2024,3,3,0,0,100,302417,1788,165
27570,2024,3,3,0,0,100,206167,1983,101
27571,2024,3,3,0,0,100,366083,2318,171
27572,2024,1,1,0,0,100,275000,1687,163
27576,2024,6,6,0,0,100,174000,1697,93
27577,2024,4,4,0,0,100,130265,1273,110
27578,2024,11,11,0,0,100,153496,1408,111
27579,2024,2,2,0,0,100,238900,1770,134
27580,2024,25,25,0,0,100,187565,2038,94
27582,2024,19,19,0,0,100,184318,2010,95
27584,2024,5,5,0,0,100,177240,1865,91
27586,2024,2,2,0,0,100,235440,2129,114
27587,2024,10,10,0,0,100,172090,1969,83
27589,2024,11,11,0,0,100,224951,2334,99
27590,2024,4,4,0,0,100,133275,1253,106
27591,2024,13,13,0,0,100,216418,2088,99
27592,2024,5,5,0,0,100,187830,1699,118
27593,2024,18,18,0,0,100,182253,2022,94
27594,2024,3,3,0,0,100,196133,1919,107
27595,2024,9,9,0,0,100,222667,2033,114
27597,2024,7,7,0,0,100,267564,2384,119
27598,2024,19,18,1,5,95,186225,2279,85
27599,2024,8,8,0,0,100,169316,1748,101
27601,2024,9,9,0,0,100,270944,2536,95
27602,2024,52,49,3,6,94,169444,1832,94
27603,2024,3,3,0,0,100,152167,1882,83
27604,2024,1,1,0,0,100,216900,1870,116
27605,2024,2,2,0,0,100,155000,1864,82
27606,2024,4,4,0,0,100,168775,2812,62
27608,2024,5,5,0,0,100,165200,1563,103
27610,2024,1,1,0,0,100,175000,1458,120
27611,2024,3,3,0,0,100,233593,2351,107
27612,2024,4,4,0,0,100,225900,2172,104
27613,2024,4,4,0,0,100,165500,2013,85
27614,2024,3,3,0,0,100,212000,1414,183
27615,2024,2,2,0,0,100,206000,2614,80
27616,2024,16,16,0,0,100,182942,1902,97
27617,2024,6,6,0,0,100,201802,1697,117
27618,2024,10,10,0,0,100,169800,1839,100
27620,2024,7,7,0,0,100,189257,2083,96
27622,2024,26,25,1,4,96,115380,1491,79
27623,2024,4,4,0,0,100,172125,1821,94
27624,2024,6,6,0,0,100,167433,1744,98
27625,2024,3,3,0,0,100,190383,1672,117
27627,2024,7,7,0,0,100,171000,1805,102
27629,2024,18,17,1,6,94,143366,1794,87
27630,2024,6,6,0,0,100,131833,1504,99
27631,2024,2,2,0,0,100,165700,1703,94
27632,2024,3,3,0,0,100,151250,1795,90
27633,2024,6,5,1,17,83,140133,1996,68
27635,2024,2,2,0,0,100,183500,1876,96
27638,2024,27,27,0,0,100,222083,1883,121
27640,2024,1,1,0,0,100,165000,1320,125
27641,2024,2,2,0,0,100,106000,786,126
27643,2024,14,14,0,0,100,158930,1662,98
27644,2024,4,4,0,0,100,206504,2463,95
27645,2024,1,1,0,0,100,55000,688,80
27646,2024,3,3,0,0,100,203183,3698,60
27649,2024,5,5,0,0,100,176560,2062,88
27650,2024,2,2,0,0,100,253225,2282,111
27652,2024,3,3,0,0,100,193333,2162,90
27654,2024,10,10,0,0,100,214386,2118,101
27655,2024,8,8,0,0,100,226275,1792,131
27656,2024,15,15,0,0,100,158560,1797,85
27658,2024,3,3,0,0,100,178333,1809,99
27659,2024,1,1,0,0,100,181000,1602,113
27660,2024,7,7,0,0,100,270997,2397,119
27661,2024,3,3,0,0,100,285383,2351,120
27662,2024,8,8,0,0,100,129200,2098,69
27663,2024,1,1,0,0,100,97000,1448,67
27664,2024,6,6,0,0,100,154353,1594,101
27665,2024,10,10,0,0,100,184154,1520,126
27666,2024,5,5,0,0,100,211960,2008,108
27668,2024,9,9,0,0,100,205033,1888,119
27669,2024,3,3,0,0,100,251167,1982,122
27670,2024,5,5,0,0,100,199074,2007,98
27671,2024,2,2,0,0,100,247375,2152,118
27672,2024,4,4,0,0,100,136643,1720,80
27673,2024,2,2,0,0,100,158578,1180,134
27674,2024,3,3,0,0,100,402590,3100,135
27676,2024,11,11,0,0,100,205501,2666,116
27677,2024,4,4,0,0,100,175225,1522,110
27678,2024,12,12,0,0,100,209988,2018,106
27679,2024,83,63,20,24,76,142025,1816,82
27680,2024,5,5,0,0,100,102100,1180,88
27681,2024,229,102,127,55,45,202623,2676,78
27682,2024,6,6,0,0,100,203678,2273,95
27684,2024,12,10,2,17,83,178875,1723,105
27685,2024,13,13,0,0,100,122462,1458,85
27686,2024,2,2,0,0,100,255000,2091,113
27689,2024,1,1,0,0,100,250460,2319,108
27690,2024,2,2,0,0,100,193500,1530,125
27691,2024,15,15,0,0,100,163153,1946,86
27692,2024,2,2,0,0,100,209500,1854,115
27693,2024,10,10,0,0,100,227242,1979,114
27694,2024,4,4,0,0,100,255500,2759,96
27695,2024,1,1,0,0,100,159990,1739,92
27696,2024,10,10,0,0,100,208009,2085,105
27697,2024,1,1,0,0,100,253000,1687,150
27698,2024,4,4,0,0,100,120625,1492,89
27699,2024,1,1,0,0,100,151500,2295,66
27700,2024,7,7,0,0,100,223541,1942,119
27701,2024,67,49,18,27,73,141248,1664,86
28001,2024,18,17,1,6,94,274588,2175,127
28003,2024,1,1,0,0,100,205000,2050,100
28004,2024,2,2,0,0,100,180400,2334,78
28005,2024,8,8,0,0,100,114816,1112,103
28006,2024,26,26,0,0,100,204113,2160,97
28007,2024,42,37,5,12,88,217698,2153,106
28008,2024,3,3,0,0,100,152167,1504,100
28009,2024,1,1,0,0,100,128000,1143,112
28010,2024,4,4,0,0,100,112488,1653,81
28012,2024,61,60,1,2,98,100015,1159,85
28013,2024,12,11,1,8,92,180988,2263,83
28014,2024,6,5,1,17,83,175248,1642,111
28015,2024,59,45,14,24,76,189543,2166,92
28016,2024,5,5,0,0,100,127062,1281,90
28018,2024,31,31,0,0,100,114418,1443,78
28019,2024,1,1,0,0,100,226104,1449,156
28021,2024,17,17,0,0,100,183886,1959,99
28022,2024,4,4,0,0,100,169338,2368,79
28023,2024,13,13,0,0,100,304970,2368,131
28024,2024,13,13,0,0,100,256146,2458,102
28026,2024,3,3,0,0,100,163840,1510,115
28027,2024,18,18,0,0,100,107417,1181,91
28028,2024,6,6,0,0,100,130450,1618,86
28029,2024,3,3,0,0,100,128267,2424,61
28030,2024,3,3,0,0,100,186000,1318,140
28031,2024,3,3,0,0,100,75020,1182,61
28032,2024,2,2,0,0,100,150500,1732,90
28033,2024,15,15,0,0,100,125691,1327,95
28034,2024,8,8,0,0,100,219450,1979,116
28035,2024,3,3,0,0,100,223083,2434,90
28036,2024,8,6,2,25,75,261088,3144,86
28037,2024,5,4,1,20,80,95652,995,93
28038,2024,1,1,0,0,100,18000,375,48
28039,2024,19,19,0,0,100,187061,2183,85
28040,2024,2,2,0,0,100,227010,2255,101
28041,2024,3,3,0,0,100,108333,1415,72
28045,2024,4,4,0,0,100,148120,1482,102
28046,2024,7,7,0,0,100,178643,1795,102
28047,2024,2,2,0,0,100,85000,704,122
28048,2024,6,6,0,0,100,136333,1561,92
28049,2024,1,1,0,0,100,160000,1778,90
28050,2024,5,5,0,0,100,269800,2439,122
28051,2024,61,56,5,8,92,159456,1628,100
28052,2024,10,10,0,0,100,199026,2065,104
28053,2024,7,7,0,0,100,198623,1700,117
28054,2024,6,6,0,0,100,180708,1585,118
28055,2024,5,5,0,0,100,175594,1934,92
28056,2024,20,20,0,0,100,387334,3090,127
28057,2024,2,2,0,0,100,92500,1195,79
28058,2024,2,2,0,0,100,215280,2450,85
28059,2024,12,12,0,0,100,122021,1519,83
28060,2024,2,2,0,0,100,246200,2626,114
28061,2024,46,43,3,7,93,130092,1469,90
28062,2024,6,6,0,0,100,338208,2771,124
28064,2024,10,10,0,0,100,222480,2332,98
28065,2024,1,1,0,0,100,115000,1554,74
28067,2024,3,3,0,0,100,99100,1179,83
28068,2024,5,5,0,0,100,196120,1670,125
28070,2024,25,24,1,4,96,271680,2452,113
28071,2024,8,8,0,0,100,117102,1347,88
28072,2024,5,5,0,0,100,168414,1678,99
28073,2024,2,2,0,0,100,232000,2343,100
28074,2024,7,7,0,0,100,197307,1808,114
28075,2024,14,14,0,0,100,159072,1498,111
28076,2024,4,4,0,0,100,178325,1925,98
28077,2024,6,6,0,0,100,134383,1428,92
28078,2024,1,1,0,0,100,87600,775,113
28079,2024,6,6,0,0,100,90883,1250,74
28080,2024,4,4,0,0,100,228062,2435,100
28081,2024,5,5,0,0,100,136130,1584,90
28082,2024,8,8,0,0,100,283794,2166,126
28084,2024,5,5,0,0,100,260490,2365,114
28085,2024,548,162,386,70,30,181034,2513,72
28086,2024,3,3,0,0,100,97095,817,131
28087,2024,5,5,0,0,100,154000,1856,85
28088,2024,141,105,36,26,74,110755,1370,84
28089,2024,24,20,4,17,83,148641,1475,110
28090,2024,3,3,0,0,100,112000,1338,67
28092,2024,5,5,0,0,100,161674,1623,109
28094,2024,20,20,0,0,100,186180,1986,104
28095,2024,6,6,0,0,100,204833,2051,117
28096,2024,12,12,0,0,100,271127,2523,107
28098,2024,18,18,0,0,100,223451,2228,103
28099,2024,12,12,0,0,100,188218,1745,107
28100,2024,2,2,0,0,100,261500,1796,153
28102,2024,10,10,0,0,100,169819,1660,107
28103,2024,64,62,2,3,97,123570,1355,94
28104,2024,14,14,0,0,100,204302,2020,101
28105,2024,9,9,0,0,100,99339,1142,87
28106,2024,6,6,0,0,100,144464,1511,96
28107,2024,4,4,0,0,100,207712,1854,108
28108,2024,4,4,0,0,100,116975,1084,105
28109,2024,7,7,0,0,100,125414,1210,112
28110,2024,45,21,24,53,47,204119,2661,78
28111,2024,3,3,0,0,100,212900,1658,129
28113,2024,15,15,0,0,100,192442,2085,97
28114,2024,1,1,0,0,100,90000,450,200
28116,2024,30,28,2,7,93,177846,1982,94
28117,2024,6,6,0,0,100,233892,1991,124
28118,2024,5,5,0,0,100,285527,2386,121
28119,2024,4,4,0,0,100,103100,1326,78
28120,2024,4,4,0,0,100,156250,1648,96
28121,2024,2,2,0,0,100,128005,1422,84
28122,2024,18,17,1,6,94,223025,2006,115
28123,2024,8,8,0,0,100,104188,1217,89
28124,2024,7,7,0,0,100,130701,1426,94
28126,2024,2,2,0,0,100,91000,1015,93
28127,2024,22,22,0,0,100,94114,1450,67
28128,2024,4,4,0,0,100,146250,1548,95
28129,2024,13,13,0,0,100,203196,1974,107
28130,2024,13,13,0,0,100,133199,1689,96
28132,2024,10,10,0,0,100,128175,1468,87
28134,2024,272,126,146,54,46,133128,1744,76
28135,2024,17,17,0,0,100,325258,2461,132
28136,2024,1,1,0,0,100,133000,2111,63
28137,2024,16,16,0,0,100,258601,2835,98
28139,2024,2,2,0,0,100,148250,1096,135
28140,2024,64,26,38,59,41,171491,2651,66
28141,2024,2,2,0,0,100,168750,1881,90
28142,2024,2,2,0,0,100,95000,1630,52
28143,2024,2,2,0,0,100,217775,1418,153
28144,2024,1,1,0,0,100,80000,1860,43
28146,2024,8,8,0,0,100,262619,2681,104
28147,2024,8,8,0,0,100,162912,1740,96
28148,2024,6,6,0,0,100,77500,1094,70
28149,2024,12,12,0,0,100,101608,1163,88
28151,2024,1,1,0,0,100,247500,1547,160
28153,2024,2,2,0,0,100,78500,1186,72
28154,2024,18,18,0,0,100,231970,1922,129
28155,2024,3,3,0,0,100,142667,1893,75
28156,2024,15,15,0,0,100,115687,1395,85
28158,2024,5,5,0,0,100,232756,1579,157
28159,2024,5,5,0,0,100,163560,1627,102
28160,2024,12,12,0,0,100,168450,1786,100
28161,2024,7,6,1,14,86,136314,1687,87
28162,2024,2,2,0,0,100,150750,1458,104
28163,2024,3,3,0,0,100,189719,1447,136
28164,2024,16,16,0,0,100,141606,1663,94
28166,2024,7,7,0,0,100,147929,1474,101
28167,2024,3,3,0,0,100,144107,1819,82
28168,2024,33,27,6,18,82,183827,1964,103
28169,2024,4,4,0,0,100,185175,2148,84
28170,2024,1,1,0,0,100,356400,2742,130
28171,2024,14,14,0,0,100,241393,1973,132
28172,2024,11,10,1,9,91,223764,2659,90
28173,2024,15,14,1,7,93,239287,1980,120
28175,2024,2,2,0,0,100,165000,1662,100
28176,2024,8,8,0,0,100,167016,1498,122
28177,2024,8,8,0,0,100,241744,2832,101
28178,2024,7,7,0,0,100,155660,2089,86
28180,2024,7,7,0,0,100,284044,2666,118
28182,2024,2,2,0,0,100,197500,1442,136
28183,2024,9,9,0,0,100,175111,1667,109
28184,2024,5,5,0,0,100,165988,1933,92
28185,2024,6,5,1,17,83,232767,2211,107
28187,2024,6,6,0,0,100,241450,2272,114
28188,2024,13,13,0,0,100,216896,2056,110
28189,2024,2,2,0,0,100,183635,1356,156
28190,2024,4,4,0,0,100,114500,1624,75
28191,2024,14,14,0,0,100,245755,2548,96
28192,2024,6,6,0,0,100,107625,1284,85
28193,2024,1,1,0,0,100,500000,3125,160
28194,2024,4,4,0,0,100,244500,2202,118
28195,2024,11,11,0,0,100,168964,2339,74
28196,2024,42,41,1,2,98,118598,1391,87
28198,2024,10,10,0,0,100,133551,1389,97
28199,2024,24,24,0,0,100,161558,1631,105
28200,2024,3,3,0,0,100,154567,1213,130
28201,2024,14,14,0,0,100,251464,2559,99
28202,2024,3,3,0,0,100,161333,1364,109
28203,2024,9,9,0,0,100,196661,1868,108
28206,2024,5,5,0,0,100,109000,1679,66
28207,2024,3,3,0,0,100,240167,1567,157
28208,2024,6,6,0,0,100,246217,1993,132
28209,2024,50,33,17,34,66,192201,2355,83
28210,2024,6,6,0,0,100,119470,1344,89
28211,2024,3,3,0,0,100,104083,1046,98
28212,2024,3,3,0,0,100,53333,1031,55
28213,2024,8,5,3,38,62,171262,1941,86
28214,2024,44,38,6,14,86,127158,1470,89
28215,2024,3,3,0,0,100,126633,1029,111
28217,2024,2,2,0,0,100,112175,1720,68
28218,2024,119,59,60,50,50,152557,2242,70
28219,2024,8,8,0,0,100,144588,2594,73
28220,2024,77,56,21,27,73,248232,2649,96
28222,2024,1,1,0,0,100,120790,2013,60
28223,2024,15,15,0,0,100,204560,2249,93
28225,2024,9,9,0,0,100,177956,1910,98
28226,2024,7,7,0,0,100,131157,1323,93
28227,2024,46,36,10,22,78,204911,2634,79
28229,2024,135,69,66,49,51,166958,2260,76
28230,2024,6,6,0,0,100,190275,1897,108
28231,2024,1,1,0,0,100,179000,1627,110
28232,2024,6,6,0,0,100,139628,1473,94
28233,2024,15,14,1,7,93,95477,1266,84
28234,2024,7,7,0,0,100,113605,1384,83
28235,2024,3,3,0,0,100,304030,2319,131
28236,2024,24,23,1,4,96,184331,1930,96
28237,2024,2,2,0,0,100,106750,2228,71
28239,2024,8,8,0,0,100,267706,1934,144
28240,2024,6,6,0,0,100,130308,1612,88
28242,2024,1,1,0,0,100,125000,1562,80
28243,2024,1,1,0,0,100,96600,792,122
28245,2024,5,5,0,0,100,233540,1998,112
28246,2024,7,7,0,0,100,135967,1303,103
28247,2024,11,11,0,0,100,264546,2357,114
28248,2024,2,2,0,0,100,170125,1802,96
28249,2024,4,4,0,0,100,201429,2072,90
28251,2024,12,12,0,0,100,225110,2045,109
28252,2024,5,5,0,0,100,178420,1140,139
28253,2024,7,7,0,0,100,221754,2256,111
28254,2024,6,6,0,0,100,172333,1828,103
28255,2024,4,4,0,0,100,155964,1522,108
28256,2024,5,5,0,0,100,94952,1389,68
28259,2024,4,4,0,0,100,185625,1614,107
28261,2024,9,9,0,0,100,124277,1664,80
28263,2024,3,3,0,0,100,162667,1271,119
28264,2024,2,2,0,0,100,158250,1469,109
28265,2024,5,5,0,0,100,88450,795,99
28267,2024,6,5,1,17,83,191358,2003,98
28269,2024,15,15,0,0,100,258229,2360,110
28270,2024,1,1,0,0,100,98500,1313,75
28272,2024,3,3,0,0,100,79333,1157,77
28273,2024,1,1,0,0,100,120000,1290,93
28274,2024,3,3,0,0,100,165667,1668,99
28275,2024,5,5,0,0,100,191230,1709,99
28277,2024,6,6,0,0,100,115733,1181,100
28278,2024,10,10,0,0,100,247375,2216,112
28279,2024,38,30,8,21,79,171830,2000,88
28280,2024,113,80,33,29,71,122558,1413,85
28281,2024,1,1,0,0,100,226750,2362,96
28282,2024,5,5,0,0,100,195000,1712,107
28283,2024,7,7,0,0,100,76151,1400,63
28284,2024,2,2,0,0,100,124995,982,128
28285,2024,5,5,0,0,100,206520,2512,85
28286,2024,8,8,0,0,100,180138,1635,116
28287,2024,8,8,0,0,100,99375,1366,76
28289,2024,4,4,0,0,100,236125,1811,134
28290,2024,3,3,0,0,100,141000,1577,92
28291,2024,8,8,0,0,100,192125,2029,102
28292,2024,10,10,0,0,100,317829,2452,131
28293,2024,10,10,0,0,100,231793,2238,103
28294,2024,5,5,0,0,100,193040,1940,99
28296,2024,5,5,0,0,100,120748,1048,119
28298,2024,19,18,1,5,95,212887,2434,89
28299,2024,2,2,0,0,100,230000,2608,90
28300,2024,2,2,0,0,100,124500,1514,82
28301,2024,2,2,0,0,100,247500,2104,119
28302,2024,13,13,0,0,100,170190,1713,99
28303,2024,3,3,0,0,100,97667,1016,100
28304,2024,6,6,0,0,100,146333,1256,130
28305,2024,3,3,0,0,100,172507,1855,99
28306,2024,2,2,0,0,100,151000,1574,91
28308,2024,3,3,0,0,100,158413,1645,99
28309,2024,10,10,0,0,100,173875,1789,110
28310,2024,2,2,0,0,100,148750,1586,98
28312,2024,2,2,0,0,100,227300,1931,114
28313,2024,4,4,0,0,100,217000,1499,148
28314,2024,3,3,0,0,100,166400,1895,92
28315,2024,1,1,0,0,100,101000,1578,64
28316,2024,3,3,0,0,100,105667,1113,95
28317,2024,4,4,0,0,100,197250,2270,102
28319,2024,5,5,0,0,100,173550,1642,103
28321,2024,8,8,0,0,100,210790,2259,94
28322,2024,9,9,0,0,100,168333,1521,113
28323,2024,1,1,0,0,100,150000,1899,79
28324,2024,3,3,0,0,100,179400,1618,115
28325,2024,9,9,0,0,100,200761,1982,102
28326,2024,2,2,0,0,100,168750,1450,125
28327,2024,2,2,0,0,100,82000,815,124
28329,2024,1,1,0,0,100,151000,1208,125
28330,2024,16,16,0,0,100,148038,1551,91
28331,2024,13,13,0,0,100,152358,1611,96
28332,2024,9,9,0,0,100,239626,2284,106
28333,2024,3,3,0,0,100,133333,1116,123
28334,2024,28,28,0,0,100,172556,1684,100
28335,2024,11,11,0,0,100,148443,1521,95
28337,2024,33,32,1,3,97,200270,2087,101
28339,2024,2,2,0,0,100,192575,1858,104
28341,2024,6,6,0,0,100,136583,1861,70
28342,2024,2,2,0,0,100,218000,1476,148
28343,2024,3,3,0,0,100,390097,2060,175
28344,2024,5,5,0,0,100,172800,2330,77
28347,2024,10,10,0,0,100,270619,2882,108
28348,2024,27,26,1,4,96,152211,1654,93
28349,2024,5,5,0,0,100,249434,2188,120
28350,2024,10,10,0,0,100,215590,2119,105
28351,2024,5,5,0,0,100,214120,1736,133
28352,2024,17,17,0,0,100,256053,2560,107
28353,2024,4,4,0,0,100,178750,2105,83
28354,2024,3,3,0,0,100,131900,1455,93
28355,2024,3,3,0,0,100,209867,2251,97
28357,2024,14,14,0,0,100,215275,2644,88
28358,2024,20,20,0,0,100,178535,2149,92
28359,2024,36,36,0,0,100,164834,1795,94
28360,2024,10,10,0,0,100,128805,1722,81
28362,2024,9,9,0,0,100,124589,1570,84
28363,2024,11,11,0,0,100,243973,2427,105
28364,2024,14,11,3,21,79,90571,1344,70
28365,2024,4,4,0,0,100,215838,1895,113
28366,2024,1,1,0,0,100,810000,5159,157
28367,2024,2,2,0,0,100,137000,1135,119
28368,2024,4,4,0,0,100,146750,1392,107
28369,2024,10,10,0,0,100,163290,1768,96
28370,2024,9,9,0,0,100,115444,1569,74
28371,2024,14,14,0,0,100,240519,2593,97
28372,2024,3,3,0,0,100,447750,3520,125
28373,2024,45,44,1,2,98,128491,1413,91
28374,2024,2,2,0,0,100,167250,1495,112
28375,2024,1,1,0,0,100,230000,1353,170
28377,2024,19,16,3,16,84,208717,2204,97
28378,2024,1,1,0,0,100,70000,707,99
28379,2024,11,11,0,0,100,227527,2232,109
28380,2024,13,13,0,0,100,269076,2451,114
28382,2024,10,10,0,0,100,126260,1393,92
28383,2024,4,4,0,0,100,155338,1516,106
28385,2024,6,6,0,0,100,144633,1846,80
28386,2024,14,14,0,0,100,193157,1830,108
28387,2024,12,12,0,0,100,99011,1360,74
28388,2024,20,20,0,0,100,174716,2193,81
28389,2024,4,4,0,0,100,154200,1283,135
28390,2024,2,2,0,0,100,126000,1900,75
28391,2024,21,19,2,10,90,138119,1726,84
28392,2024,5,5,0,0,100,122320,1432,90
28393,2024,30,29,1,3,97,191824,1783,116
28394,2024,17,17,0,0,100,167428,1809,95
28395,2024,4,4,0,0,100,157125,1666,97
28396,2024,1,1,0,0,100,137000,2635,52
28397,2024,3,3,0,0,100,211197,2248,98
28398,2024,21,21,0,0,100,134012,1383,101
28400,2024,3,3,0,0,100,132000,1305,107
28401,2024,7,7,0,0,100,142882,1531,100
28403,2024,9,9,0,0,100,294867,2206,130
28404,2024,92,74,18,20,80,174833,2060,88
28405,2024,11,11,0,0,100,168989,1875,91
28406,2024,16,16,0,0,100,143480,1305,114
28407,2024,6,6,0,0,100,138233,1450,99
28408,2024,2,2,0,0,100,156850,1722,89
28409,2024,4,4,0,0,100,205226,1524,147
28410,2024,2,2,0,0,100,116950,1448,95
28411,2024,4,4,0,0,100,155002,1389,118
28415,2024,16,16,0,0,100,230028,2029,123
28417,2024,13,13,0,0,100,203285,2401,96
28418,2024,3,3,0,0,100,186667,1699,113
28419,2024,2,2,0,0,100,132500,1544,90
28421,2024,3,3,0,0,100,152667,1448,119
28422,2024,52,49,3,6,94,153363,1836,85
28423,2024,6,6,0,0,100,205767,2275,88
28424,2024,20,20,0,0,100,119820,1611,78
28425,2024,8,8,0,0,100,233814,2765,88
28426,2024,6,6,0,0,100,133750,1711,76
29001,2024,11,10,1,9,91,216537,2482,94
29002,2024,11,11,0,0,100,173358,1988,91
29003,2024,79,57,22,28,72,213025,2663,85
29004,2024,65,64,1,2,98,180219,1830,103
29005,2024,13,13,0,0,100,269969,2259,116
29006,2024,98,35,63,64,36,243333,3517,74
29007,2024,8,8,0,0,100,86252,1080,83
29008,2024,8,8,0,0,100,161494,1876,82
29010,2024,15,15,0,0,100,161774,1475,112
29011,2024,20,14,6,30,70,242326,2556,99
29012,2024,4,3,1,25,75,70850,1072,63
29013,2024,4,4,0,0,100,61250,608,94
29014,2024,6,6,0,0,100,80333,910,84
29015,2024,26,26,0,0,100,220770,2089,108
29016,2024,13,13,0,0,100,89881,1078,90
29017,2024,4,4,0,0,100,218200,1602,145
29018,2024,8,8,0,0,100,90512,1212,76
29019,2024,2158,487,1671,77,23,154980,2278,70
29020,2024,51,43,8,16,84,174779,1895,101
29021,2024,27,25,2,7,93,279907,2965,95
29022,2024,41,31,10,24,76,202186,2741,86
29023,2024,57,40,17,30,70,310934,3390,88
29024,2024,91,76,15,16,84,111555,1448,80
29025,2024,21,21,0,0,100,140414,1479,96
29026,2024,52,45,7,13,87,137241,1710,88
29027,2024,63,61,2,3,97,111386,1283,87
29028,2024,13,13,0,0,100,151878,1788,97
29029,2024,15,15,0,0,100,110218,1377,86
29030,2024,37,37,0,0,100,198281,2087,102
29031,2024,70,53,17,24,76,292244,3473,94
29032,2024,24,23,1,4,96,322264,2930,111
29033,2024,10,10,0,0,100,131700,1112,111
29034,2024,7,7,0,0,100,109714,1400,78
29035,2024,7,7,0,0,100,211279,1762,123
29036,2024,13,13,0,0,100,122502,1189,114
29037,2024,45,39,6,13,87,311534,3421,96
29038,2024,15,15,0,0,100,88841,1185,78
29039,2024,321,187,134,42,58,273902,3377,83
29040,2024,33,28,5,15,85,341673,3069,109
29041,2024,18,18,0,0,100,119440,1214,101
29042,2024,117,91,26,22,78,214756,2722,85
29043,2024,18,18,0,0,100,204702,1888,112
29044,2024,20,20,0,0,100,148373,1436,103
29045,2024,22,20,2,9,91,199619,2087,102
29046,2024,224,143,81,36,64,193955,2301,87
29047,2024,20,20,0,0,100,191801,1931,102
29048,2024,18,17,1,6,94,196215,2019,105
29049,2024,28,27,1,4,96,176934,1946,98
29051,2024,65,65,0,0,100,223989,2216,101
29053,2024,22,22,0,0,100,176358,1889,98
29054,2024,11,11,0,0,100,119832,1264,92
29055,2024,23,23,0,0,100,203592,2063,101
29056,2024,22,21,1,5,95,252613,2341,105
29057,2024,35,26,9,26,74,387642,3688,106
29058,2024,153,100,53,35,65,324544,3717,91
29059,2024,10,10,0,0,100,226110,2166,120
29060,2024,28,28,0,0,100,301469,2706,118
29061,2024,67,60,7,10,90,250621,2517,101
29062,2024,20,20,0,0,100,141235,1490,98
29063,2024,7,7,0,0,100,206512,2247,90
29064,2024,7,7,0,0,100,269286,2451,107
29065,2024,11,11,0,0,100,194480,1968,110
29066,2024,14,14,0,0,100,187036,1940,99
29067,2024,17,17,0,0,100,117762,1185,103
29068,2024,19,19,0,0,100,171947,1481,116
29069,2024,79,74,5,6,94,221405,2219,102
29070,2024,6,6,0,0,100,186083,2052,95
29071,2024,16,16,0,0,100,189084,1438,133
29072,2024,64,54,10,16,84,210605,2707,81
29073,2024,12,12,0,0,100,229667,2209,105
29074,2024,8,8,0,0,100,114711,1767,68
29075,2024,143,111,32,22,78,236078,2491,95
29076,2024,38,36,2,5,95,245018,2235,110
29077,2024,30,29,1,3,97,197470,2085,96
29078,2024,19,19,0,0,100,235639,2244,106
29079,2024,19,19,0,0,100,148221,1543,99
29080,2024,33,32,1,3,97,204055,2035,103
29081,2024,33,32,1,3,97,127614,1438,91
29082,2024,12,12,0,0,100,357147,3961,92
29085,2024,16,12,4,25,75,286894,4399,73
29086,2024,7,7,0,0,100,158696,1871,83
29087,2024,9,9,0,0,100,179222,1728,103
29089,2024,5,5,0,0,100,69800,961,73
29090,2024,5,5,0,0,100,263959,2715,105
29091,2024,26,26,0,0,100,231647,2457,113
29093,2024,10,10,0,0,100,213314,1903,115
29094,2024,2,2,0,0,100,141250,1652,94
29095,2024,12,12,0,0,100,219854,2112,108
29097,2024,25,25,0,0,100,137746,1460,95
29098,2024,22,20,2,9,91,204220,2388,88
29099,2024,4,4,0,0,100,212403,2238,106
29100,2024,2,2,0,0,100,128500,1066,120
29101,2024,51,45,6,12,88,289546,2697,107
29102,2024,18,18,0,0,100,84578,978,87
29103,2024,199,125,74,37,63,184804,2181,86
29104,2024,3,3,0,0,100,156126,2329,67
29105,2024,140,108,32,23,77,154918,1740,91
29106,2024,9,9,0,0,100,213789,1784,120
29107,2024,10,10,0,0,100,199840,2055,99
29108,2024,16,16,0,0,100,189253,1857,101
29109,2024,16,16,0,0,100,302022,2754,114
29110,2024,3,3,0,0,100,143667,1428,98
29111,2024,5,5,0,0,100,139531,1959,72
29112,2024,18,18,0,0,100,338459,3120,108
29113,2024,26,26,0,0,100,186820,2047,97
29114,2024,9,9,0,0,100,109416,1129,90
29115,2024,5,5,0,0,100,100800,1256,89
29116,2024,1,1,0,0,100,211450,2158,98
29117,2024,71,59,12,17,83,235287,2265,103
29119,2024,17,17,0,0,100,220589,2386,95
29120,2024,17,13,4,24,76,152742,2022,81
29122,2024,12,12,0,0,100,146351,1482,104
29123,2024,9,9,0,0,100,99164,1360,76
29124,2024,88,64,24,27,73,161480,1860,87
29125,2024,9,9,0,0,100,98947,983,115
29126,2024,3,3,0,0,100,87000,1532,61
29128,2024,2,2,0,0,100,67500,588,126
29130,2024,36,35,1,3,97,321694,2948,109
29131,2024,7,7,0,0,100,177701,1658,109
29132,2024,13,13,0,0,100,221885,2665,96
29133,2024,31,22,9,29,71,327970,4632,72
29134,2024,7,7,0,0,100,165717,2818,67
29135,2024,55,50,5,9,91,285094,3048,95
29136,2024,12,11,1,8,92,186365,1753,106
29137,2024,29,29,0,0,100,207002,2614,82
29139,2024,6,6,0,0,100,119071,1468,84
29140,2024,27,27,0,0,100,311274,2799,110
29141,2024,10,10,0,0,100,71685,1116,74
29142,2024,8,8,0,0,100,136004,1295,106
29143,2024,11,11,0,0,100,199273,1935,94
29144,2024,11,10,1,9,91,154282,1398,111
29145,2024,12,12,0,0,100,204820,2080,103
29146,2024,45,45,0,0,100,234245,2238,112
29147,2024,26,26,0,0,100,248686,2393,106
29148,2024,15,15,0,0,100,123330,1299,93
29150,2024,103,92,11,11,89,283265,3237,92
29151,2024,223,118,105,47,53,134207,1713,79
29152,2024,8,8,0,0,100,94810,966,96
29153,2024,52,49,3,6,94,356942,3476,104
29155,2024,11,10,1,9,91,196773,2919,76
29156,2024,20,20,0,0,100,251315,2200,116
29158,2024,84,71,13,15,85,236518,2869,87
29159,2024,7,7,0,0,100,199802,2324,93
29160,2024,75,67,8,11,89,216024,2202,97
29161,2024,37,33,4,11,89,278211,2753,104
29162,2024,55,55,0,0,100,127486,1539,84
29163,2024,34,34,0,0,100,149506,1592,101
29165,2024,46,44,2,4,96,299631,2811,106
29166,2024,5,5,0,0,100,153612,1289,120
29167,2024,18,18,0,0,100,206991,2106,103
29168,2024,22,22,0,0,100,181028,2278,82
29169,2024,28,28,0,0,100,214918,2026,110
29170,2024,50,47,3,6,94,259339,2455,105
29171,2024,37,37,0,0,100,270433,2771,104
29172,2024,35,34,1,3,97,199413,2033,103
29173,2024,24,24,0,0,100,208260,1939,110
29174,2024,57,56,1,2,98,215787,2224,103
29175,2024,45,45,0,0,100,109008,1219,91
29176,2024,16,16,0,0,100,213121,2142,103
29177,2024,42,40,2,5,95,252424,2836,95
29178,2024,63,61,2,3,97,251893,2561,103
29179,2024,30,30,0,0,100,203052,2094,101
29180,2024,11,11,0,0,100,172125,2256,77
29181,2024,28,28,0,0,100,234952,2168,117
29182,2024,13,13,0,0,100,177698,1868,100
29184,2024,20,20,0,0,100,153752,1736,98
29185,2024,42,41,1,2,98,213767,2153,100
29186,2024,21,21,0,0,100,288035,3094,96
29187,2024,5,5,0,0,100,127424,1217,118
29188,2024,54,47,7,13,87,255284,2931,90
29189,2024,120,97,23,19,81,251714,2599,95
29190,2024,63,42,21,33,67,269885,3070,87
29191,2024,43,43,0,0,100,176228,1790,99
29192,2024,10,10,0,0,100,138160,1649,88
29193,2024,13,13,0,0,100,166665,1513,110
29195,2024,76,73,3,4,96,228371,2597,93
29196,2024,20,20,0,0,100,203892,1898,112
29197,2024,86,78,8,9,91,218204,2363,94
29198,2024,17,17,0,0,100,168687,1547,110
29199,2024,42,42,0,0,100,181187,1733,104
29201,2024,15,15,0,0,100,242032,2697,94
29202,2024,12,12,0,0,100,141925,1061,119
29204,2024,22,22,0,0,100,209600,1827,119
29205,2024,23,23,0,0,100,142273,1373,107
29206,2024,30,30,0,0,100,161873,1583,110
29207,2024,42,40,2,5,95,175157,1742,99
29208,2024,10,10,0,0,100,267565,2196,116
29209,2024,32,32,0,0,100,209286,2119,101
29210,2024,32,31,1,3,97,171720,1675,110
29211,2024,10,10,0,0,100,82445,967,85
29212,2024,104,97,7,7,93,249521,2410,106
29213,2024,19,19,0,0,100,140101,1782,86
29214,2024,12,12,0,0,100,329208,3798,102
29215,2024,42,42,0,0,100,236062,2294,105
29216,2024,29,29,0,0,100,226378,2338,101
29217,2024,42,38,4,10,90,251726,2722,94
29218,2024,20,20,0,0,100,186721,2197,92
29220,2024,115,65,50,43,57,208689,2548,82
29221,2024,19,19,0,0,100,299282,2913,109
29222,2024,10,9,1,10,90,111100,1170,93
29224,2024,12,12,0,0,100,190238,1655,130
29225,2024,27,27,0,0,100,230457,2175,116
29226,2024,17,16,1,6,94,219354,2486,94
29227,2024,30,30,0,0,100,90679,1169,83
29228,2024,7,7,0,0,100,191094,2501,91
29229,2024,7,7,0,0,100,155120,1455,109
29230,2024,17,16,1,6,94,165433,1834,92
29232,2024,1077,474,603,56,44,171834,2247,77
29233,2024,155,109,46,30,70,180847,2123,87
29234,2024,27,27,0,0,100,289216,2423,123
29235,2024,123,98,25,20,80,294746,2987,100
29236,2024,61,60,1,2,98,245741,2565,105
29237,2024,20,19,1,5,95,173650,1792,96
29238,2024,21,21,0,0,100,223300,2535,96
29239,2024,74,40,34,46,54,267209,3235,87
29240,2024,11,11,0,0,100,163656,1876,88
29241,2024,101,92,9,9,91,184595,2142,93
29243,2024,6,6,0,0,100,202266,1358,147
29244,2024,8,8,0,0,100,152414,1444,110
29245,2024,15,15,0,0,100,237836,2296,105
29246,2024,3,3,0,0,100,142500,1306,109
29247,2024,35,32,3,9,91,245725,2356,102
29248,2024,10,10,0,0,100,188127,1628,111
29249,2024,15,15,0,0,100,110829,1399,81
29250,2024,10,10,0,0,100,115479,1166,101
29251,2024,9,9,0,0,100,296151,2975,104
29252,2024,12,12,0,0,100,186625,2193,94
29254,2024,61,51,10,16,84,154600,1851,87
29255,2024,14,14,0,0,100,175314,1934,100
29256,2024,28,8,20,71,29,126017,2687,50
29257,2024,26,24,2,8,92,261854,2617,102
29259,2024,99,76,23,23,77,186257,2128,87
29260,2024,85,51,34,40,60,216373,2407,90
29261,2024,2,2,0,0,100,95500,1419,70
29262,2024,11,11,0,0,100,108218,1200,102
29263,2024,8,7,1,12,88,124742,1488,87
29264,2024,4,4,0,0,100,191704,1861,105
29265,2024,6,6,0,0,100,207200,2004,106
29266,2024,39,39,0,0,100,167897,1886,94
29267,2024,6,6,0,0,100,124000,1560,76
29268,2024,10,9,1,10,90,280878,2524,112
29269,2024,12,12,0,0,100,130690,1618,84
29270,2024,10,10,0,0,100,237037,1983,119
29271,2024,9,9,0,0,100,142156,1529,95
29272,2024,20,20,0,0,100,209858,2040,106
29273,2024,23,23,0,0,100,339709,3079,109
29274,2024,76,76,0,0,100,143304,1491,98
29275,2024,20,20,0,0,100,96045,1436,72
29276,2024,8,8,0,0,100,279479,3074,96
29277,2024,24,24,0,0,100,175596,1732,102
29278,2024,33,33,0,0,100,104165,1237,86
29279,2024,29,29,0,0,100,161064,1747,94
29280,2024,27,26,1,4,96,264326,2597,101
29281,2024,9,9,0,0,100,140846,1492,100
29282,2024,5,5,0,0,100,301640,3016,106
29284,2024,43,41,2,5,95,242455,2863,90
29285,2024,10,10,0,0,100,153898,1705,98
29286,2024,2,2,0,0,100,258000,1850,142
29287,2024,9,9,0,0,100,198201,1602,129
29288,2024,6,6,0,0,100,179823,1883,102
29289,2024,1,1,0,0,100,194000,1357,143
29290,2024,5,5,0,0,100,181654,1900,96
29291,2024,7,7,0,0,100,105567,1124,90
29292,2024,2,2,0,0,100,205000,2400,86
29293,2024,86,78,8,9,91,290840,3035,96
29294,2024,7,7,0,0,100,175556,1830,95
29295,2024,3,3,0,0,100,208167,1669,124
29296,2024,11,11,0,0,100,298635,3055,106
29297,2024,33,31,2,6,94,240792,2263,110
29298,2024,4,4,0,0,100,306795,3120,114
29299,2024,4,4,0,0,100,218290,1642,130
29300,2024,11,11,0,0,100,170406,1944,92
29301,2024,3,3,0,0,100,121333,1147,107
29302,2024,54,54,0,0,100,118587,1441,86
2A001,2024,20,13,7,35,65,443063,3955,114
2A004,2024,651,35,616,95,5,275689,3956,70
2A006,2024,18,16,2,11,89,560629,4529,118
2A008,2024,32,13,19,59,41,573284,6590,85
2A017,2024,13,9,4,31,69,292492,4513,74
2A018,2024,1,1,0,0,100,75000,1364,55
2A024,2024,4,0,4,100,0,44982,669,69
2A026,2024,2,2,0,0,100,160000,4205,41
2A027,2024,3,3,0,0,100,123333,1511,77
2A028,2024,1,0,1,100,0,75130,2424,31
2A031,2024,7,6,1,14,86,102746,1816,62
2A032,2024,25,21,4,16,84,417551,4756,89
2A035,2024,4,4,0,0,100,501250,5590,84
2A040,2024,4,3,1,25,75,162500,3028,62
2A041,2024,46,18,28,61,39,334472,5017,67
2A048,2024,22,6,16,73,27,238029,5251,50
2A056,2024,1,0,1,100,0,40000,1481,27
2A060,2024,2,2,0,0,100,227500,1902,131
2A062,2024,5,4,1,20,80,186200,3468,59
2A065,2024,12,7,5,42,58,274633,4474,67
2A066,2024,2,1,1,50,50,55972,1492,37
2A070,2024,14,6,8,57,43,330276,4941,67
2A071,2024,5,4,1,20,80,167442,2699,68
2A085,2024,10,7,3,30,70,350579,3636,98
2A090,2024,8,3,5,62,38,401511,3914,88
2A091,2024,2,0,2,100,0,45000,682,66
2A092,2024,16,5,11,69,31,210436,4830,47
2A094,2024,1,1,0,0,100,228000,3257,70
2A098,2024,12,11,1,8,92,854292,7174,110
2A099,2024,2,2,0,0,100,49000,675,72
2A103,2024,9,9,0,0,100,377281,3544,108
2A104,2024,7,5,2,29,71,293000,3298,93
2A108,2024,1,1,0,0,100,122500,3062,40
2A114,2024,11,11,0,0,100,362304,4837,82
2A118,2024,1,1,0,0,100,450000,4500,100
2A119,2024,1,1,0,0,100,35000,1029,34
2A128,2024,2,1,1,50,50,39170,676,62
2A130,2024,82,32,50,61,39,405542,6306,63
2A132,2024,2,0,2,100,0,113950,2794,45
2A133,2024,1,1,0,0,100,48000,960,50
2A139,2024,34,21,13,38,62,653740,6253,103
2A141,2024,2,2,0,0,100,230072,2482,90
2A142,2024,6,3,3,50,50,97033,1481,69
2A144,2024,1,1,0,0,100,25600,853,30
2A146,2024,2,2,0,0,100,192985,2412,80
2A154,2024,2,1,1,50,50,57500,599,142
2A160,2024,1,1,0,0,100,308850,3184,97
2A163,2024,5,4,1,20,80,263761,3089,81
2A174,2024,2,2,0,0,100,100375,2846,56
2A181,2024,1,1,0,0,100,250000,3846,65
2A186,2024,1,1,0,0,100,167000,2386,70
2A189,2024,13,11,2,15,85,566113,6381,84
2A197,2024,2,2,0,0,100,130000,2654,48
2A198,2024,8,2,6,75,25,132000,2555,76
2A203,2024,3,3,0,0,100,310643,3515,83
2A209,2024,12,9,3,25,75,328302,4073,77
2A211,2024,9,6,3,33,67,224344,3572,62
2A212,2024,6,4,2,33,67,239078,3189,70
2A215,2024,8,7,1,12,88,956181,7161,101
2A228,2024,26,14,12,46,54,693640,6502,98
2A232,2024,1,0,1,100,0,95000,1267,75
2A240,2024,1,1,0,0,100,233000,2774,84
2A247,2024,159,85,74,47,53,628580,6394,91
2A249,2024,63,13,50,79,21,233662,3876,61
2A254,2024,4,1,3,75,25,102625,1768,44
2A258,2024,4,4,0,0,100,123250,1533,85
2A259,2024,2,2,0,0,100,139900,2282,61
2A262,2024,1,1,0,0,100,159000,1359,117
2A266,2024,1,1,0,0,100,37000,2846,13
2A268,2024,2,1,1,50,50,85000,2072,43
2A269,2024,33,9,24,73,27,249558,3944,68
2A270,2024,2,2,0,0,100,220000,2584,68
2A271,2024,18,5,13,72,28,202340,3224,66
2A272,2024,31,11,20,65,35,290615,3297,76
2A276,2024,8,3,5,62,38,287975,4568,71
2A279,2024,1,1,0,0,100,285000,2850,100
2A284,2024,6,3,3,50,50,189875,2796,79
2A288,2024,5,3,2,40,60,404921,3916,106
2A295,2024,2,2,0,0,100,440550,2816,164
2A300,2024,10,10,0,0,100,712656,6151,106
2A308,2024,4,1,3,75,25,87750,1589,56
2A310,2024,1,1,0,0,100,298000,4139,72
2A312,2024,5,2,3,60,40,190000,3443,73
2A322,2024,2,1,1,50,50,77500,1100,62
2A324,2024,6,5,1,17,83,176008,3344,52
2A326,2024,1,0,1,100,0,140500,2927,48
2A330,2024,4,3,1,25,75,112472,2590,49
2A336,2024,2,0,2,100,0,318000,2368,142
2A345,2024,5,5,0,0,100,320967,3805,90
2A348,2024,9,5,4,44,56,307850,3057,108
2A351,2024,1,1,0,0,100,450000,5625,80
2A357,2024,1,1,0,0,100,40000,851,47
2A359,2024,1,1,0,0,100,25000,781,32
2A362,2024,51,40,11,22,78,778525,6354,110
2B002,2024,2,2,0,0,100,392930,4054,96
2B009,2024,18,10,8,44,56,209858,2310,91
2B010,2024,8,1,7,88,12,433105,5962,64
2B012,2024,1,1,0,0,100,16800,933,18
2B013,2024,1,1,0,0,100,113760,2844,40
2B015,2024,1,0,1,100,0,67000,1218,55
2B016,2024,3,3,0,0,100,208622,2366,110
2B020,2024,2,1,1,50,50,150500,2904,48
2B025,2024,1,0,1,100,0,185000,4625,40
2B029,2024,2,1,1,50,50,456765,4784,100
2B030,2024,5,4,1,20,80,119222,1880,72
2B033,2024,356,19,337,95,5,217018,3076,69
2B034,2024,16,9,7,44,56,199410,4146,50
2B037,2024,48,20,28,58,42,289479,3277,86
2B039,2024,3,3,0,0,100,183627,950,124
2B042,2024,106,40,66,62,38,227461,3274,72
2B043,2024,28,11,17,61,39,411948,4465,82
2B045,2024,1,1,0,0,100,30000,500,60
2B046,2024,6,5,1,17,83,167740,2769,61
2B047,2024,1,0,1,100,0,50000,833,60
2B049,2024,31,23,8,26,74,363384,3493,87
2B050,2024,118,14,104,88,12,312304,5157,58
2B051,2024,1,0,1,100,0,165630,1904,87
2B052,2024,2,1,1,50,50,85000,2731,33
2B053,2024,1,1,0,0,100,37000,374,99
2B054,2024,3,3,0,0,100,98000,1517,76
2B057,2024,4,4,0,0,100,388875,3710,114
2B058,2024,9,7,2,22,78,158444,2791,67
2B059,2024,3,3,0,0,100,226453,2783,69
2B072,2024,1,1,0,0,100,105000,1667,63
2B074,2024,3,3,0,0,100,100333,1146,80
2B075,2024,1,1,0,0,100,77075,1606,48
2B077,2024,7,6,1,14,86,220219,2849,73
2B079,2024,3,2,1,33,67,277257,2712,107
2B083,2024,1,1,0,0,100,121200,1955,62
2B086,2024,4,2,2,50,50,241000,2474,96
2B087,2024,12,4,8,67,33,170441,2696,69
2B088,2024,1,1,0,0,100,447980,4073,110
2B093,2024,12,9,3,25,75,741103,6611,114
2B095,2024,1,1,0,0,100,120000,1224,98
2B096,2024,68,7,61,90,10,139243,3012,52
2B097,2024,2,2,0,0,100,348600,4287,82
2B107,2024,3,3,0,0,100,183233,2719,69
2B109,2024,4,3,1,25,75,117825,2726,52
2B112,2024,3,3,0,0,100,309950,4457,72
2B120,2024,28,13,15,54,46,281836,3243,85
2B121,2024,2,1,1,50,50,274654,1255,196
2B122,2024,1,1,0,0,100,23000,767,30
2B123,2024,26,15,11,42,58,241270,3280,75
2B124,2024,2,1,1,50,50,95000,1588,48
2B134,2024,65,2,63,97,3,246547,4431,57
2B135,2024,6,2,4,67,33,86299,1432,55
2B136,2024,1,1,0,0,100,199265,3985,50
2B138,2024,1,1,0,0,100,300000,3261,92
2B140,2024,3,2,1,33,67,106000,1053,81
2B143,2024,45,11,34,76,24,103566,2577,42
2B145,2024,2,1,1,50,50,186000,1264,155
2B148,2024,61,36,25,41,59,213728,3294,66
2B150,2024,35,7,28,80,20,363713,5610,59
2B152,2024,6,2,4,67,33,105125,2320,54
2B156,2024,1,1,0,0,100,117712,1784,66
2B159,2024,3,2,1,33,67,107208,3321,63
2B162,2024,3,2,1,33,67,172317,1710,109
2B165,2024,4,4,0,0,100,201432,2489,83
2B166,2024,3,2,1,33,67,100257,1368,68
2B167,2024,5,2,3,60,40,177299,3088,60
2B168,2024,21,13,8,38,62,490291,5041,96
2B169,2024,6,4,2,33,67,131747,2075,63
2B172,2024,2,0,2,100,0,193500,2974,64
2B173,2024,1,0,1,100,0,120000,2308,52
2B175,2024,1,1,0,0,100,700000,5600,125
2B178,2024,2,0,2,100,0,152500,2027,64
2B179,2024,2,2,0,0,100,69830,742,95
2B180,2024,1,1,0,0,100,95000,1462,65
2B182,2024,3,2,1,33,67,199167,3121,58
2B184,2024,1,1,0,0,100,185330,2942,63
2B185,2024,22,6,16,73,27,248505,3535,64
2B188,2024,2,1,1,50,50,156000,2972,56
2B190,2024,1,1,0,0,100,51000,607,84
2B193,2024,2,1,1,50,50,82520,1826,43
2B194,2024,1,0,1,100,0,32500,1161,28
2B195,2024,2,2,0,0,100,186300,2380,80
2B199,2024,2,1,1,50,50,201645,2398,84
2B201,2024,4,2,2,50,50,50625,1333,56
2B205,2024,8,2,6,75,25,217927,3818,67
2B207,2024,30,18,12,40,60,257280,2931,88
2B210,2024,2,0,2,100,0,124145,1379,90
2B213,2024,1,1,0,0,100,45000,1286,35
2B217,2024,1,1,0,0,100,15000,417,36
2B218,2024,3,1,2,67,33,61667,975,68
2B219,2024,5,2,3,60,40,68962,814,84
2B220,2024,2,0,2,100,0,40000,636,63
2B222,2024,1,1,0,0,100,40000,667,60
2B223,2024,1,1,0,0,100,100000,714,140
2B224,2024,9,7,2,22,78,248369,3611,69
2B225,2024,5,2,3,60,40,128201,1196,88
2B229,2024,5,4,1,20,80,201860,3376,63
2B233,2024,1,1,0,0,100,390000,5342,73
2B235,2024,2,2,0,0,100,125000,2440,52
2B238,2024,2,0,2,100,0,43500,1212,39
2B239,2024,2,1,1,50,50,335000,2398,136
2B242,2024,28,12,16,57,43,123080,3353,37
2B245,2024,2,2,0,0,100,219535,3311,70
2B246,2024,2,0,2,100,0,123700,2244,56
2B250,2024,2,1,1,50,50,229772,2687,79
2B251,2024,31,25,6,19,81,243523,2916,83
2B261,2024,5,4,1,20,80,270784,3031,92
2B264,2024,1,1,0,0,100,20000,588,34
2B265,2024,1,1,0,0,100,322000,2368,136
2B267,2024,1,0,1,100,0,110000,846,130
2B274,2024,1,1,0,0,100,154000,1901,81
2B275,2024,1,1,0,0,100,87500,2188,40
2B277,2024,2,2,0,0,100,283152,3043,98
2B280,2024,1,0,1,100,0,225000,2473,91
2B281,2024,18,14,4,22,78,227853,3004,81
2B283,2024,5,4,1,20,80,170880,2943,61
2B286,2024,6,2,4,67,33,225612,2955,77
2B287,2024,2,1,1,50,50,67500,1962,34
2B290,2024,3,1,2,67,33,146206,2243,66
2B291,2024,2,1,1,50,50,42500,996,49
2B292,2024,1,1,0,0,100,40000,889,45
2B293,2024,1,0,1,100,0,100000,1667,60
2B298,2024,21,6,15,71,29,284876,4801,61
2B299,2024,3,2,1,33,67,68747,1637,68
2B301,2024,1,0,1,100,0,20000,333,60
2B302,2024,1,1,0,0,100,144000,1286,112
2B303,2024,3,1,2,67,33,151500,2612,59
2B304,2024,1,1,0,0,100,59686,635,94
2B305,2024,28,8,20,71,29,296364,3431,86
2B306,2024,2,2,0,0,100,125000,2012,65
2B307,2024,31,11,20,65,35,175532,2835,61
2B309,2024,8,3,5,62,38,314296,3288,96
2B311,2024,8,6,2,25,75,260070,4047,67
2B313,2024,55,9,46,84,16,137699,3153,46
2B314,2024,3,3,0,0,100,184703,2474,76
2B315,2024,1,1,0,0,100,325720,1939,168
2B316,2024,10,6,4,40,60,402616,4055,96
2B317,2024,1,1,0,0,100,140000,2545,55
2B318,2024,3,2,1,33,67,250333,2416,94
2B319,2024,3,3,0,0,100,365000,3294,116
2B320,2024,2,1,1,50,50,150000,1281,95
2B327,2024,3,1,2,67,33,266053,2688,117
2B328,2024,3,2,1,33,67,165483,2097,78
2B329,2024,2,0,2,100,0,55000,886,60
2B332,2024,3,1,2,67,33,63233,1625,40
2B335,2024,1,1,0,0,100,36165,1205,30
2B337,2024,1,0,1,100,0,115000,958,120
2B340,2024,4,3,1,25,75,168775,2526,62
2B341,2024,4,1,3,75,25,128250,1822,71
2B342,2024,16,15,1,6,94,332134,2873,119
2B343,2024,13,8,5,38,62,148194,2468,57
2B346,2024,15,9,6,40,60,253625,2874,82
2B347,2024,2,2,0,0,100,60000,2462,40
2B350,2024,1,1,0,0,100,390000,3545,110
2B352,2024,3,3,0,0,100,316943,4337,81
2B353,2024,28,5,23,82,18,279995,3589,80
2B354,2024,1,1,0,0,100,380000,2621,145
2B355,2024,1,1,0,0,100,259000,2376,109
2B361,2024,2,2,0,0,100,427500,3420,128
30001,2024,4,4,0,0,100,406994,3782,109
30002,2024,7,7,0,0,100,246404,2394,102
30003,2024,113,95,18,16,84,336184,4276,81
30004,2024,22,19,3,14,86,313901,2896,111
30005,2024,3,2,1,33,67,230517,2823,88
30006,2024,66,55,11,17,83,247599,2890,87
30007,2024,505,228,277,55,45,140354,1796,77
30008,2024,10,10,0,0,100,155478,2070,84
30009,2024,6,5,1,17,83,111843,1456,68
30010,2024,29,21,8,28,72,200606,2098,90
30011,2024,102,60,42,41,59,281100,3362,84
30012,2024,37,29,8,22,78,265304,2877,87
30013,2024,5,5,0,0,100,327824,2769,114
30014,2024,11,11,0,0,100,383563,3729,101
30015,2024,2,2,0,0,100,142000,2292,69
30016,2024,3,3,0,0,100,90000,1625,57
30017,2024,3,3,0,0,100,138683,1051,131
30018,2024,3,1,2,67,33,217820,2608,84
30019,2024,32,27,5,16,84,341302,3236,107
30020,2024,19,17,2,11,89,248532,2612,98
30021,2024,3,3,0,0,100,338143,3826,92
30022,2024,5,5,0,0,100,154360,2682,90
30023,2024,9,9,0,0,100,380588,3427,114
30024,2024,8,7,1,12,88,128562,1407,85
30025,2024,15,11,4,27,73,152777,1729,92
30026,2024,18,15,3,17,83,197180,1960,107
30027,2024,25,22,3,12,88,247122,2553,95
30028,2024,185,108,77,42,58,160458,1927,80
30029,2024,26,21,5,19,81,261390,2714,92
30030,2024,4,4,0,0,100,352315,3326,102
30031,2024,6,6,0,0,100,453933,3529,116
30032,2024,144,79,65,45,55,136601,1730,79
30033,2024,51,41,10,20,80,238520,2734,88
30034,2024,47,41,6,13,87,265569,2976,91
30035,2024,7,7,0,0,100,224496,2684,87
30036,2024,30,27,3,10,90,251446,2870,91
30037,2024,28,16,12,43,57,117519,1532,77
30038,2024,6,4,2,33,67,121532,1919,65
30039,2024,9,7,2,22,78,240676,2951,83
30040,2024,2,2,0,0,100,232500,2062,101
30041,2024,20,20,0,0,100,377297,3470,106
30042,2024,17,17,0,0,100,294800,2498,114
30043,2024,6,6,0,0,100,253240,2135,116
30045,2024,3,1,2,67,33,92392,1014,82
30046,2024,8,8,0,0,100,178012,2510,87
30047,2024,55,43,12,22,78,211262,2506,88
30048,2024,4,4,0,0,100,335950,3094,116
30049,2024,7,7,0,0,100,388717,3975,97
30050,2024,1,1,0,0,100,337250,4324,78
30051,2024,9,6,3,33,67,82052,1309,62
30052,2024,9,9,0,0,100,151920,2253,78
30053,2024,3,3,0,0,100,125000,1693,74
30054,2024,4,4,0,0,100,348375,2560,144
30055,2024,4,4,0,0,100,118500,1733,71
30056,2024,5,5,0,0,100,304428,2775,105
30057,2024,12,12,0,0,100,277540,2924,94
30059,2024,16,16,0,0,100,331343,3074,109
30060,2024,33,29,4,12,88,263723,2646,101
30061,2024,23,16,7,30,70,198412,2373,83
30062,2024,82,48,34,41,59,238790,3370,76
30064,2024,4,4,0,0,100,190856,2256,87
30065,2024,5,5,0,0,100,217386,2274,95
30066,2024,3,3,0,0,100,278443,2362,116
30067,2024,6,6,0,0,100,279717,2467,110
30068,2024,5,5,0,0,100,258220,2421,101
30069,2024,6,6,0,0,100,303025,3037,102
30070,2024,6,6,0,0,100,280335,2717,102
30071,2024,3,3,0,0,100,232733,2346,101
30072,2024,4,4,0,0,100,287790,2561,113
30073,2024,18,17,1,6,94,388819,3490,116
30075,2024,35,30,5,14,86,303643,3041,99
30076,2024,9,8,1,11,89,201633,2513,84
30077,2024,7,7,0,0,100,222471,2505,96
30079,2024,3,3,0,0,100,182120,1601,106
30080,2024,15,11,4,27,73,80295,1137,67
30081,2024,11,11,0,0,100,253207,2712,101
30082,2024,51,49,2,4,96,254143,2481,101
30083,2024,28,28,0,0,100,284070,3042,96
30084,2024,3,1,2,67,33,143470,1591,90
30085,2024,12,12,0,0,100,309114,3203,93
30086,2024,6,6,0,0,100,282000,2433,110
30087,2024,5,5,0,0,100,151978,1708,89
30088,2024,8,8,0,0,100,250600,2479,110
30089,2024,14,13,1,7,93,227406,2308,99
30090,2024,8,7,1,12,88,118074,1686,73
30091,2024,12,12,0,0,100,282866,2882,98
30092,2024,29,25,4,14,86,218752,2524,90
30095,2024,13,13,0,0,100,325707,3068,104
30096,2024,13,13,0,0,100,216798,3525,84
30097,2024,2,2,0,0,100,294300,2089,145
30098,2024,13,13,0,0,100,362250,2818,129
30099,2024,6,6,0,0,100,308335,2331,123
30100,2024,4,4,0,0,100,256455,2455,102
30101,2024,3,3,0,0,100,168033,2360,72
30102,2024,6,5,1,17,83,92103,1416,65
30103,2024,9,8,1,11,89,296682,2839,105
30104,2024,5,5,0,0,100,399782,2535,155
30105,2024,5,4,1,20,80,98640,1439,68
30106,2024,6,6,0,0,100,182018,1398,130
30107,2024,7,7,0,0,100,442500,3661,94
30108,2024,1,1,0,0,100,146350,665,220
30109,2024,2,1,1,50,50,201250,2846,85
30110,2024,8,8,0,0,100,537338,3048,145
30111,2024,3,3,0,0,100,349793,2873,120
30112,2024,18,18,0,0,100,267048,2677,101
30114,2024,8,8,0,0,100,288731,2198,128
30115,2024,1,1,0,0,100,226900,2701,84
30116,2024,8,7,1,12,88,297317,3325,86
30117,2024,15,14,1,7,93,228068,2695,86
30120,2024,16,11,5,31,69,150188,1830,81
30121,2024,3,3,0,0,100,308283,3061,101
30122,2024,3,3,0,0,100,208867,2334,88
30123,2024,33,26,7,21,79,239153,2774,86
30124,2024,3,2,1,33,67,174167,2676,64
30125,2024,40,30,10,25,75,228777,2544,93
30126,2024,7,7,0,0,100,388667,3369,115
30127,2024,12,12,0,0,100,200487,2412,83
30128,2024,46,39,7,15,85,199225,2310,85
30129,2024,6,6,0,0,100,185103,2162,84
30130,2024,15,12,3,20,80,120428,1706,75
30131,2024,10,8,2,20,80,260038,2586,110
30132,2024,37,19,18,49,51,85898,1148,75
30133,2024,669,39,630,94,6,202767,5276,38
30134,2024,9,9,0,0,100,287996,2579,117
30135,2024,33,26,7,21,79,218053,2253,100
30136,2024,12,12,0,0,100,320756,2957,108
30138,2024,19,18,1,5,95,319197,2939,103
30139,2024,4,4,0,0,100,92500,980,86
30140,2024,10,9,1,10,90,182668,1822,98
30141,2024,54,47,7,13,87,222215,2468,91
30142,2024,6,5,1,17,83,169055,1550,106
30144,2024,3,2,1,33,67,181567,4395,84
30145,2024,13,12,1,8,92,278285,2668,106
30146,2024,9,8,1,11,89,188430,1774,104
30147,2024,14,12,2,14,86,185549,1957,90
30148,2024,4,4,0,0,100,202250,2310,82
30149,2024,4,4,0,0,100,467600,4067,108
30150,2024,3,3,0,0,100,538202,2815,146
30151,2024,8,7,1,12,88,316398,2538,126
30152,2024,30,29,1,3,97,203532,2125,95
30153,2024,2,2,0,0,100,257500,2010,148
30154,2024,8,7,1,12,88,112432,1202,92
30155,2024,66,62,4,6,94,252128,2707,97
30156,2024,81,65,16,20,80,222726,2517,90
30158,2024,1,1,0,0,100,147500,3512,42
30159,2024,11,9,2,18,82,141700,1685,90
30160,2024,4,3,1,25,75,260800,4081,95
30161,2024,2,2,0,0,100,175815,1890,92
30162,2024,4,3,1,25,75,202832,2168,96
30163,2024,3,3,0,0,100,172000,2800,64
30164,2024,28,28,0,0,100,184890,2626,67
30165,2024,6,6,0,0,100,287717,2152,130
30166,2024,16,14,2,12,88,223893,2696,82
30167,2024,6,6,0,0,100,230345,2458,99
30168,2024,10,10,0,0,100,236318,2507,94
30169,2024,56,48,8,14,86,212634,2425,87
30170,2024,14,12,2,14,86,122101,2007,74
30171,2024,15,9,6,40,60,154580,1609,91
30172,2024,8,8,0,0,100,194806,2333,80
30173,2024,20,20,0,0,100,226610,2211,105
30174,2024,17,16,1,6,94,517651,4206,117
30175,2024,1,1,0,0,100,185000,2569,72
30176,2024,9,9,0,0,100,104092,1372,75
30177,2024,3,3,0,0,100,228333,2212,116
30178,2024,15,14,1,7,93,232525,2417,94
30179,2024,46,44,2,4,96,213630,2260,96
30180,2024,3,3,0,0,100,297667,3221,92
30181,2024,4,4,0,0,100,242362,2687,96
30182,2024,18,17,1,6,94,228920,2398,93
30183,2024,7,5,2,29,71,149530,2144,70
30184,2024,12,12,0,0,100,211725,2139,94
30185,2024,14,13,1,7,93,265039,3178,81
30186,2024,11,11,0,0,100,339410,3212,107
30187,2024,3,3,0,0,100,110799,1639,72
30188,2024,5,5,0,0,100,145000,1526,91
30189,2024,1954,475,1479,76,24,165953,2348,69
30191,2024,15,15,0,0,100,206295,2245,90
30192,2024,5,5,0,0,100,299165,3355,92
30193,2024,3,3,0,0,100,335680,2784,118
30194,2024,4,4,0,0,100,176290,2466,73
30196,2024,2,2,0,0,100,212875,2926,70
30198,2024,3,3,0,0,100,145947,1444,100
30200,2024,10,10,0,0,100,235279,2293,96
30201,2024,5,5,0,0,100,112400,1642,77
30202,2024,125,75,50,40,60,153685,1916,81
30203,2024,7,7,0,0,100,179654,1710,96
30204,2024,8,8,0,0,100,236884,2232,103
30205,2024,2,2,0,0,100,545725,3239,168
30206,2024,26,25,1,4,96,357852,3756,106
30207,2024,7,6,1,14,86,247393,2492,106
30209,2024,36,34,2,6,94,400496,3513,111
30210,2024,28,22,6,21,79,212619,2671,88
30211,2024,30,28,2,7,93,253127,2718,96
30212,2024,20,16,4,20,80,198113,2286,90
30214,2024,23,21,2,9,91,197232,1931,104
30215,2024,1,1,0,0,100,210000,2234,94
30216,2024,8,7,1,12,88,127162,1279,101
30217,2024,73,66,7,10,90,323949,3240,100
30218,2024,5,5,0,0,100,314394,2737,109
30219,2024,3,3,0,0,100,151333,1937,78
30221,2024,44,40,4,9,91,208823,2405,85
30222,2024,4,4,0,0,100,347690,3266,146
30223,2024,36,35,1,3,97,230150,2449,94
30224,2024,2,2,0,0,100,122000,2248,60
30225,2024,18,18,0,0,100,373416,3188,123
30226,2024,6,6,0,0,100,370110,2925,126
30227,2024,52,40,12,23,77,160386,1816,82
30228,2024,13,12,1,8,92,264852,2351,104
30229,2024,11,11,0,0,100,238710,2731,88
30230,2024,6,6,0,0,100,256917,3068,84
30231,2024,13,11,2,15,85,180690,1717,97
30232,2024,3,3,0,0,100,354183,2679,127
30233,2024,3,2,1,33,67,195947,3333,71
30234,2024,2,2,0,0,100,266470,3500,82
30235,2024,9,8,1,11,89,226508,2356,101
30236,2024,2,2,0,0,100,201000,2763,84
30237,2024,8,8,0,0,100,223681,2493,93
30238,2024,1,1,0,0,100,112500,2812,40
30239,2024,3,3,0,0,100,140165,3859,48
30240,2024,4,4,0,0,100,219625,3116,70
30241,2024,15,12,3,20,80,247953,2308,110
30242,2024,4,4,0,0,100,292250,2283,144
30243,2024,62,44,18,29,71,192299,2193,88
30244,2024,5,5,0,0,100,402738,3627,107
30245,2024,2,2,0,0,100,256850,2516,104
30246,2024,1,1,0,0,100,130000,2031,64
30247,2024,4,4,0,0,100,277385,2260,115
30248,2024,3,3,0,0,100,219882,2066,96
30249,2024,5,4,1,20,80,278040,3109,108
30250,2024,4,4,0,0,100,293582,2325,124
30251,2024,6,5,1,17,83,163368,1867,86
30252,2024,2,2,0,0,100,82225,1111,70
30253,2024,14,10,4,29,71,195377,2047,99
30254,2024,17,17,0,0,100,224097,2306,96
30255,2024,32,24,8,25,75,188163,1996,97
30256,2024,6,6,0,0,100,216007,2297,92
30257,2024,15,14,1,7,93,240412,2822,86
30258,2024,135,97,38,28,72,163284,2072,79
30259,2024,39,37,2,5,95,244921,2345,107
30260,2024,12,12,0,0,100,300706,2981,102
30261,2024,1,1,0,0,100,369150,3026,122
30262,2024,4,4,0,0,100,394500,3290,113
30263,2024,42,35,7,17,83,207515,2213,90
30264,2024,1,1,0,0,100,75000,2143,35
30266,2024,5,5,0,0,100,205770,2383,96
30267,2024,5,5,0,0,100,196180,1539,118
30268,2024,6,4,2,33,67,152183,1515,86
30269,2024,32,18,14,44,56,147695,2199,67
30270,2024,14,14,0,0,100,207957,2166,97
30271,2024,2,2,0,0,100,311350,2436,130
30272,2024,1,1,0,0,100,115000,799,144
30273,2024,20,19,1,5,95,235191,2593,95
30274,2024,31,29,2,6,94,204100,2130,99
30275,2024,2,2,0,0,100,170000,1374,123
30276,2024,42,36,6,14,86,321703,3604,89
30277,2024,6,6,0,0,100,282933,2534,115
30278,2024,22,21,1,5,95,304566,2866,108
30279,2024,9,9,0,0,100,234392,2756,83
30280,2024,12,12,0,0,100,151405,1249,122
30281,2024,14,13,1,7,93,241200,2628,93
30282,2024,8,8,0,0,100,185155,2278,82
30284,2024,29,27,2,7,93,189559,2042,95
30285,2024,3,3,0,0,100,181084,1678,105
30286,2024,15,15,0,0,100,394841,3942,102
30287,2024,9,8,1,11,89,282547,2589,114
30288,2024,9,5,4,44,56,287833,3089,96
30290,2024,12,12,0,0,100,278379,2508,112
30291,2024,5,5,0,0,100,289960,3243,91
30292,2024,6,6,0,0,100,273654,2860,101
30293,2024,3,3,0,0,100,243217,2353,106
30294,2024,51,42,9,18,82,204716,2162,96
30295,2024,49,44,5,10,90,377781,3668,102
30296,2024,3,3,0,0,100,166667,2200,91
30297,2024,9,9,0,0,100,239443,3097,78
30298,2024,3,3,0,0,100,215150,2226,97
30299,2024,16,16,0,0,100,458549,3624,130
30300,2024,3,3,0,0,100,279567,2750,102
30301,2024,4,4,0,0,100,812200,4544,161
30302,2024,10,10,0,0,100,359108,2981,110
30303,2024,9,9,0,0,100,211400,2147,99
30304,2024,5,5,0,0,100,372415,2445,165
30305,2024,31,26,5,16,84,183633,2024,89
30306,2024,8,8,0,0,100,242295,2669,88
30307,2024,15,15,0,0,100,119902,1620,76
30308,2024,8,8,0,0,100,325998,3173,107
30309,2024,1,1,0,0,100,254200,2250,113
30310,2024,1,1,0,0,100,220000,917,240
30311,2024,27,17,10,37,63,200004,2099,91
30312,2024,17,16,1,6,94,339581,3070,117
30313,2024,8,7,1,12,88,248489,2592,98
30314,2024,4,4,0,0,100,183788,2413,92
30315,2024,14,12,2,14,86,242692,2816,88
30316,2024,4,4,0,0,100,272000,2296,110
30317,2024,24,23,1,4,96,172356,1953,86
30318,2024,1,1,0,0,100,100000,1923,52
30319,2024,9,8,1,11,89,347708,3171,111
30320,2024,1,1,0,0,100,202520,2132,95
30321,2024,62,44,18,29,71,244717,2591,92
30322,2024,2,2,0,0,100,303950,3026,101
30323,2024,2,2,0,0,100,78250,2006,37
30324,2024,12,11,1,8,92,266442,2554,104
30325,2024,18,15,3,17,83,118786,1734,70
30326,2024,16,15,1,6,94,252533,2808,90
30327,2024,1,1,0,0,100,17500,1458,12
30328,2024,6,5,1,17,83,216047,2686,80
30329,2024,1,1,0,0,100,90000,2045,44
30330,2024,8,8,0,0,100,271568,2077,133
30331,2024,13,13,0,0,100,255942,2521,111
30332,2024,2,2,0,0,100,45450,731,62
30333,2024,50,44,6,12,88,239950,2687,89
30334,2024,166,77,89,54,46,321674,3821,82
30335,2024,1,1,0,0,100,229000,1974,116
30336,2024,19,16,3,16,84,247240,2738,89
30337,2024,10,10,0,0,100,385325,3278,117
30338,2024,1,1,0,0,100,437020,3735,117
30339,2024,27,15,12,44,56,106194,1720,65
30340,2024,3,3,0,0,100,285567,2510,112
30341,2024,109,88,21,19,81,214047,2556,86
30342,2024,14,11,3,21,79,221356,2153,100
30343,2024,6,6,0,0,100,290968,2479,127
30344,2024,54,44,10,19,81,275013,3105,91
30345,2024,6,5,1,17,83,102450,1675,59
30346,2024,24,20,4,17,83,281049,3185,91
30347,2024,18,18,0,0,100,309421,3151,105
30348,2024,11,11,0,0,100,235195,2553,94
30349,2024,6,5,1,17,83,298470,2572,116
30350,2024,49,20,29,59,41,110858,1387,77
30351,2024,173,111,62,36,64,340371,3808,92
30352,2024,24,20,4,17,83,286643,3104,94
30353,2024,1,1,0,0,100,350330,2336,150
30354,2024,3,3,0,0,100,215317,2232,95
30355,2024,15,15,0,0,100,293524,2683,110
30356,2024,26,25,1,4,96,265282,2817,88
31001,2024,1,1,0,0,100,484265,2026,239
31002,2024,1,1,0,0,100,150000,1667,90
31003,2024,8,7,1,12,88,431716,3469,129
31004,2024,34,32,2,6,94,254837,2595,100
31005,2024,6,6,0,0,100,177895,1228,148
31006,2024,1,1,0,0,100,160000,1006,159
31007,2024,1,1,0,0,100,290000,1933,150
31008,2024,2,2,0,0,100,318425,1344,260
31010,2024,4,4,0,0,100,221732,1742,143
31011,2024,6,6,0,0,100,116417,1497,92
31012,2024,2,2,0,0,100,59850,796,75
31014,2024,1,1,0,0,100,87500,972,90
31015,2024,3,3,0,0,100,106217,1197,94
31017,2024,3,3,0,0,100,129317,1463,83
31018,2024,1,1,0,0,100,157750,1502,105
31020,2024,21,21,0,0,100,140904,1236,113
31022,2024,114,38,76,67,33,179743,2686,67
31023,2024,3,3,0,0,100,103183,913,113
31024,2024,2,2,0,0,100,200575,2515,78
31025,2024,5,5,0,0,100,446732,3172,138
31026,2024,5,5,0,0,100,145680,1726,80
31027,2024,3,3,0,0,100,170333,1862,85
31028,2024,24,14,10,42,58,113862,1322,85
31029,2024,1,1,0,0,100,295810,2275,130
31030,2024,1,1,0,0,100,232350,2300,101
31031,2024,8,7,1,12,88,157735,1935,78
31032,2024,51,37,14,27,73,267654,2725,98
31033,2024,102,54,48,47,53,170831,2163,79
31034,2024,1,1,0,0,100,290000,1706,170
31035,2024,39,16,23,59,41,218720,3305,69
31036,2024,10,9,1,10,90,355728,3387,106
31037,2024,18,16,2,11,89,211226,2161,94
31038,2024,7,7,0,0,100,313959,2275,129
31041,2024,1,1,0,0,100,109310,1093,100
31042,2024,156,21,135,87,13,121235,2492,52
31043,2024,2,2,0,0,100,136848,837,150
31044,2024,183,77,106,58,42,327583,3547,90
31045,2024,6,6,0,0,100,167407,1599,110
31046,2024,1,1,0,0,100,118000,2458,48
31047,2024,1,1,0,0,100,262178,1441,182
31048,2024,51,50,1,2,98,261865,2674,93
31049,2024,8,8,0,0,100,267209,3010,99
31050,2024,4,4,0,0,100,139000,1636,89
31051,2024,4,4,0,0,100,273678,2048,136
31052,2024,14,14,0,0,100,215386,2150,101
31053,2024,5,5,0,0,100,372220,3079,138
31054,2024,4,4,0,0,100,156425,1995,92
31055,2024,1,1,0,0,100,344000,2324,148
31056,2024,63,30,33,52,48,240445,3069,76
31057,2024,12,11,1,8,92,377609,3096,125
31059,2024,1,1,0,0,100,230000,2556,90
31061,2024,1,1,0,0,100,177000,2529,70
31062,2024,1,1,0,0,100,226400,2156,105
31063,2024,2,2,0,0,100,374774,1730,198
31065,2024,20,19,1,5,95,234604,2369,99
31066,2024,56,38,18,32,68,216916,2379,90
31067,2024,2,2,0,0,100,88180,1042,86
31068,2024,2,2,0,0,100,348800,5700,85
31069,2024,307,102,205,67,33,246900,3202,77
31070,2024,7,7,0,0,100,107307,1285,90
31071,2024,2,2,0,0,100,301225,2416,124
31073,2024,3,3,0,0,100,171000,2062,78
31074,2024,4,4,0,0,100,388850,3280,118
31075,2024,10,10,0,0,100,361174,3487,129
31076,2024,5,5,0,0,100,197620,1614,124
31077,2024,2,2,0,0,100,223333,1583,142
31078,2024,4,4,0,0,100,156460,1115,140
31079,2024,55,54,1,2,98,257842,2593,100
31080,2024,14,14,0,0,100,110212,1359,76
31081,2024,1,1,0,0,100,193800,2982,65
31082,2024,11,11,0,0,100,168136,1783,106
31083,2024,1,1,0,0,100,112000,800,140
31084,2024,10,9,1,10,90,163083,1755,108
31085,2024,18,14,4,22,78,96829,1712,66
31087,2024,3,3,0,0,100,164126,1506,106
31088,2024,21,18,3,14,86,343461,3092,108
31089,2024,4,4,0,0,100,408166,2520,157
31090,2024,5,5,0,0,100,172790,1829,92
31091,2024,58,31,27,47,53,232120,2855,85
31092,2024,1,1,0,0,100,103000,636,162
31093,2024,10,10,0,0,100,185790,1686,115
31094,2024,30,27,3,10,90,254345,2497,104
31095,2024,1,1,0,0,100,238850,1493,160
31097,2024,4,4,0,0,100,211038,1665,142
31098,2024,10,10,0,0,100,226995,1880,122
31099,2024,4,3,1,25,75,172775,3413,71
31100,2024,26,26,0,0,100,155570,1683,92
31101,2024,2,2,0,0,100,296410,2126,138
31102,2024,2,2,0,0,100,211385,1786,130
31104,2024,1,1,0,0,100,241077,2296,105
31105,2024,1,1,0,0,100,70000,636,110
31106,2024,21,20,1,5,95,238939,2346,108
31107,2024,45,39,6,13,87,212142,2186,104
31108,2024,4,4,0,0,100,191543,1678,135
31109,2024,10,10,0,0,100,191978,1637,114
31110,2024,10,10,0,0,100,122857,1568,85
31111,2024,3,3,0,0,100,98333,1531,63
31112,2024,2,2,0,0,100,169895,1622,104
31113,2024,158,49,109,69,31,227580,3082,74
31114,2024,3,3,0,0,100,198100,1540,128
31116,2024,125,78,47,38,62,234963,2840,82
31117,2024,31,29,2,6,94,367972,3242,118
31118,2024,96,55,41,43,57,224192,2645,84
31120,2024,4,4,0,0,100,413019,2200,191
31121,2024,1,1,0,0,100,60000,429,140
31122,2024,1,1,0,0,100,162875,905,180
31123,2024,1,1,0,0,100,285000,3608,79
31124,2024,2,2,0,0,100,117052,1013,116
31126,2024,7,7,0,0,100,250401,1992,141
31127,2024,1,1,0,0,100,175001,1389,126
31128,2024,6,6,0,0,100,191358,1742,130
31129,2024,1,1,0,0,100,80000,941,85
31130,2024,3,3,0,0,100,181067,1362,135
31131,2024,6,6,0,0,100,141333,1398,100
31133,2024,1,1,0,0,100,98900,1236,80
31135,2024,71,53,18,25,75,152512,1870,84
31136,2024,16,11,5,31,69,243080,2874,83
31138,2024,3,3,0,0,100,139967,1191,127
31139,2024,1,1,0,0,100,135000,1421,95
31140,2024,2,2,0,0,100,203750,1557,125
31141,2024,1,1,0,0,100,135000,1378,98
31142,2024,6,6,0,0,100,170709,2312,94
31143,2024,4,4,0,0,100,131920,1142,116
31144,2024,16,15,1,6,94,105460,1350,80
31145,2024,28,26,2,7,93,197012,2206,95
31147,2024,1,1,0,0,100,290000,2320,125
31148,2024,4,4,0,0,100,471771,3345,150
31149,2024,411,159,252,61,39,218685,2670,80
31150,2024,96,60,36,38,62,257148,2923,85
31151,2024,7,7,0,0,100,398811,3373,119
31153,2024,5,5,0,0,100,118702,1297,89
31155,2024,3,3,0,0,100,222667,1937,129
31156,2024,8,8,0,0,100,164336,1191,145
31157,2024,215,108,107,50,50,228711,2724,84
31158,2024,1,0,1,100,0,53000,1178,45
31159,2024,3,3,0,0,100,105750,978,109
31160,2024,18,14,4,22,78,290329,2653,113
31162,2024,8,8,0,0,100,328548,3007,112
31163,2024,20,17,3,15,85,356982,3024,120
31164,2024,3,3,0,0,100,365128,2165,159
31165,2024,77,58,19,25,75,259285,2681,95
31166,2024,1,1,0,0,100,269300,2720,99
31167,2024,10,10,0,0,100,111116,1212,103
31168,2024,1,1,0,0,100,150000,1579,95
31169,2024,58,37,21,36,64,287078,3031,93
31170,2024,2,2,0,0,100,100000,738,136
31171,2024,2,2,0,0,100,211320,1924,131
31174,2024,5,5,0,0,100,140800,1419,108
31175,2024,4,4,0,0,100,105500,1123,91
31176,2024,2,2,0,0,100,50000,722,62
31177,2024,1,1,0,0,100,299775,1774,169
31178,2024,4,4,0,0,100,163898,1774,103
31179,2024,1,1,0,0,100,200000,2128,94
31181,2024,26,23,3,12,88,259577,2564,100
31182,2024,62,26,36,58,42,184487,2472,75
31183,2024,3,3,0,0,100,110033,1112,89
31184,2024,10,8,2,20,80,320369,3300,99
31185,2024,1,1,0,0,100,186500,1743,107
31186,2024,38,16,22,58,42,189447,2667,71
31187,2024,133,89,44,33,67,246782,2679,90
31188,2024,42,40,2,5,95,298229,2513,118
31189,2024,1,1,0,0,100,259825,2451,106
31190,2024,9,9,0,0,100,105915,1458,80
31191,2024,5,5,0,0,100,119690,1808,73
31192,2024,9,9,0,0,100,296394,2792,105
31193,2024,20,19,1,5,95,159152,1566,108
31194,2024,3,3,0,0,100,294187,2175,143
31196,2024,2,2,0,0,100,122228,1438,85
31197,2024,4,4,0,0,100,195112,1496,120
31199,2024,7,7,0,0,100,115441,1312,91
31200,2024,4,4,0,0,100,87325,858,104
31202,2024,55,45,10,18,82,239354,2297,104
31203,2024,96,61,35,36,64,225687,2761,84
31204,2024,1,1,0,0,100,260000,1529,170
31205,2024,45,14,31,69,31,189289,2888,68
31206,2024,14,14,0,0,100,176296,1844,98
31207,2024,4,4,0,0,100,102621,1334,78
31208,2024,4,4,0,0,100,143000,1553,92
31209,2024,2,2,0,0,100,156000,1578,100
31210,2024,24,18,6,25,75,228335,2388,96
31211,2024,3,3,0,0,100,371883,2175,150
31212,2024,18,17,1,6,94,280258,2678,106
31215,2024,1,1,0,0,100,354200,2643,134
31216,2024,3,2,1,33,67,232767,2307,105
31219,2024,3,3,0,0,100,192372,1567,129
31220,2024,2,2,0,0,100,151850,2576,67
31221,2024,11,0,11,100,0,82466,2169,38
31222,2024,1,1,0,0,100,74500,1490,50
31224,2024,15,12,3,20,80,98434,1128,93
31227,2024,6,6,0,0,100,343269,2923,107
31228,2024,23,14,9,39,61,315596,3236,97
31229,2024,7,7,0,0,100,237758,1978,110
31230,2024,64,58,6,9,91,268563,2846,98
31231,2024,6,6,0,0,100,260331,2220,126
31232,2024,102,67,35,34,66,211819,2394,90
31233,2024,7,7,0,0,100,262500,2371,113
31234,2024,5,5,0,0,100,282310,1945,145
31235,2024,1,1,0,0,100,152210,2174,70
31236,2024,1,1,0,0,100,216350,1833,118
31237,2024,2,2,0,0,100,95000,890,122
31238,2024,6,6,0,0,100,128133,1631,82
31239,2024,25,25,0,0,100,130576,1226,110
31240,2024,3,3,0,0,100,337409,2936,113
31241,2024,6,6,0,0,100,172737,1315,150
31245,2024,3,3,0,0,100,193000,1865,119
31246,2024,8,8,0,0,100,154988,1299,120
31247,2024,20,20,0,0,100,138882,1366,113
31248,2024,51,46,5,10,90,269481,2867,95
31249,2024,5,5,0,0,100,305833,2948,111
31250,2024,6,6,0,0,100,203173,1900,112
31251,2024,2,2,0,0,100,147000,1860,69
31252,2024,21,20,1,5,95,263647,2762,96
31253,2024,20,17,3,15,85,234011,2681,88
31254,2024,25,20,5,20,80,357219,3361,107
31255,2024,2,2,0,0,100,132950,2629,56
31256,2024,1,1,0,0,100,332400,2702,123
31258,2024,3,3,0,0,100,167512,3065,70
31259,2024,23,18,5,22,78,392390,3467,110
31261,2024,13,13,0,0,100,190477,1856,100
31262,2024,5,5,0,0,100,210270,2047,108
31263,2024,15,15,0,0,100,309105,2349,136
31264,2024,3,3,0,0,100,239143,1940,127
31265,2024,3,3,0,0,100,144000,1333,105
31267,2024,2,2,0,0,100,99300,1146,96
31268,2024,2,2,0,0,100,254657,2006,128
31269,2024,9,9,0,0,100,297446,2636,117
31270,2024,11,11,0,0,100,202809,1900,112
31271,2024,14,13,1,7,93,290661,2587,125
31272,2024,2,2,0,0,100,133000,1534,85
31273,2024,14,14,0,0,100,389207,2884,133
31274,2024,1,1,0,0,100,106000,981,108
31275,2024,1,1,0,0,100,25184,350,72
31276,2024,7,7,0,0,100,139400,962,146
31277,2024,8,8,0,0,100,268444,2385,115
31278,2024,4,4,0,0,100,252855,2268,116
31280,2024,6,6,0,0,100,139260,1195,111
31281,2024,19,19,0,0,100,200582,2269,91
31282,2024,86,45,41,48,52,203823,2695,75
31283,2024,2,2,0,0,100,275100,2539,105
31284,2024,8,8,0,0,100,556981,3361,166
31285,2024,8,7,1,12,88,302567,2886,109
31286,2024,4,4,0,0,100,176152,1700,96
31287,2024,58,49,9,16,84,216388,2439,89
31289,2024,3,3,0,0,100,176967,1472,119
31290,2024,2,2,0,0,100,189300,1640,115
31291,2024,116,61,55,47,53,224532,2663,84
31293,2024,31,26,5,16,84,235030,2959,86
31296,2024,7,7,0,0,100,97886,981,104
31297,2024,14,13,1,7,93,282080,2614,114
31299,2024,32,29,3,9,91,252512,2421,112
31300,2024,1,1,0,0,100,230150,1798,128
31301,2024,2,2,0,0,100,90000,1064,88
31302,2024,2,2,0,0,100,172700,1274,126
31303,2024,34,32,2,6,94,238911,2423,102
31304,2024,6,6,0,0,100,301389,2529,126
31305,2024,2,2,0,0,100,183000,1269,144
31308,2024,1,1,0,0,100,88000,1375,64
31309,2024,3,3,0,0,100,220120,1998,112
31310,2024,3,3,0,0,100,348650,2048,174
31311,2024,3,3,0,0,100,179567,1710,110
31313,2024,4,4,0,0,100,136517,1729,82
31314,2024,7,7,0,0,100,177802,1429,134
31315,2024,8,7,1,12,88,112956,1356,98
31316,2024,10,10,0,0,100,178882,1566,119
31317,2024,6,6,0,0,100,251822,1708,150
31318,2024,2,2,0,0,100,147500,991,172
31319,2024,1,1,0,0,100,50000,357,140
31320,2024,12,12,0,0,100,251246,2085,120
31323,2024,3,3,0,0,100,199333,2021,102
31324,2024,42,38,4,10,90,137524,1651,89
31325,2024,1,1,0,0,100,140000,1373,102
31327,2024,1,1,0,0,100,156800,1318,119
31328,2024,1,1,0,0,100,152250,1384,110
31329,2024,2,2,0,0,100,201850,1760,94
31330,2024,5,5,0,0,100,250184,2458,101
31334,2024,13,13,0,0,100,255731,2540,106
31336,2024,8,8,0,0,100,146808,1537,99
31337,2024,3,3,0,0,100,123072,1825,67
31338,2024,6,6,0,0,100,246923,2301,115
31339,2024,4,4,0,0,100,279425,2724,104
31340,2024,2,2,0,0,100,527750,3668,146
31341,2024,58,35,23,40,60,243649,2735,87
31342,2024,2,2,0,0,100,58100,1269,44
31344,2024,12,12,0,0,100,109717,1203,89
31345,2024,25,25,0,0,100,235146,2517,100
31346,2024,11,10,1,9,91,272258,2554,114
31347,2024,2,2,0,0,100,87500,898,98
31348,2024,3,3,0,0,100,106000,946,113
31349,2024,4,4,0,0,100,277533,2220,127
31351,2024,54,23,31,57,43,202587,2746,70
31355,2024,12,12,0,0,100,474857,3478,140
31356,2024,25,23,2,8,92,303535,2712,111
31357,2024,5,5,0,0,100,149960,1487,107
31358,2024,28,25,3,11,89,308960,2563,122
31360,2024,6,1,5,83,17,166864,2800,67
31361,2024,4,4,0,0,100,418985,2702,158
31362,2024,1,1,0,0,100,202500,1966,103
31363,2024,4,4,0,0,100,253084,2026,125
31364,2024,30,26,4,13,87,259254,2643,98
31365,2024,9,9,0,0,100,198616,2197,95
31366,2024,7,7,0,0,100,482011,3023,161
31368,2024,1,1,0,0,100,248500,2761,90
31371,2024,9,9,0,0,100,210254,1949,106
31372,2024,2,2,0,0,100,181530,1728,107
31373,2024,5,5,0,0,100,128151,1158,105
31374,2024,12,12,0,0,100,273752,2437,119
31375,2024,24,23,1,4,96,145338,1595,97
31376,2024,2,2,0,0,100,230000,1858,156
31377,2024,3,3,0,0,100,296837,2662,113
31380,2024,7,7,0,0,100,224886,1950,114
31381,2024,17,15,2,12,88,232036,2471,96
31383,2024,7,7,0,0,100,279344,2367,117
31384,2024,3,2,1,33,67,220263,2959,75
31385,2024,1,1,0,0,100,134500,1234,109
31386,2024,2,2,0,0,100,157000,1198,144
31387,2024,2,2,0,0,100,80600,1240,54
31388,2024,4,4,0,0,100,279938,2607,109
31389,2024,44,23,21,48,52,297783,3389,81
31390,2024,57,30,27,47,53,84200,1096,76
31391,2024,4,4,0,0,100,195192,1379,141
31392,2024,1,1,0,0,100,170000,2048,83
31393,2024,2,2,0,0,100,146250,1401,107
31394,2024,1,1,0,0,100,1900000,13971,136
31395,2024,273,123,150,55,45,174591,2278,76
31396,2024,70,24,46,66,34,154275,1976,72
31398,2024,2,2,0,0,100,130000,1077,109
31399,2024,32,30,2,6,94,204635,2095,99
31401,2024,1,1,0,0,100,365900,2361,155
31402,2024,6,6,0,0,100,242475,2407,106
31403,2024,10,10,0,0,100,282720,2754,104
31405,2024,3,3,0,0,100,169867,1629,106
31406,2024,9,9,0,0,100,166078,1614,101
31407,2024,15,14,1,7,93,279039,2876,99
31409,2024,23,14,9,39,61,275492,3307,82
31410,2024,41,36,5,12,88,275440,2914,96
31411,2024,9,9,0,0,100,468964,3249,142
31412,2024,2,2,0,0,100,82500,1114,81
31413,2024,4,4,0,0,100,217300,2288,98
31415,2024,1,1,0,0,100,130000,1130,115
31416,2024,4,3,1,25,75,197562,2271,90
31417,2024,83,60,23,28,72,358022,3423,106
31418,2024,4,4,0,0,100,634788,4780,135
31419,2024,2,2,0,0,100,342500,2364,112
31420,2024,27,21,6,22,78,265507,2749,95
31421,2024,40,32,8,20,80,244841,2801,87
31422,2024,1,1,0,0,100,194000,1416,137
31423,2024,3,3,0,0,100,270887,2577,108
31424,2024,178,133,45,25,75,262208,2843,93
31425,2024,11,11,0,0,100,184281,1562,118
31426,2024,5,5,0,0,100,90300,1088,81
31427,2024,6,6,0,0,100,131296,1524,86
31428,2024,1,1,0,0,100,250000,4167,60
31429,2024,16,13,3,19,81,301929,2874,108
31430,2024,3,3,0,0,100,223721,1446,115
31432,2024,1,1,0,0,100,170000,1789,95
31433,2024,83,63,20,24,76,251011,2834,87
31435,2024,5,5,0,0,100,256034,2512,103
31436,2024,2,2,0,0,100,202000,2497,82
31437,2024,2,2,0,0,100,304960,1980,148
31439,2024,6,6,0,0,100,408087,3787,116
31441,2024,2,2,0,0,100,405600,2836,143
31442,2024,8,8,0,0,100,222912,2512,94
31443,2024,5,5,0,0,100,123040,1168,108
31444,2024,1,1,0,0,100,165000,2260,73
31445,2024,62,46,16,26,74,391272,3771,104
31446,2024,164,45,119,73,27,221104,2956,76
31447,2024,3,3,0,0,100,98380,1622,65
31448,2024,5,5,0,0,100,602392,4866,131
31450,2024,3,3,0,0,100,287833,2589,112
31451,2024,103,87,16,16,84,188030,1996,97
31454,2024,37,27,10,27,73,173697,1907,94
31455,2024,27,27,0,0,100,201198,1824,114
31457,2024,7,7,0,0,100,182310,1665,119
31458,2024,59,43,16,27,73,233652,2789,84
31459,2024,7,7,0,0,100,250936,2506,100
31460,2024,37,25,12,32,68,253691,2755,93
31461,2024,3,3,0,0,100,104897,1302,86
31462,2024,21,13,8,38,62,429053,3507,116
31463,2024,1,1,0,0,100,217500,1891,115
31464,2024,7,7,0,0,100,185436,1696,113
31465,2024,2,2,0,0,100,124400,1162,101
31466,2024,8,8,0,0,100,239562,2374,107
31467,2024,51,40,11,22,78,273997,3183,87
31468,2024,3,3,0,0,100,203890,1645,122
31470,2024,15,3,12,80,20,58727,1888,34
31471,2024,14,13,1,7,93,146755,1530,92
31472,2024,4,4,0,0,100,133500,1293,97
31473,2024,14,3,11,79,21,146368,1817,79
31474,2024,1,1,0,0,100,113000,983,115
31475,2024,11,8,3,27,73,191923,2230,88
31476,2024,7,7,0,0,100,237496,2258,130
31478,2024,10,10,0,0,100,226681,1853,121
31480,2024,20,15,5,25,75,341627,3104,109
31481,2024,17,12,5,29,71,217501,2181,97
31482,2024,3,3,0,0,100,132580,1586,86
31483,2024,175,80,95,54,46,95382,1277,76
31484,2024,22,13,9,41,59,224060,2775,81
31486,2024,10,10,0,0,100,266809,2535,110
31487,2024,2,2,0,0,100,152500,1186,134
31488,2024,120,72,48,40,60,248469,2988,84
31489,2024,1,1,0,0,100,495960,3786,131
31490,2024,48,34,14,29,71,241899,2846,84
31491,2024,4,4,0,0,100,206438,2221,94
31492,2024,5,5,0,0,100,179696,1715,114
31493,2024,1,1,0,0,100,190000,2021,94
31494,2024,1,1,0,0,100,109000,681,160
31495,2024,6,6,0,0,100,204040,2021,102
31496,2024,3,3,0,0,100,291952,2483,115
31497,2024,12,12,0,0,100,387271,3279,117
31499,2024,98,74,24,24,76,219724,2507,87
31500,2024,21,9,12,57,43,167659,2641,67
31501,2024,2,2,0,0,100,427700,2468,180
31502,2024,2,2,0,0,100,133175,1104,113
31503,2024,11,9,2,18,82,116498,1191,97
31504,2024,2,2,0,0,100,178500,1792,100
31505,2024,2,2,0,0,100,127166,1266,112
31506,2024,150,73,77,51,49,250200,3081,81
31507,2024,22,14,8,36,64,197858,2341,87
31508,2024,1,1,0,0,100,189050,2011,94
31509,2024,3,3,0,0,100,126833,1125,97
31510,2024,1,1,0,0,100,317500,2810,113
31511,2024,3,3,0,0,100,271367,2864,98
31512,2024,4,4,0,0,100,456485,4320,118
31513,2024,5,5,0,0,100,121381,1140,112
31515,2024,4,4,0,0,100,262950,2340,116
31516,2024,17,13,4,24,76,243894,3075,82
31517,2024,21,20,1,5,95,201565,2197,95
31518,2024,3,3,0,0,100,310598,2270,135
31519,2024,1,1,0,0,100,244800,2075,118
31520,2024,1,1,0,0,100,120000,1765,68
31521,2024,6,6,0,0,100,139206,1338,103
31522,2024,2,2,0,0,100,272568,998,230
31523,2024,25,19,6,24,76,127114,1562,93
31524,2024,4,4,0,0,100,220236,2085,107
31525,2024,5,5,0,0,100,277440,2109,127
31526,2024,70,48,22,31,69,259290,2906,89
31527,2024,2,2,0,0,100,402925,2799,143
31528,2024,2,2,0,0,100,165000,1018,165
31529,2024,2,2,0,0,100,229000,1960,110
31530,2024,2,2,0,0,100,225000,1582,142
31531,2024,1,1,0,0,100,252500,1549,163
31533,2024,14,13,1,7,93,289846,2765,102
31534,2024,1,1,0,0,100,369925,2661,139
31535,2024,16,16,0,0,100,164570,1416,114
31536,2024,2,2,0,0,100,199000,2134,93
31538,2024,2,2,0,0,100,321425,2913,118
31540,2024,3,3,0,0,100,278210,2529,112
31541,2024,53,25,28,53,47,275828,3155,87
31542,2024,2,2,0,0,100,244215,1848,136
31543,2024,2,2,0,0,100,244610,2608,95
31544,2024,8,8,0,0,100,95934,1227,81
31545,2024,3,3,0,0,100,166621,1292,145
31546,2024,3,3,0,0,100,238817,2339,113
31547,2024,92,50,42,46,54,197102,2523,79
31549,2024,1,1,0,0,100,200700,3237,62
31550,2024,11,11,0,0,100,182217,1595,116
31551,2024,3,3,0,0,100,254667,1564,151
31552,2024,1,1,0,0,100,339500,2122,160
31553,2024,14,12,2,14,86,218286,1889,122
31555,2024,6571,979,5592,85,15,216291,3497,63
31556,2024,2,2,0,0,100,59000,799,74
31557,2024,258,162,96,37,63,294984,3213,91
31558,2024,5,5,0,0,100,274840,2551,109
31560,2024,1,1,0,0,100,317500,1764,180
31561,2024,139,108,31,22,78,300644,3186,96
31563,2024,11,11,0,0,100,282418,2375,120
31564,2024,3,3,0,0,100,157167,1353,116
31565,2024,10,9,1,10,90,82538,1027,87
31566,2024,6,6,0,0,100,281995,2681,114
31567,2024,1,1,0,0,100,260000,2131,122
31568,2024,3,3,0,0,100,379167,2563,135
31569,2024,3,3,0,0,100,336667,2817,116
31571,2024,1,1,0,0,100,246000,2388,103
31572,2024,32,29,3,9,91,267302,2536,107
31573,2024,57,52,5,9,91,273503,2614,107
31574,2024,28,26,2,7,93,266812,2875,96
31575,2024,10,8,2,20,80,562745,3909,165
31576,2024,2,2,0,0,100,150875,1764,72
31577,2024,1,1,0,0,100,87062,1527,57
31578,2024,6,6,0,0,100,554477,3578,152
31579,2024,9,9,0,0,100,298160,2589,118
31580,2024,5,5,0,0,100,227760,2082,118
31581,2024,14,14,0,0,100,266292,2266,125
31582,2024,53,48,5,9,91,241104,2521,100
31583,2024,13,12,1,8,92,248910,2304,115
31584,2024,85,65,20,24,76,147953,1844,82
31585,2024,16,16,0,0,100,199368,1745,115
31586,2024,2,2,0,0,100,178900,1634,114
31587,2024,15,15,0,0,100,312783,2639,123
31588,2024,102,71,31,30,70,221215,2729,82
31589,2024,12,12,0,0,100,287175,2610,117
31591,2024,1,1,0,0,100,150000,1250,120
31592,2024,12,12,0,0,100,254046,2298,107
31593,2024,1,1,0,0,100,416410,3108,134
32001,2024,7,7,0,0,100,147041,1190,129
32002,2024,1,1,0,0,100,70000,636,110
32004,2024,2,2,0,0,100,154000,1547,97
32005,2024,4,4,0,0,100,210125,1491,138
32007,2024,1,1,0,0,100,150000,1351,111
32008,2024,1,1,0,0,100,449000,2689,167
32010,2024,1,1,0,0,100,117850,2405,49
32012,2024,6,6,0,0,100,157787,1923,83
32013,2024,291,136,155,53,47,140222,1762,80
32014,2024,3,3,0,0,100,206497,1495,149
32015,2024,1,1,0,0,100,420400,2336,180
32016,2024,4,4,0,0,100,320075,2230,150
32017,2024,1,1,0,0,100,150000,1596,94
32020,2024,2,2,0,0,100,268725,1854,184
32021,2024,1,1,0,0,100,145000,1318,110
32022,2024,1,1,0,0,100,195000,1393,140
32023,2024,1,1,0,0,100,40000,571,70
32024,2024,4,4,0,0,100,160382,1474,146
32025,2024,4,4,0,0,100,184942,1395,126
32026,2024,1,1,0,0,100,190000,1919,99
32027,2024,16,15,1,6,94,128699,1412,94
32029,2024,10,10,0,0,100,223400,1480,156
32030,2024,1,1,0,0,100,180000,1333,135
32031,2024,2,2,0,0,100,129000,1526,75
32032,2024,4,4,0,0,100,280122,2476,115
32033,2024,2,2,0,0,100,240500,1724,136
32034,2024,1,1,0,0,100,432500,2031,213
32035,2024,5,5,0,0,100,216787,1892,105
32036,2024,3,3,0,0,100,143667,1032,141
32037,2024,2,2,0,0,100,168700,1425,110
32038,2024,2,2,0,0,100,154250,1598,96
32039,2024,1,1,0,0,100,254000,2988,85
32040,2024,2,2,0,0,100,232400,2153,108
32041,2024,1,1,0,0,100,178490,1257,142
32043,2024,1,1,0,0,100,191820,1744,110
32044,2024,5,5,0,0,100,187850,1585,128
32045,2024,3,3,0,0,100,243600,1839,127
32047,2024,2,2,0,0,100,388500,2114,180
32049,2024,1,1,0,0,100,173000,2218,78
32050,2024,5,5,0,0,100,109692,1342,94
32052,2024,2,2,0,0,100,172500,1590,108
32053,2024,2,2,0,0,100,220800,1133,190
32054,2024,4,4,0,0,100,290750,1561,191
32057,2024,1,1,0,0,100,100000,556,180
32058,2024,1,1,0,0,100,127500,1062,120
32059,2024,1,1,0,0,100,120000,667,180
32060,2024,2,2,0,0,100,204325,1689,124
32061,2024,2,2,0,0,100,256168,2559,96
32062,2024,1,1,0,0,100,86000,905,95
32063,2024,3,3,0,0,100,229992,1558,146
32064,2024,8,8,0,0,100,147897,1312,115
32065,2024,2,2,0,0,100,225000,1435,202
32066,2024,2,1,1,50,50,302750,2178,150
32067,2024,1,1,0,0,100,180700,2697,67
32068,2024,1,1,0,0,100,128000,1376,93
32069,2024,2,2,0,0,100,284950,2119,136
32071,2024,1,1,0,0,100,58800,1633,36
32073,2024,3,3,0,0,100,302000,1642,168
32075,2024,2,2,0,0,100,107500,1804,74
32076,2024,8,8,0,0,100,94312,1348,78
32077,2024,2,2,0,0,100,537500,2764,180
32078,2024,2,2,0,0,100,301950,1386,196
32079,2024,16,16,0,0,100,165932,1356,120
32080,2024,2,2,0,0,100,310000,2357,120
32081,2024,2,2,0,0,100,95110,888,129
32082,2024,1,1,0,0,100,241000,1785,135
32083,2024,12,12,0,0,100,190590,1710,133
32084,2024,3,3,0,0,100,199267,1723,107
32085,2024,2,2,0,0,100,211791,2808,76
32086,2024,1,1,0,0,100,220000,2444,90
32087,2024,1,1,0,0,100,185000,1233,150
32088,2024,5,5,0,0,100,206494,1793,105
32089,2024,1,1,0,0,100,265000,2409,110
32091,2024,2,2,0,0,100,175409,1525,115
32093,2024,1,1,0,0,100,249000,1791,139
32094,2024,7,7,0,0,100,205853,1365,158
32095,2024,10,10,0,0,100,231650,1874,125
32096,2024,61,12,49,80,20,71923,1614,45
32098,2024,4,4,0,0,100,260875,2440,113
32099,2024,1,1,0,0,100,360000,1200,300
32100,2024,1,1,0,0,100,80000,1231,65
32101,2024,2,2,0,0,100,167625,1810,112
32102,2024,3,3,0,0,100,225167,1345,156
32103,2024,1,1,0,0,100,183600,1113,165
32104,2024,1,1,0,0,100,157000,1744,90
32105,2024,4,4,0,0,100,296691,2191,135
32106,2024,5,5,0,0,100,222968,2139,115
32107,2024,105,100,5,5,95,142633,1351,106
32108,2024,3,3,0,0,100,267533,2113,126
32110,2024,3,3,0,0,100,147667,931,159
32111,2024,1,1,0,0,100,456000,1900,240
32112,2024,1,1,0,0,100,128000,1067,120
32113,2024,1,1,0,0,100,277000,2916,95
32114,2024,2,2,0,0,100,275925,2060,165
32115,2024,1,1,0,0,100,220000,2444,90
32117,2024,4,4,0,0,100,169250,1786,93
32118,2024,3,3,0,0,100,332333,2048,159
32119,2024,56,46,10,18,82,115835,1295,94
32120,2024,7,7,0,0,100,328816,2211,162
32121,2024,4,4,0,0,100,263705,2295,119
32122,2024,1,1,0,0,100,150000,1154,130
32123,2024,8,8,0,0,100,223635,1870,122
32124,2024,1,1,0,0,100,266000,1255,212
32126,2024,3,3,0,0,100,319750,1497,217
32127,2024,7,7,0,0,100,177861,1024,155
32128,2024,2,2,0,0,100,110660,1078,88
32129,2024,3,1,2,67,33,185033,1363,142
32130,2024,1,1,0,0,100,155200,1176,132
32131,2024,4,4,0,0,100,113750,1184,86
32132,2024,98,89,9,9,91,137459,1465,97
32133,2024,4,4,0,0,100,282500,1910,202
32134,2024,3,3,0,0,100,340113,2748,126
32135,2024,1,1,0,0,100,100000,1266,79
32136,2024,2,2,0,0,100,170000,1162,147
32138,2024,2,2,0,0,100,200150,1303,148
32139,2024,3,3,0,0,100,358143,3993,96
32141,2024,2,2,0,0,100,330950,2304,147
32143,2024,4,4,0,0,100,193750,1260,150
32144,2024,3,3,0,0,100,287500,1699,170
32146,2024,1,1,0,0,100,227000,1746,130
32147,2024,38,37,1,3,97,190384,2005,100
32149,2024,15,15,0,0,100,178793,1838,110
32150,2024,1,1,0,0,100,37106,337,110
32151,2024,3,3,0,0,100,184070,1239,149
32152,2024,3,3,0,0,100,61000,1166,64
32155,2024,14,14,0,0,100,138566,1384,102
32157,2024,3,3,0,0,100,299840,2553,111
32159,2024,5,5,0,0,100,137500,1074,155
32160,2024,90,66,24,27,73,227913,2553,93
32162,2024,12,12,0,0,100,160220,1565,104
32163,2024,7,7,0,0,100,167900,1238,131
32165,2024,1,1,0,0,100,184000,2165,85
32167,2024,1,1,0,0,100,76000,1086,70
32170,2024,1,1,0,0,100,146460,1285,114
32171,2024,1,1,0,0,100,300550,2683,112
32175,2024,1,1,0,0,100,60000,414,145
32176,2024,2,2,0,0,100,178500,1152,177
32177,2024,1,1,0,0,100,320000,1185,270
32180,2024,9,9,0,0,100,223468,1530,138
32181,2024,8,8,0,0,100,133662,1505,92
32182,2024,2,2,0,0,100,285900,2048,140
32183,2024,2,2,0,0,100,216500,1044,209
32184,2024,1,1,0,0,100,115000,1322,87
32185,2024,3,3,0,0,100,289883,2471,118
32188,2024,1,1,0,0,100,215000,1525,141
32189,2024,3,3,0,0,100,99760,1083,99
32190,2024,6,6,0,0,100,100567,1340,84
32191,2024,2,2,0,0,100,95000,1554,54
32192,2024,3,3,0,0,100,178217,1942,94
32193,2024,5,5,0,0,100,132018,1329,103
32194,2024,1,1,0,0,100,265000,4732,56
32195,2024,1,1,0,0,100,48000,400,120
32196,2024,1,1,0,0,100,38000,559,68
32197,2024,1,1,0,0,100,447540,2459,182
32199,2024,2,2,0,0,100,219000,2922,110
32201,2024,4,4,0,0,100,239775,1949,130
32202,2024,2,2,0,0,100,65715,844,88
32203,2024,4,4,0,0,100,133303,1146,119
32204,2024,5,5,0,0,100,151560,1746,92
32205,2024,2,2,0,0,100,336000,4108,82
32206,2024,1,1,0,0,100,139000,2106,66
32207,2024,3,3,0,0,100,269967,2415,114
32208,2024,36,33,3,8,92,175531,1649,104
32209,2024,1,1,0,0,100,140000,1176,119
32210,2024,3,3,0,0,100,241167,2421,98
32211,2024,1,1,0,0,100,86000,1162,74
32212,2024,2,2,0,0,100,355450,1374,268
32213,2024,31,29,2,6,94,176236,2022,91
32215,2024,2,2,0,0,100,206450,2024,102
32216,2024,1,1,0,0,100,194000,1902,102
32218,2024,1,1,0,0,100,150000,1364,110
32219,2024,4,4,0,0,100,446788,5892,70
32220,2024,1,1,0,0,100,115000,1420,81
32221,2024,2,2,0,0,100,115500,642,175
32222,2024,3,3,0,0,100,150000,1081,123
32224,2024,1,1,0,0,100,242310,1850,131
32226,2024,2,2,0,0,100,250150,1854,136
32227,2024,11,11,0,0,100,213614,1576,163
32230,2024,1,1,0,0,100,256860,2569,100
32231,2024,4,4,0,0,100,205838,1499,139
32233,2024,25,20,5,20,80,161358,1782,99
32235,2024,1,1,0,0,100,204998,2158,95
32237,2024,4,4,0,0,100,179488,2068,83
32239,2024,6,6,0,0,100,578469,3028,182
32242,2024,17,15,2,12,88,88963,1031,92
32243,2024,3,3,0,0,100,233667,2849,89
32244,2024,4,4,0,0,100,121500,1821,83
32246,2024,1,1,0,0,100,50000,625,80
32247,2024,2,2,0,0,100,195000,2244,88
32248,2024,1,1,0,0,100,705000,3294,214
32249,2024,29,21,8,28,72,123728,1450,85
32252,2024,17,17,0,0,100,126757,1193,103
32253,2024,6,6,0,0,100,154428,1302,123
32255,2024,1,1,0,0,100,49000,422,116
32256,2024,36,34,2,6,94,141969,1515,94
32258,2024,1,1,0,0,100,305000,1968,155
32260,2024,1,1,0,0,100,139000,1007,138
32261,2024,5,5,0,0,100,237640,1984,120
32262,2024,3,3,0,0,100,247220,2930,92
32263,2024,1,1,0,0,100,581931,1531,380
32264,2024,1,1,0,0,100,128500,1382,93
32265,2024,2,2,0,0,100,507500,1968,232
32267,2024,2,2,0,0,100,147250,1610,94
32268,2024,4,3,1,25,75,196418,1670,131
32269,2024,7,7,0,0,100,162766,1732,97
32273,2024,3,3,0,0,100,189432,1294,144
32274,2024,2,2,0,0,100,111000,1225,90
32276,2024,1,1,0,0,100,196330,2765,71
32277,2024,2,2,0,0,100,137500,1734,77
32279,2024,6,6,0,0,100,215775,1842,125
32280,2024,2,2,0,0,100,157500,2115,118
32282,2024,8,8,0,0,100,267962,2141,127
32283,2024,4,4,0,0,100,144675,1400,112
32284,2024,1,1,0,0,100,147225,995,148
32285,2024,5,5,0,0,100,68584,1099,69
32286,2024,4,4,0,0,100,182625,1788,96
32287,2024,3,3,0,0,100,213530,1315,173
32290,2024,21,21,0,0,100,204348,1701,114
32292,2024,3,3,0,0,100,329533,1833,172
32293,2024,1,1,0,0,100,218000,1009,216
32295,2024,3,3,0,0,100,287880,2430,116
32296,2024,25,14,11,44,56,102377,1373,84
32297,2024,4,4,0,0,100,220042,1866,132
32298,2024,6,6,0,0,100,175075,1681,100
32299,2024,1,1,0,0,100,540000,2213,244
32300,2024,3,3,0,0,100,123037,1320,105
32301,2024,5,5,0,0,100,271337,1672,171
32302,2024,2,2,0,0,100,200400,1336,160
32303,2024,1,1,0,0,100,550500,3058,180
32304,2024,3,3,0,0,100,142017,1580,102
32305,2024,5,4,1,20,80,102837,1129,108
32306,2024,8,8,0,0,100,202144,1720,120
32307,2024,16,16,0,0,100,192166,1826,106
32308,2024,1,1,0,0,100,245000,1960,125
32309,2024,2,2,0,0,100,164000,1810,86
32310,2024,1,1,0,0,100,194800,1241,157
32311,2024,6,6,0,0,100,291833,2512,129
32312,2024,7,7,0,0,100,189084,1816,110
32314,2024,2,2,0,0,100,214250,1784,106
32315,2024,2,2,0,0,100,120825,1790,110
32316,2024,2,2,0,0,100,860296,2866,278
32319,2024,26,26,0,0,100,154900,1358,122
32320,2024,1,1,0,0,100,381350,1557,245
32321,2024,6,6,0,0,100,204003,1871,106
32322,2024,1,1,0,0,100,252400,2774,91
32324,2024,1,1,0,0,100,85000,944,90
32326,2024,1,1,0,0,100,239550,1426,168
32328,2024,2,2,0,0,100,196400,1182,222
32329,2024,1,1,0,0,100,311780,1632,191
32330,2024,4,4,0,0,100,102938,1024,108
32331,2024,9,7,2,22,78,171807,1813,94
32332,2024,1,1,0,0,100,114650,882,130
32333,2024,3,3,0,0,100,130100,1342,102
32334,2024,9,7,2,22,78,216037,2369,99
32335,2024,5,5,0,0,100,150210,1765,79
32336,2024,2,2,0,0,100,114400,1077,105
32338,2024,2,2,0,0,100,176300,1042,160
32339,2024,2,2,0,0,100,217070,2030,105
32340,2024,5,5,0,0,100,124690,1120,118
32341,2024,1,1,0,0,100,305000,910,335
32342,2024,2,2,0,0,100,188590,2340,83
32343,2024,3,3,0,0,100,371833,2081,192
32344,2024,21,20,1,5,95,136090,1331,114
32345,2024,4,3,1,25,75,216500,1257,187
32347,2024,2,2,0,0,100,220050,1626,146
32348,2024,6,6,0,0,100,47292,956,46
32349,2024,1,1,0,0,100,224000,1600,140
32351,2024,3,3,0,0,100,212767,1741,122
32354,2024,1,1,0,0,100,100000,1333,75
32355,2024,1,1,0,0,100,176000,1872,94
32357,2024,1,1,0,0,100,233234,1928,121
32358,2024,3,3,0,0,100,205753,1599,125
32359,2024,2,2,0,0,100,426386,2449,173
32360,2024,1,1,0,0,100,80000,396,202
32362,2024,1,1,0,0,100,309900,2066,150
32364,2024,1,1,0,0,100,25500,398,64
32365,2024,1,1,0,0,100,60000,500,120
32367,2024,2,2,0,0,100,105000,851,101
32368,2024,2,2,0,0,100,295250,2561,115
32369,2024,4,4,0,0,100,183125,1942,93
32370,2024,15,15,0,0,100,168821,1434,107
32371,2024,1,1,0,0,100,365000,3883,94
32372,2024,1,1,0,0,100,265000,2070,128
32373,2024,5,5,0,0,100,172786,1328,139
32376,2024,2,2,0,0,100,120900,1290,94
32377,2024,1,1,0,0,100,200000,1835,109
32378,2024,2,2,0,0,100,108690,1025,112
32379,2024,1,1,0,0,100,105000,3000,35
32381,2024,2,2,0,0,100,139250,1446,100
32382,2024,2,2,0,0,100,105500,1079,119
32384,2024,4,4,0,0,100,172592,1292,128
32385,2024,3,3,0,0,100,160069,1569,108
32388,2024,3,3,0,0,100,189706,1398,133
32389,2024,2,2,0,0,100,297700,1462,205
32392,2024,1,1,0,0,100,61000,678,90
32395,2024,1,1,0,0,100,102640,1283,80
32396,2024,3,3,0,0,100,159000,1198,130
32397,2024,5,5,0,0,100,214661,1947,104
32398,2024,1,1,0,0,100,220000,1134,194
32400,2024,1,1,0,0,100,180000,2222,81
32403,2024,1,1,0,0,100,140000,1556,90
32404,2024,11,11,0,0,100,234520,1447,141
32405,2024,4,4,0,0,100,171375,1324,139
32410,2024,24,22,2,8,92,220270,2174,105
32412,2024,14,14,0,0,100,121799,1672,87
32414,2024,2,2,0,0,100,100000,706,142
32416,2024,2,2,0,0,100,55000,592,98
32417,2024,6,6,0,0,100,309250,2119,137
32418,2024,8,8,0,0,100,160468,1622,108
32419,2024,2,2,0,0,100,204800,1604,125
32424,2024,3,3,0,0,100,176847,1788,100
32425,2024,7,7,0,0,100,240768,2922,82
32426,2024,19,19,0,0,100,184123,1957,101
32427,2024,1,1,0,0,100,225130,2558,88
32428,2024,1,1,0,0,100,320000,1280,250
32429,2024,2,2,0,0,100,198250,1394,129
32430,2024,1,1,0,0,100,180000,1682,107
32432,2024,1,1,0,0,100,170000,1545,110
32433,2024,3,3,0,0,100,153000,1625,103
32436,2024,5,5,0,0,100,171639,1243,148
32437,2024,4,4,0,0,100,98790,1165,84
32438,2024,2,2,0,0,100,137000,1866,75
32439,2024,1,1,0,0,100,114750,981,117
32440,2024,2,2,0,0,100,82850,1236,71
32442,2024,3,3,0,0,100,144710,1973,83
32443,2024,2,2,0,0,100,113500,1262,84
32444,2024,3,3,0,0,100,179198,1563,152
32445,2024,2,2,0,0,100,263390,2278,116
32446,2024,1,1,0,0,100,64000,941,68
32447,2024,1,1,0,0,100,240000,1218,197
32448,2024,7,6,1,14,86,152845,1447,118
32450,2024,2,2,0,0,100,155500,1600,98
32452,2024,3,3,0,0,100,187333,1177,180
32454,2024,1,1,0,0,100,40000,400,100
32455,2024,3,3,0,0,100,165000,1052,175
32457,2024,1,1,0,0,100,176533,1139,155
32458,2024,2,2,0,0,100,171000,1472,114
32459,2024,12,12,0,0,100,138192,1361,97
32460,2024,1,1,0,0,100,127000,1283,99
32462,2024,42,38,4,10,90,155579,1750,89
32463,2024,11,11,0,0,100,166558,1172,151
32464,2024,12,12,0,0,100,163815,1304,130
32465,2024,3,3,0,0,100,125500,1237,97
32466,2024,1,1,0,0,100,85030,850,100
32468,2024,1,1,0,0,100,168000,1768,95
33001,2024,20,20,0,0,100,121125,1432,91
33002,2024,6,6,0,0,100,250295,2014,105
33003,2024,148,116,32,22,78,236091,2767,89
33004,2024,33,14,19,58,42,147548,1982,75
33005,2024,203,151,52,26,74,451380,5451,86
33006,2024,9,9,0,0,100,178102,1441,121
33007,2024,11,11,0,0,100,252771,2692,96
33008,2024,2,2,0,0,100,109000,1190,92
33009,2024,389,105,284,73,27,525822,8300,62
33010,2024,11,11,0,0,100,237055,2674,88
33011,2024,121,94,27,22,78,373074,5229,76
33012,2024,35,35,0,0,100,331984,3318,103
33013,2024,70,41,29,41,59,270023,3116,87
33014,2024,6,6,0,0,100,254925,2250,105
33015,2024,14,14,0,0,100,224494,2578,101
33017,2024,4,4,0,0,100,265812,1762,156
33018,2024,31,30,1,3,97,242032,2262,109
33019,2024,118,68,50,42,58,308688,3979,77
33021,2024,10,10,0,0,100,168156,1705,104
33022,2024,26,24,2,8,92,236817,2525,97
33023,2024,7,7,0,0,100,318421,2992,106
33024,2024,1,1,0,0,100,268000,2851,94
33025,2024,4,4,0,0,100,183498,1825,94
33026,2024,4,4,0,0,100,141250,1679,119
33027,2024,2,2,0,0,100,187925,1038,190
33028,2024,3,3,0,0,100,128333,1310,96
33029,2024,38,30,8,21,79,294868,3286,91
33030,2024,30,27,3,10,90,199947,2101,96
33032,2024,60,33,27,45,55,215639,2984,73
33033,2024,6,6,0,0,100,333958,2662,116
33034,2024,7,7,0,0,100,248657,2006,126
33035,2024,4,4,0,0,100,204838,1644,120
33036,2024,43,37,6,14,86,182598,1970,100
33037,2024,20,19,1,5,95,249550,2469,107
33038,2024,15,15,0,0,100,204556,1238,159
33039,2024,357,163,194,54,46,276071,3696,75
33040,2024,13,12,1,8,92,165850,1850,100
33042,2024,64,62,2,3,97,272219,2832,98
33043,2024,3,3,0,0,100,329803,2827,113
33044,2024,2,2,0,0,100,257500,3778,66
33045,2024,3,3,0,0,100,107556,1360,81
33046,2024,12,12,0,0,100,207849,1845,114
33047,2024,19,19,0,0,100,207124,1846,112
33048,2024,1,1,0,0,100,408000,3290,124
33049,2024,22,22,0,0,100,320239,2746,122
33050,2024,5,5,0,0,100,196677,1712,117
33051,2024,99,76,23,23,77,284088,3635,80
33052,2024,5,5,0,0,100,194340,1788,112
33054,2024,2,2,0,0,100,253800,2226,114
33055,2024,3,3,0,0,100,137096,1241,109
33056,2024,112,84,28,25,75,326601,3329,99
33057,2024,5,5,0,0,100,118743,1062,107
33058,2024,62,37,25,40,60,126417,1668,76
33060,2024,4,4,0,0,100,90700,904,90
33061,2024,7,7,0,0,100,422756,3926,109
33062,2024,4,4,0,0,100,193250,1988,95
33063,2024,3747,875,2872,77,23,312153,4549,69
33065,2024,29,24,5,17,83,540582,4200,122
33067,2024,31,30,1,3,97,163092,1532,106
33068,2024,1,1,0,0,100,276300,2017,137
33069,2024,322,149,173,54,46,400851,4496,86
33070,2024,4,4,0,0,100,329187,3272,102
33071,2024,16,16,0,0,100,208866,2048,112
33072,2024,1,1,0,0,100,81665,698,117
33073,2024,11,11,0,0,100,143038,1639,90
33075,2024,258,96,162,63,37,291564,3747,76
33076,2024,10,10,0,0,100,205135,1735,128
33077,2024,18,18,0,0,100,282656,2543,116
33078,2024,3,3,0,0,100,302545,2415,127
33079,2024,2,2,0,0,100,140500,1569,90
33080,2024,58,42,16,28,72,272060,3423,80
33081,2024,28,20,8,29,71,162314,2153,74
33082,2024,10,10,0,0,100,178850,1965,93
33083,2024,8,8,0,0,100,357932,2749,126
33084,2024,19,16,3,16,84,264806,3081,85
33085,2024,23,22,1,4,96,363376,3579,102
33086,2024,2,2,0,0,100,132750,1616,84
33087,2024,8,8,0,0,100,186500,1604,122
33088,2024,9,9,0,0,100,172214,1941,91
33089,2024,2,2,0,0,100,125925,1376,100
33090,2024,28,24,4,14,86,327434,3524,95
33093,2024,6,6,0,0,100,215617,2162,101
33094,2024,1,1,0,0,100,45000,900,50
33095,2024,10,10,0,0,100,139831,1442,101
33096,2024,60,44,16,27,73,244944,2813,88
33097,2024,67,41,26,39,61,247929,3965,66
33098,2024,2,2,0,0,100,285850,2606,110
33099,2024,25,25,0,0,100,343702,3335,110
33100,2024,10,10,0,0,100,202265,2032,104
33101,2024,11,10,1,9,91,192073,2127,102
33102,2024,3,3,0,0,100,61031,1226,60
33104,2024,61,55,6,10,90,229568,2648,89
33105,2024,2,2,0,0,100,394298,2520,148
33106,2024,11,10,1,9,91,186433,2056,93
33108,2024,43,34,9,21,79,151403,1544,100
33109,2024,21,21,0,0,100,241102,2677,92
33111,2024,13,12,1,8,92,167603,1633,113
33112,2024,3,3,0,0,100,283400,1488,176
33113,2024,3,3,0,0,100,133333,1784,77
33114,2024,28,14,14,50,50,130487,1946,70
33115,2024,2,2,0,0,100,205000,1762,122
33116,2024,2,2,0,0,100,203250,2799,72
33117,2024,4,4,0,0,100,141900,1388,126
33118,2024,27,27,0,0,100,341820,3257,104
33119,2024,257,87,170,66,34,201671,3126,65
33120,2024,17,16,1,6,94,271272,2490,117
33121,2024,1,1,0,0,100,245000,2207,111
33122,2024,114,110,4,4,96,390109,3602,111
33123,2024,21,21,0,0,100,224203,2217,102
33124,2024,9,9,0,0,100,206874,1689,118
33125,2024,23,23,0,0,100,275443,2292,118
33126,2024,8,8,0,0,100,243404,2742,101
33127,2024,1,1,0,0,100,147000,860,171
33128,2024,6,6,0,0,100,202467,1808,106
33129,2024,1,1,0,0,100,166000,1886,88
33130,2024,9,9,0,0,100,217032,1840,132
33131,2024,1,1,0,0,100,1084321,5768,188
33132,2024,3,3,0,0,100,286567,1862,147
33134,2024,1,1,0,0,100,147000,1515,97
33135,2024,2,2,0,0,100,283660,2208,136
33136,2024,2,2,0,0,100,537994,2550,200
33137,2024,7,7,0,0,100,158600,1463,111
33138,2024,100,85,15,15,85,156252,1817,94
33139,2024,2,2,0,0,100,161200,1418,108
33140,2024,53,39,14,26,74,203778,2737,75
33141,2024,7,7,0,0,100,376771,3078,120
33142,2024,17,17,0,0,100,229388,2622,96
33143,2024,28,26,2,7,93,244338,2248,109
33144,2024,5,5,0,0,100,152003,1854,82
33145,2024,8,8,0,0,100,378698,2847,129
33146,2024,20,20,0,0,100,216534,2204,104
33147,2024,3,3,0,0,100,185000,2011,94
33148,2024,1,1,0,0,100,200000,1000,200
33149,2024,1,1,0,0,100,686350,2288,300
33150,2024,2,2,0,0,100,215035,1023,210
33151,2024,10,10,0,0,100,116394,1263,91
33152,2024,1,1,0,0,100,216601,3185,68
33153,2024,3,3,0,0,100,187580,2319,112
33154,2024,21,19,2,10,90,96733,1264,77
33157,2024,4,4,0,0,100,214015,1724,114
33158,2024,1,1,0,0,100,134000,1072,125
33159,2024,30,27,3,10,90,108212,1341,81
33160,2024,4,4,0,0,100,198000,1668,105
33161,2024,10,10,0,0,100,169628,2095,102
33162,2024,314,127,187,60,40,247073,3524,71
33163,2024,2,2,0,0,100,217000,1598,125
33164,2024,15,15,0,0,100,223826,2016,112
33165,2024,41,23,18,44,56,269813,3213,83
33166,2024,5,5,0,0,100,98000,1456,73
33167,2024,146,82,64,44,56,255110,3337,77
33168,2024,6,6,0,0,100,250768,1755,132
33169,2024,1,1,0,0,100,119900,1499,80
33170,2024,12,12,0,0,100,187335,1441,128
33171,2024,2,2,0,0,100,96000,1187,80
33172,2024,3,3,0,0,100,159100,1049,153
33173,2024,2,2,0,0,100,302036,3414,108
33174,2024,13,12,1,8,92,270123,2190,127
33175,2024,2,2,0,0,100,153500,2082,74
33176,2024,1,1,0,0,100,95000,2375,40
33177,2024,35,31,4,11,89,224060,2515,100
33178,2024,4,4,0,0,100,210560,1914,110
33179,2024,35,27,8,23,77,203069,2300,88
33181,2024,1,1,0,0,100,250000,3125,80
33182,2024,16,16,0,0,100,258239,2105,119
33183,2024,12,12,0,0,100,210094,2357,90
33184,2024,7,7,0,0,100,91339,1236,79
33185,2024,16,11,5,31,69,197551,2267,96
33186,2024,9,9,0,0,100,146167,1186,125
33187,2024,13,9,4,31,69,170037,1611,114
33188,2024,1,1,0,0,100,220000,1913,115
33189,2024,4,3,1,25,75,178100,1452,133
33190,2024,5,5,0,0,100,103720,1406,78
33191,2024,7,7,0,0,100,207557,2125,92
33192,2024,286,109,177,62,38,269909,3736,73
33193,2024,19,19,0,0,100,243444,2719,91
33194,2024,5,5,0,0,100,178000,2046,86
33195,2024,13,13,0,0,100,133613,1259,114
33196,2024,1,1,0,0,100,275000,1447,190
33197,2024,4,4,0,0,100,245253,2023,126
33198,2024,18,18,0,0,100,148846,1915,81
33199,2024,257,204,53,21,79,398982,4675,87
33200,2024,152,78,74,49,51,289157,3602,79
33201,2024,5,5,0,0,100,138555,1800,98
33202,2024,12,11,1,8,92,263819,2715,101
33203,2024,97,72,25,26,74,241294,3677,70
33204,2024,4,4,0,0,100,169796,1449,124
33205,2024,6,6,0,0,100,275105,1916,135
33206,2024,9,9,0,0,100,179350,2179,91
33207,2024,53,53,0,0,100,272038,2654,106
33208,2024,13,13,0,0,100,149869,2137,83
33209,2024,1,1,0,0,100,120000,1034,116
33210,2024,2,2,0,0,100,135000,1899,84
33211,2024,4,4,0,0,100,325650,3087,128
33212,2024,2,2,0,0,100,93250,1270,74
33213,2024,36,25,11,31,69,351107,3164,103
33214,2024,216,138,78,36,64,321007,5518,59
33215,2024,2,2,0,0,100,173500,969,209
33216,2024,1,1,0,0,100,75000,893,84
33218,2024,11,11,0,0,100,141295,1379,104
33219,2024,17,15,2,12,88,252915,2407,111
33220,2024,18,17,1,6,94,184335,2214,93
33221,2024,9,9,0,0,100,179888,1822,103
33222,2024,3,3,0,0,100,178733,1989,87
33223,2024,4,4,0,0,100,119936,1403,88
33225,2024,22,20,2,9,91,239674,2303,108
33226,2024,28,24,4,14,86,201077,2170,98
33227,2024,84,48,36,43,57,146020,2098,74
33228,2024,9,9,0,0,100,209533,1845,115
33229,2024,87,66,21,24,76,356607,4554,81
33230,2024,9,9,0,0,100,205390,1835,115
33232,2024,1,1,0,0,100,150000,1786,84
33233,2024,21,18,3,14,86,187591,1900,98
33234,2024,29,26,3,10,90,461401,3784,119
33235,2024,3,3,0,0,100,165667,1284,140
33236,2024,124,95,29,23,77,977025,10071,95
33237,2024,6,6,0,0,100,243735,1840,140
33238,2024,68,66,2,3,97,344866,3494,99
33239,2024,4,4,0,0,100,174500,1990,84
33240,2024,79,69,10,13,87,163800,1920,88
33241,2024,9,9,0,0,100,226520,2095,115
33242,2024,3,3,0,0,100,200000,1528,128
33243,2024,309,197,112,36,64,193669,2529,79
33244,2024,3,3,0,0,100,209667,2188,95
33245,2024,3,3,0,0,100,456050,2868,147
33246,2024,2,2,0,0,100,118540,1206,114
33248,2024,15,13,2,13,87,229629,2368,97
33249,2024,186,68,118,63,37,174402,2619,68
33250,2024,2,2,0,0,100,150000,1463,114
33251,2024,2,2,0,0,100,246475,2325,106
33252,2024,1,1,0,0,100,105000,929,113
33253,2024,8,7,1,12,88,326977,2365,127
33254,2024,6,6,0,0,100,213833,1576,137
33255,2024,1,1,0,0,100,220000,1222,180
33256,2024,48,41,7,15,85,266612,2806,96
33257,2024,4,4,0,0,100,274075,2502,110
33258,2024,3,3,0,0,100,191517,1788,144
33259,2024,18,17,1,6,94,200472,2087,98
33260,2024,7,7,0,0,100,481706,5284,121
33261,2024,8,8,0,0,100,176105,1469,118
33262,2024,32,30,2,6,94,260216,2566,102
33263,2024,3,3,0,0,100,298000,3541,86
33264,2024,6,6,0,0,100,165908,1756,95
33266,2024,3,2,1,33,67,204400,3170,75
33268,2024,29,29,0,0,100,212532,2291,103
33269,2024,5,5,0,0,100,187265,1787,98
33270,2024,2,2,0,0,100,189500,2034,97
33271,2024,2,2,0,0,100,229750,2106,110
33272,2024,8,8,0,0,100,240888,2068,116
33273,2024,63,42,21,33,67,325723,3703,90
33274,2024,28,26,2,7,93,391990,3402,115
33275,2024,2,2,0,0,100,277450,2274,122
33276,2024,2,2,0,0,100,267100,1682,141
33279,2024,7,7,0,0,100,212707,1971,119
33280,2024,5,5,0,0,100,207596,1539,138
33281,2024,883,310,573,65,35,275169,3695,75
33282,2024,3,3,0,0,100,150000,2187,79
33283,2024,3,3,0,0,100,186000,1464,138
33284,2024,91,82,9,10,90,356023,3751,96
33285,2024,5,5,0,0,100,172328,1730,104
33287,2024,2,2,0,0,100,205450,1596,112
33288,2024,4,4,0,0,100,227000,2088,112
33289,2024,21,19,2,10,90,198765,2034,107
33290,2024,10,9,1,10,90,274744,1856,155
33293,2024,29,23,6,21,79,302301,2820,103
33294,2024,3,3,0,0,100,206433,1843,117
33296,2024,14,14,0,0,100,153711,1652,92
33297,2024,17,17,0,0,100,255348,2493,106
33298,2024,13,13,0,0,100,327014,3005,94
33299,2024,1,1,0,0,100,211000,1918,110
33300,2024,10,10,0,0,100,224682,2660,82
33301,2024,2,2,0,0,100,130000,1038,144
33302,2024,2,2,0,0,100,240500,2748,88
33303,2024,7,7,0,0,100,278671,2179,112
33304,2024,1,1,0,0,100,390000,2600,150
33305,2024,5,5,0,0,100,226600,2183,93
33306,2024,5,5,0,0,100,230085,1853,146
33307,2024,16,16,0,0,100,202134,1907,107
33308,2024,2,2,0,0,100,96400,845,134
33309,2024,4,4,0,0,100,198488,1566,118
33310,2024,1,1,0,0,100,255000,2073,123
33311,2024,12,8,4,33,67,172001,2224,78
33312,2024,104,80,24,23,77,281724,3121,92
33314,2024,56,49,7,12,88,161907,2016,87
33315,2024,14,14,0,0,100,139317,1418,105
33316,2024,11,11,0,0,100,173701,1427,126
33317,2024,7,7,0,0,100,277332,3205,107
33318,2024,588,333,255,43,57,307278,3840,81
33319,2024,6,6,0,0,100,184377,1796,96
33320,2024,8,8,0,0,100,229125,2643,98
33321,2024,18,18,0,0,100,241374,2228,108
33322,2024,45,44,1,2,98,383464,3356,116
33323,2024,1,1,0,0,100,362000,1326,273
33324,2024,76,43,33,43,57,115021,1455,77
33325,2024,7,7,0,0,100,207586,2026,102
33326,2024,1,1,0,0,100,143000,2383,60
33327,2024,24,23,1,4,96,211142,2333,92
33328,2024,5,5,0,0,100,155640,1567,102
33329,2024,1,1,0,0,100,199500,1995,100
33330,2024,40,38,2,5,95,349943,3200,110
33331,2024,3,3,0,0,100,149127,2000,73
33332,2024,10,10,0,0,100,188240,1618,111
33333,2024,23,22,1,4,96,401372,4408,92
33334,2024,24,22,2,8,92,217862,2410,101
33335,2024,4,4,0,0,100,296638,2860,106
33336,2024,16,15,1,6,94,135355,1429,98
33337,2024,33,31,2,6,94,170148,1576,115
33339,2024,15,14,1,7,93,223997,2520,89
33341,2024,12,12,0,0,100,244298,2059,122
33342,2024,9,9,0,0,100,163778,1453,111
33343,2024,7,7,0,0,100,198001,1944,103
33344,2024,5,5,0,0,100,150700,1500,108
33345,2024,2,2,0,0,100,352965,1932,181
33346,2024,3,3,0,0,100,108667,1671,72
33347,2024,2,2,0,0,100,137500,1018,124
33348,2024,10,10,0,0,100,164083,1799,94
33349,2024,12,12,0,0,100,485927,3391,137
33350,2024,19,18,1,5,95,171134,1898,94
33351,2024,12,12,0,0,100,130471,1369,103
33352,2024,41,38,3,7,93,133732,1392,101
33353,2024,1,1,0,0,100,270000,2015,134
33354,2024,1,1,0,0,100,398360,2371,168
33355,2024,12,12,0,0,100,246065,2385,97
33356,2024,1,1,0,0,100,140500,1405,100
33357,2024,17,17,0,0,100,276973,2520,108
33358,2024,3,3,0,0,100,193133,1873,105
33360,2024,4,4,0,0,100,147375,1288,113
33361,2024,3,3,0,0,100,158333,2338,69
33362,2024,10,10,0,0,100,159800,2187,76
33363,2024,33,31,2,6,94,300233,3125,96
33364,2024,4,4,0,0,100,220700,1694,134
33366,2024,122,85,37,30,70,215543,2622,84
33367,2024,4,4,0,0,100,191575,2105,92
33369,2024,3,3,0,0,100,272753,1939,136
33370,2024,2,2,0,0,100,138100,1345,104
33372,2024,2,2,0,0,100,110000,788,141
33373,2024,8,8,0,0,100,154338,1606,99
33374,2024,9,9,0,0,100,180708,1395,133
33375,2024,2,2,0,0,100,339185,3097,107
33376,2024,42,38,4,10,90,473721,3883,125
33377,2024,1,1,0,0,100,222653,1855,120
33378,2024,10,10,0,0,100,128972,1388,92
33379,2024,1,1,0,0,100,450000,4412,102
33380,2024,24,24,0,0,100,129238,1297,105
33381,2024,28,27,1,4,96,291382,3106,98
33382,2024,8,8,0,0,100,202938,1584,138
33383,2024,4,4,0,0,100,149750,1306,103
33384,2024,4,4,0,0,100,306125,2864,103
33385,2024,5,5,0,0,100,223960,2440,102
33386,2024,2,2,0,0,100,254390,2144,116
33387,2024,16,16,0,0,100,171069,1753,103
33388,2024,4,4,0,0,100,236390,2013,114
33389,2024,29,28,1,3,97,159942,1700,105
33390,2024,3,3,0,0,100,233185,2337,100
33391,2024,3,3,0,0,100,133667,1577,90
33392,2024,7,7,0,0,100,226829,1870,125
33393,2024,43,40,3,7,93,189353,2092,103
33394,2024,11,11,0,0,100,493864,3065,145
33395,2024,14,14,0,0,100,140932,1677,82
33396,2024,2,2,0,0,100,342020,3504,84
33397,2024,19,17,2,11,89,309406,3002,104
33399,2024,1,1,0,0,100,754950,4339,174
33400,2024,4,4,0,0,100,299730,1767,164
33401,2024,2,2,0,0,100,247350,1798,133
33402,2024,37,21,16,43,57,82804,1089,75
33404,2024,1,1,0,0,100,140000,693,202
33405,2024,5,5,0,0,100,131600,1195,112
33406,2024,5,5,0,0,100,195800,1922,88
33407,2024,8,8,0,0,100,264291,2592,106
33408,2024,1,1,0,0,100,331100,2365,140
33411,2024,1,1,0,0,100,126000,1312,96
33412,2024,10,10,0,0,100,187608,2009,94
33413,2024,14,14,0,0,100,276583,2472,112
33414,2024,3,3,0,0,100,221667,2103,114
33415,2024,26,18,8,31,69,216569,2514,84
33416,2024,8,8,0,0,100,190138,1857,100
33417,2024,25,23,2,8,92,291683,2991,99
33418,2024,6,6,0,0,100,283608,1970,155
33421,2024,2,1,1,50,50,463235,1866,208
33422,2024,95,55,40,42,58,314884,3621,88
33423,2024,4,3,1,25,75,160625,1975,78
33424,2024,59,50,9,15,85,191667,2154,92
33425,2024,13,11,2,15,85,255767,2687,104
33426,2024,3,3,0,0,100,405333,3376,98
33427,2024,1,1,0,0,100,93000,795,117
33428,2024,2,2,0,0,100,147000,1726,88
33429,2024,4,4,0,0,100,110500,1419,98
33431,2024,1,1,0,0,100,321775,2873,112
33432,2024,1,1,0,0,100,244650,2522,97
33433,2024,62,56,6,10,90,253069,2790,94
33434,2024,22,14,8,36,64,163295,2435,70
33435,2024,26,17,9,35,65,174705,1961,94
33436,2024,8,8,0,0,100,266987,2251,126
33437,2024,30,30,0,0,100,215917,2301,99
33438,2024,20,20,0,0,100,248445,2393,104
33439,2024,17,17,0,0,100,201162,2048,98
33441,2024,22,12,10,45,55,139750,1850,77
33442,2024,6,6,0,0,100,92183,1377,72
33443,2024,2,2,0,0,100,204151,1933,125
33444,2024,1,1,0,0,100,139000,1241,112
33445,2024,4,4,0,0,100,224175,1732,124
33447,2024,19,19,0,0,100,138205,1581,90
33448,2024,22,20,2,9,91,299616,3537,89
33449,2024,283,213,70,25,75,342995,3647,96
33450,2024,2,2,0,0,100,117476,1016,128
33451,2024,7,7,0,0,100,237910,2801,116
33452,2024,5,5,0,0,100,294220,2855,100
33453,2024,1,1,0,0,100,90000,804,112
33454,2024,11,11,0,0,100,420462,3773,117
33456,2024,6,6,0,0,100,160408,1311,124
33457,2024,1,1,0,0,100,405000,3092,131
33458,2024,8,8,0,0,100,160062,1568,110
33459,2024,1,1,0,0,100,334000,2369,141
33460,2024,4,4,0,0,100,156912,1980,82
33461,2024,3,3,0,0,100,458550,2190,193
33462,2024,4,4,0,0,100,249500,1969,126
33463,2024,16,16,0,0,100,155618,1763,88
33464,2024,2,2,0,0,100,182500,1494,121
33465,2024,9,9,0,0,100,233811,2489,93
33466,2024,54,17,37,69,31,134551,2448,56
33467,2024,2,2,0,0,100,382800,3218,118
33468,2024,2,2,0,0,100,380500,2374,149
33470,2024,3,3,0,0,100,196333,2037,101
33471,2024,6,6,0,0,100,197787,1819,108
33472,2024,2,2,0,0,100,202952,2182,95
33473,2024,36,31,5,14,86,172743,2069,88
33474,2024,37,37,0,0,100,338511,2992,115
33476,2024,12,12,0,0,100,156796,1574,112
33477,2024,14,10,4,29,71,136299,1619,84
33478,2024,58,43,15,26,74,116813,1586,72
33480,2024,8,8,0,0,100,211762,2818,82
33481,2024,2,2,0,0,100,169750,1970,86
33482,2024,2,2,0,0,100,207500,1011,206
33483,2024,36,36,0,0,100,379934,2870,129
33484,2024,17,17,0,0,100,205919,2383,88
33485,2024,21,21,0,0,100,247297,2297,108
33486,2024,2,2,0,0,100,173500,1656,101
33487,2024,4,4,0,0,100,289750,2463,111
33488,2024,1,1,0,0,100,178660,1985,90
33489,2024,5,5,0,0,100,256402,2100,122
33490,2024,24,22,2,8,92,203086,2282,90
33491,2024,3,3,0,0,100,301217,1792,167
33492,2024,27,23,4,15,85,167279,1747,98
33493,2024,7,7,0,0,100,105557,1058,107
33494,2024,9,9,0,0,100,403003,3290,123
33496,2024,15,14,1,7,93,296293,2982,100
33498,2024,76,73,3,4,96,328215,3299,104
33499,2024,3,3,0,0,100,294863,1996,143
33500,2024,1,1,0,0,100,250667,1393,180
33501,2024,28,27,1,4,96,308934,3076,106
33502,2024,3,3,0,0,100,169000,1751,90
33503,2024,4,4,0,0,100,300082,3002,100
33504,2024,5,5,0,0,100,225601,2491,93
33505,2024,6,6,0,0,100,204406,2205,97
33506,2024,14,14,0,0,100,191335,1449,134
33507,2024,3,3,0,0,100,199267,1761,112
33508,2024,9,9,0,0,100,264833,2113,129
33509,2024,6,6,0,0,100,315477,2308,130
33511,2024,6,6,0,0,100,198604,2324,108
33512,2024,5,5,0,0,100,154806,1455,110
33513,2024,2,2,0,0,100,72500,1117,66
33514,2024,95,53,42,44,56,259052,4322,64
33515,2024,1,1,0,0,100,210000,2258,93
33516,2024,4,4,0,0,100,171065,1408,103
33517,2024,17,17,0,0,100,268681,2378,112
33518,2024,2,2,0,0,100,437500,3997,120
33519,2024,99,77,22,22,78,312512,3480,92
33520,2024,2,2,0,0,100,153500,1182,158
33521,2024,9,9,0,0,100,249985,2464,96
33522,2024,526,179,347,66,34,248522,4036,63
33523,2024,14,14,0,0,100,229813,2059,116
33524,2024,3,3,0,0,100,299017,3014,103
33525,2024,14,14,0,0,100,226858,2336,102
33527,2024,101,71,30,30,70,347047,4329,84
33528,2024,4,2,2,50,50,308975,2448,122
33529,2024,360,234,126,35,65,555405,6104,86
33530,2024,6,6,0,0,100,203142,2050,97
33531,2024,1,1,0,0,100,230000,2556,90
33532,2024,3,3,0,0,100,259367,2166,135
33533,2024,35,33,2,6,94,190654,2452,81
33534,2024,8,8,0,0,100,169752,2318,91
33535,2024,35,34,1,3,97,357120,3196,112
33536,2024,3,3,0,0,100,226943,2457,93
33537,2024,2,2,0,0,100,188652,2188,106
33538,2024,10,10,0,0,100,204340,1483,130
33539,2024,37,30,7,19,81,231142,2375,98
33540,2024,48,47,1,2,98,286925,3825,81
33541,2024,8,8,0,0,100,204989,2522,82
33542,2024,6,6,0,0,100,193559,1989,106
33543,2024,10,10,0,0,100,223695,2205,101
33544,2024,60,34,26,43,57,180584,2845,65
33545,2024,18,18,0,0,100,170426,2404,87
33546,2024,2,2,0,0,100,165000,1619,101
33547,2024,11,10,1,9,91,200336,1839,111
33548,2024,5,4,1,20,80,270270,3022,108
33549,2024,4,3,1,25,75,178075,1701,102
33550,2024,413,217,196,47,53,255187,3456,75
33551,2024,3,3,0,0,100,283867,1853,161
33552,2024,10,10,0,0,100,224476,2444,108
33553,2024,6,6,0,0,100,276277,2712,106
33554,2024,24,21,3,12,88,278770,3011,94
33555,2024,46,36,10,22,78,295629,3342,89
34001,2024,14,13,1,7,93,257652,2571,101
34002,2024,12,12,0,0,100,195088,2514,80
34003,2024,1763,354,1409,80,20,162105,4223,42
34004,2024,4,4,0,0,100,80000,1096,59
34005,2024,5,5,0,0,100,266200,2393,141
34006,2024,4,4,0,0,100,373124,2954,120
34007,2024,11,11,0,0,100,131444,1292,106
34008,2024,5,5,0,0,100,193779,2137,96
34009,2024,19,19,0,0,100,193843,2185,91
34010,2024,34,26,8,24,76,211528,2474,85
34011,2024,2,2,0,0,100,189180,2458,75
34012,2024,10,10,0,0,100,279472,3008,89
34013,2024,20,19,1,5,95,151491,2094,70
34014,2024,11,11,0,0,100,616164,4477,137
34015,2024,4,4,0,0,100,181488,2301,82
34016,2024,5,5,0,0,100,296294,2748,110
34017,2024,6,6,0,0,100,155875,1456,106
34018,2024,16,16,0,0,100,177067,1737,107
34019,2024,5,5,0,0,100,123032,1525,75
34020,2024,6,6,0,0,100,173334,1578,112
34021,2024,6,6,0,0,100,136033,1811,72
34022,2024,90,58,32,36,64,366862,3926,92
34023,2024,220,36,184,84,16,184237,4252,46
34024,2024,23,22,1,4,96,326077,3695,90
34025,2024,41,40,1,2,98,212476,2280,90
34026,2024,2,2,0,0,100,295655,3040,94
34027,2024,14,14,0,0,100,408696,3963,104
34028,2024,82,42,40,49,51,96364,1275,77
34029,2024,11,11,0,0,100,242405,2755,86
34030,2024,2,2,0,0,100,112025,1557,74
34031,2024,53,49,4,8,92,214605,2427,86
34032,2024,1261,460,801,64,36,144034,1969,73
34033,2024,21,18,3,14,86,334487,3133,108
34035,2024,11,11,0,0,100,367279,3685,103
34036,2024,14,13,1,7,93,241510,2215,109
34037,2024,37,28,9,24,76,249914,2437,98
34038,2024,19,16,3,16,84,131738,1505,86
34039,2024,22,19,3,14,86,426560,4576,95
34040,2024,1,1,0,0,100,210950,2197,96
34041,2024,9,9,0,0,100,230608,2307,100
34042,2024,7,5,2,29,71,291657,2734,73
34043,2024,1,1,0,0,100,263100,4385,60
34044,2024,7,7,0,0,100,186136,1580,124
34045,2024,5,5,0,0,100,142708,2060,82
34047,2024,10,10,0,0,100,268312,2350,114
34049,2024,6,6,0,0,100,155000,1661,105
34050,2024,18,12,6,33,67,307485,3359,92
34051,2024,39,39,0,0,100,290494,2830,105
34052,2024,46,46,0,0,100,193347,2195,88
34053,2024,1,1,0,0,100,408845,3751,109
34054,2024,2,2,0,0,100,73500,1022,103
34055,2024,6,6,0,0,100,88890,1503,65
34056,2024,12,12,0,0,100,219795,2162,103
34057,2024,342,117,225,66,34,322306,4225,73
34058,2024,68,54,14,21,79,384207,3899,99
34059,2024,5,5,0,0,100,193444,1480,116
34060,2024,5,5,0,0,100,318210,3811,76
34061,2024,8,7,1,12,88,207318,1880,110
34063,2024,30,30,0,0,100,250725,2457,100
34064,2024,7,7,0,0,100,109471,1344,92
34065,2024,8,8,0,0,100,191356,1764,114
34066,2024,3,3,0,0,100,1205793,4673,245
34067,2024,18,17,1,6,94,263792,2727,94
34068,2024,4,4,0,0,100,133000,1486,100
34069,2024,62,58,4,6,94,166946,1814,88
34070,2024,10,10,0,0,100,197205,2241,88
34071,2024,6,6,0,0,100,138467,1323,98
34073,2024,21,20,1,5,95,257065,2669,93
34074,2024,35,34,1,3,97,172478,1734,97
34075,2024,7,7,0,0,100,168463,1924,92
34076,2024,4,3,1,25,75,247712,1909,123
34077,2024,42,36,6,14,86,419516,4365,94
34078,2024,6,5,1,17,83,256250,2742,92
34079,2024,97,57,40,41,59,161383,2272,73
34080,2024,5,5,0,0,100,165671,1968,82
34081,2024,25,23,2,8,92,287187,2766,103
34082,2024,10,10,0,0,100,482092,3998,122
34083,2024,3,3,0,0,100,194610,1862,110
34084,2024,18,17,1,6,94,183781,2065,87
34085,2024,4,4,0,0,100,305780,2848,101
34086,2024,11,11,0,0,100,119699,1749,80
34087,2024,31,27,4,13,87,340877,3272,106
34088,2024,53,40,13,25,75,285804,3036,98
34089,2024,20,20,0,0,100,206716,2086,100
34090,2024,85,57,28,33,67,333751,3813,90
34091,2024,1,1,0,0,100,100000,1639,61
34092,2024,9,9,0,0,100,164528,1752,85
34093,2024,3,3,0,0,100,107467,1113,94
34094,2024,13,13,0,0,100,218034,2336,88
34095,2024,70,53,17,24,76,291458,3567,80
34096,2024,9,9,0,0,100,115253,1441,81
34097,2024,10,10,0,0,100,144988,1279,108
34098,2024,4,4,0,0,100,105425,1080,92
34100,2024,3,3,0,0,100,50992,833,58
34101,2024,62,59,3,5,95,237546,2640,89
34102,2024,6,6,0,0,100,392009,2788,137
34103,2024,13,13,0,0,100,203402,2104,101
34104,2024,1,1,0,0,100,300000,1875,160
34105,2024,4,4,0,0,100,259302,3266,91
34106,2024,1,1,0,0,100,153000,2186,70
34107,2024,4,4,0,0,100,85700,1171,76
34108,2024,358,162,196,55,45,215883,3623,63
34109,2024,19,19,0,0,100,159793,1970,82
34110,2024,1,1,0,0,100,385000,3500,110
34111,2024,48,18,30,62,38,129419,1815,70
34112,2024,1,1,0,0,100,598500,3741,160
34113,2024,55,41,14,25,75,270079,3132,86
34114,2024,69,56,13,19,81,253124,2814,89
34115,2024,1,1,0,0,100,235000,2061,114
34116,2024,110,40,70,64,36,254357,3662,64
34117,2024,23,14,9,39,61,68634,953,74
34118,2024,4,4,0,0,100,618275,5061,123
34119,2024,18,15,3,17,83,150025,1906,84
34120,2024,67,38,29,43,57,348890,3924,89
34121,2024,5,5,0,0,100,96936,1556,77
34122,2024,9,9,0,0,100,247862,2454,103
34123,2024,142,70,72,51,49,277863,3330,83
34124,2024,2,2,0,0,100,205000,3186,48
34126,2024,73,23,50,68,32,110904,2247,53
34127,2024,36,36,0,0,100,351069,3360,109
34128,2024,12,10,2,17,83,176082,2034,91
34129,2024,199,96,103,52,48,390629,4616,86
34130,2024,35,34,1,3,97,258175,2525,100
34131,2024,4,4,0,0,100,188200,2502,81
34132,2024,1,1,0,0,100,225000,2473,91
34134,2024,38,24,14,37,63,252467,3466,74
34135,2024,60,57,3,5,95,202716,2129,95
34136,2024,20,18,2,10,90,181014,2161,86
34137,2024,1,1,0,0,100,383300,3616,106
34138,2024,4,4,0,0,100,297100,2283,114
34139,2024,23,22,1,4,96,229782,2336,94
34140,2024,30,28,2,7,93,247462,2382,103
34141,2024,10,10,0,0,100,163821,1622,100
34142,2024,81,33,48,59,41,141743,1836,74
34143,2024,43,39,4,9,91,214739,3901,66
34144,2024,7,7,0,0,100,155850,1521,97
34145,2024,311,175,136,44,56,203345,2617,77
34146,2024,49,43,6,12,88,274479,3084,90
34147,2024,53,52,1,2,98,201525,2173,89
34148,2024,48,42,6,12,88,216014,2229,95
34149,2024,11,11,0,0,100,267870,2406,110
34150,2024,288,128,160,56,44,206479,4206,52
34151,2024,87,68,19,22,78,236546,2854,85
34152,2024,8,8,0,0,100,397690,3340,117
34153,2024,18,13,5,28,72,393240,3811,99
34154,2024,315,100,215,68,32,256443,4704,56
34155,2024,27,26,1,4,96,175738,2020,88
34157,2024,184,112,72,39,61,275833,3577,79
34158,2024,1,1,0,0,100,159000,1963,81
34159,2024,41,36,5,12,88,290869,3390,85
34160,2024,5,5,0,0,100,289291,2462,112
34161,2024,34,31,3,9,91,221387,2602,88
34162,2024,76,58,18,24,76,178153,2159,85
34163,2024,23,20,3,13,87,322344,3283,98
34164,2024,4,4,0,0,100,629642,4457,146
34165,2024,28,21,7,25,75,216919,2927,80
34166,2024,40,37,3,8,92,250869,2571,95
34167,2024,1,1,0,0,100,329700,2659,124
34168,2024,1,1,0,0,100,188500,3847,49
34169,2024,42,32,10,24,76,584727,4582,128
34170,2024,7,7,0,0,100,213273,1714,123
34172,2024,3973,400,3573,90,10,197301,3400,59
34173,2024,10,9,1,10,90,296140,3445,99
34174,2024,6,6,0,0,100,284424,3382,97
34176,2024,23,21,2,9,91,399059,3975,99
34177,2024,4,4,0,0,100,251081,2254,105
34178,2024,42,40,2,5,95,180119,2066,90
34179,2024,8,7,1,12,88,405049,3247,116
34180,2024,24,21,3,12,88,196420,2080,90
34181,2024,21,20,1,5,95,215102,2584,88
34182,2024,23,21,2,9,91,228026,2336,99
34183,2024,60,57,3,5,95,186001,2021,91
34184,2024,14,14,0,0,100,180556,2160,86
34185,2024,5,5,0,0,100,285126,3181,100
34186,2024,3,3,0,0,100,323900,3529,95
34187,2024,7,5,2,29,71,177000,1693,108
34188,2024,3,3,0,0,100,267588,2886,97
34189,2024,29,29,0,0,100,160973,1761,89
34190,2024,6,6,0,0,100,64783,859,81
34191,2024,4,4,0,0,100,176934,1615,87
34192,2024,228,35,193,85,15,261142,5402,49
34193,2024,11,11,0,0,100,139656,1641,82
34194,2024,56,49,7,12,88,196216,2396,82
34195,2024,2,2,0,0,100,343500,2724,117
34196,2024,5,5,0,0,100,93650,1457,69
34197,2024,15,14,1,7,93,226018,2100,99
34198,2024,116,92,24,21,79,443585,4514,96
34199,2024,106,53,53,50,50,180146,2479,73
34200,2024,5,5,0,0,100,116984,1089,87
34201,2024,3,3,0,0,100,192293,2419,88
34202,2024,65,45,20,31,69,295905,3591,84
34203,2024,14,13,1,7,93,226985,2257,98
34204,2024,21,21,0,0,100,253955,2722,92
34205,2024,2,2,0,0,100,224945,2094,99
34206,2024,4,4,0,0,100,158750,2138,74
34207,2024,53,52,1,2,98,215703,2721,82
34208,2024,6,6,0,0,100,224185,2714,83
34209,2024,101,85,16,16,84,182727,3382,60
34210,2024,21,20,1,5,95,183235,2278,84
34211,2024,12,10,2,17,83,105295,1559,70
34212,2024,3,3,0,0,100,172200,2357,74
34213,2024,71,47,24,34,66,265203,3050,84
34214,2024,21,20,1,5,95,189065,2191,83
34215,2024,9,8,1,11,89,275552,2531,108
34216,2024,3,3,0,0,100,264650,2065,116
34217,2024,43,32,11,26,74,363975,3968,94
34218,2024,4,4,0,0,100,223750,2007,114
34219,2024,5,5,0,0,100,107040,1524,69
34220,2024,2,2,0,0,100,191000,1833,100
34221,2024,7,6,1,14,86,180479,2021,84
34222,2024,4,4,0,0,100,381205,3225,122
34223,2024,15,15,0,0,100,276868,2422,107
34224,2024,19,17,2,11,89,243089,2374,100
34225,2024,53,45,8,15,85,142612,1684,85
34226,2024,30,29,1,3,97,160441,1495,101
34227,2024,18,15,3,17,83,358655,3829,95
34228,2024,1,1,0,0,100,55000,1019,54
34229,2024,13,12,1,8,92,131410,1574,85
34230,2024,2,2,0,0,100,231500,2614,96
34232,2024,15,15,0,0,100,129077,2294,64
34233,2024,2,2,0,0,100,184175,2092,90
34234,2024,6,6,0,0,100,112315,1325,84
34235,2024,5,5,0,0,100,157336,2402,75
34236,2024,1,1,0,0,100,1400000,6604,212
34237,2024,43,40,3,7,93,214047,2197,95
34239,2024,63,50,13,21,79,217066,2517,87
34240,2024,44,21,23,52,48,330313,4001,82
34241,2024,5,4,1,20,80,190406,2290,83
34242,2024,9,8,1,11,89,355598,3400,104
34243,2024,15,13,2,13,87,191777,2552,77
34244,2024,32,21,11,34,66,329549,3928,84
34245,2024,35,32,3,9,91,153439,1728,89
34246,2024,8,8,0,0,100,272372,3117,89
34247,2024,35,29,6,17,83,636466,4704,132
34248,2024,4,4,0,0,100,405278,4525,95
34249,2024,25,23,2,8,92,383621,3466,110
34250,2024,9,9,0,0,100,110650,1333,78
34251,2024,9,9,0,0,100,210437,2332,86
34252,2024,12,11,1,8,92,135021,1571,82
34254,2024,4,4,0,0,100,306250,2938,106
34255,2024,102,84,18,18,82,464269,4183,109
34256,2024,14,13,1,7,93,410823,3456,117
34257,2024,2,2,0,0,100,49500,858,58
34258,2024,26,26,0,0,100,252594,2234,105
34259,2024,66,21,45,68,32,212180,2836,67
34260,2024,13,10,3,23,77,84840,1295,70
34261,2024,5,4,1,20,80,241300,2843,85
34263,2024,4,4,0,0,100,452600,3769,122
34264,2024,1,1,0,0,100,296000,2368,125
34265,2024,2,2,0,0,100,466500,4712,97
34266,2024,4,4,0,0,100,464790,3202,147
34267,2024,14,13,1,7,93,240544,2697,92
34268,2024,6,6,0,0,100,222450,2387,89
34269,2024,3,3,0,0,100,181667,2140,95
34270,2024,127,72,55,43,57,343816,4031,85
34271,2024,3,3,0,0,100,120045,1373,83
34272,2024,15,15,0,0,100,330601,3714,93
34273,2024,1,1,0,0,100,106870,2969,36
34274,2024,20,19,1,5,95,352680,3142,115
34276,2024,27,22,5,19,81,346504,3703,97
34277,2024,3,3,0,0,100,51788,799,76
34278,2024,1,1,0,0,100,120000,2143,56
34279,2024,8,7,1,12,88,120175,1207,92
34280,2024,4,4,0,0,100,295445,3576,102
34281,2024,31,30,1,3,97,260617,2381,99
34282,2024,14,11,3,21,79,242924,2864,82
34284,2024,24,22,2,8,92,90039,1241,71
34285,2024,10,9,1,10,90,292436,2637,94
34286,2024,7,7,0,0,100,91214,1659,65
34287,2024,2,2,0,0,100,62405,1250,54
34288,2024,11,11,0,0,100,378259,3761,111
34289,2024,57,56,1,2,98,194648,2218,90
34290,2024,3,3,0,0,100,371167,4492,84
34291,2024,6,6,0,0,100,141181,1709,82
34292,2024,4,4,0,0,100,245434,2329,120
34293,2024,37,32,5,14,86,119181,1734,70
34294,2024,6,4,2,33,67,269955,3079,90
34295,2024,18,16,2,11,89,296147,3425,84
34296,2024,8,7,1,12,88,286458,2994,96
34297,2024,4,4,0,0,100,465262,3246,152
34298,2024,57,54,3,5,95,279451,2989,94
34299,2024,115,90,25,22,78,224329,2917,79
34300,2024,68,64,4,6,94,225000,2255,97
34301,2024,949,115,834,88,12,226279,3856,58
34302,2024,21,21,0,0,100,209268,2019,101
34303,2024,3,3,0,0,100,223333,2337,89
34304,2024,6,5,1,17,83,194243,3054,71
34305,2024,1,1,0,0,100,20000,417,48
34307,2024,20,16,4,20,80,375180,3756,103
34308,2024,6,5,1,17,83,185308,2162,75
34309,2024,36,32,4,11,89,453425,3889,118
34310,2024,40,38,2,5,95,192094,2028,95
34311,2024,32,30,2,6,94,254992,2588,96
34312,2024,13,11,2,15,85,187605,1786,99
34313,2024,7,6,1,14,86,163698,2268,106
34314,2024,4,4,0,0,100,388382,3302,121
34315,2024,6,6,0,0,100,196992,2362,85
34316,2024,1,1,0,0,100,179550,1796,100
34317,2024,6,6,0,0,100,139567,2017,75
34318,2024,6,6,0,0,100,270858,2524,104
34319,2024,2,2,0,0,100,263025,1848,124
34320,2024,12,12,0,0,100,369007,3478,110
34321,2024,14,11,3,21,79,319384,3315,94
34322,2024,8,8,0,0,100,428619,4111,101
34323,2024,1,1,0,0,100,427200,2558,167
34324,2024,229,93,136,59,41,174935,3739,48
34325,2024,23,22,1,4,96,174336,2110,84
34326,2024,2,2,0,0,100,157500,1681,110
34327,2024,47,31,16,34,66,320918,3810,84
34328,2024,9,9,0,0,100,229134,2089,112
34329,2024,48,43,5,10,90,195086,3200,67
34331,2024,2,2,0,0,100,89235,1152,78
34332,2024,148,101,47,32,68,175425,3062,60
34333,2024,65,64,1,2,98,241046,5609,51
34334,2024,6,6,0,0,100,192987,1826,93
34335,2024,9,9,0,0,100,139433,1603,85
34336,2024,69,51,18,26,74,184476,2249,82
34337,2024,70,56,14,20,80,302780,3866,78
34339,2024,3,3,0,0,100,366273,3171,120
34340,2024,12,12,0,0,100,410682,3344,120
34341,2024,34,34,0,0,100,251219,2570,96
34342,2024,2,2,0,0,100,490580,4153,117
34343,2024,3,3,0,0,100,407413,3296,129
34344,2024,660,43,617,93,7,221747,5649,39
35001,2024,53,31,22,42,58,261708,3011,89
35002,2024,12,12,0,0,100,215265,2238,93
35003,2024,8,8,0,0,100,247717,2333,110
35004,2024,51,49,2,4,96,117825,1567,83
35005,2024,1,1,0,0,100,35000,507,69
35006,2024,46,41,5,11,89,189187,2104,95
35007,2024,6,6,0,0,100,210283,1807,122
35008,2024,4,4,0,0,100,220760,1659,130
35009,2024,12,12,0,0,100,227482,2311,97
35010,2024,12,12,0,0,100,287862,2385,123
35012,2024,82,63,19,23,77,197672,2129,98
35013,2024,42,42,0,0,100,172828,1759,101
35014,2024,23,23,0,0,100,150858,1429,101
35015,2024,18,17,1,6,94,165682,1952,91
35016,2024,20,20,0,0,100,201146,2284,97
35017,2024,9,8,1,11,89,201111,2289,89
35018,2024,9,9,0,0,100,98087,1317,72
35019,2024,22,21,1,5,95,148131,1713,93
35021,2024,11,11,0,0,100,183582,1795,103
35022,2024,6,6,0,0,100,224032,2149,105
35023,2024,41,33,8,20,80,237714,2512,96
35024,2024,106,53,53,50,50,301284,3523,86
35025,2024,9,9,0,0,100,179455,1515,118
35026,2024,2,2,0,0,100,189000,1538,122
35027,2024,16,16,0,0,100,189162,1846,107
35028,2024,7,7,0,0,100,235043,1695,139
35029,2024,27,27,0,0,100,187917,1931,102
35030,2024,7,7,0,0,100,157372,1806,85
35031,2024,16,16,0,0,100,217238,2000,108
35032,2024,65,36,29,45,55,229576,2515,91
35033,2024,36,34,2,6,94,272099,2361,120
35034,2024,17,15,2,12,88,162847,1874,97
35035,2024,4,4,0,0,100,171088,1752,98
35037,2024,70,59,11,16,84,237874,2466,98
35038,2024,5,5,0,0,100,192346,1953,101
35039,2024,28,21,7,25,75,226345,2648,85
35040,2024,40,33,7,18,82,199647,2202,91
35041,2024,10,10,0,0,100,232695,2143,110
35042,2024,6,6,0,0,100,158500,1449,100
35044,2024,6,6,0,0,100,146233,1982,80
35045,2024,10,10,0,0,100,147850,1741,90
35046,2024,7,7,0,0,100,115864,1307,86
35047,2024,228,111,117,51,49,252904,3122,84
35049,2024,86,56,30,35,65,349101,4227,83
35050,2024,5,5,0,0,100,258422,1691,162
35051,2024,176,87,89,51,49,332331,3829,90
35052,2024,8,8,0,0,100,255519,2267,126
35054,2024,13,13,0,0,100,196533,2375,83
35055,2024,112,24,88,79,21,242740,3246,75
35056,2024,8,8,0,0,100,166638,1583,109
35057,2024,11,8,3,27,73,163032,1991,81
35058,2024,11,11,0,0,100,237296,2123,117
35059,2024,43,30,13,30,70,270480,3175,88
35060,2024,6,6,0,0,100,236679,1902,124
35061,2024,3,3,0,0,100,150000,1851,81
35062,2024,26,25,1,4,96,190738,1746,109
35063,2024,8,8,0,0,100,155631,1937,79
35064,2024,20,20,0,0,100,120520,1387,91
35065,2024,14,13,1,7,93,292850,2527,115
35066,2024,88,42,46,52,48,228455,3055,78
35067,2024,10,10,0,0,100,253156,2416,112
35068,2024,57,39,18,32,68,244369,2637,96
35069,2024,107,85,22,21,79,280834,2725,104
35070,2024,20,17,3,15,85,231399,2601,88
35071,2024,3,3,0,0,100,177333,1478,120
35072,2024,18,17,1,6,94,134672,1790,86
35075,2024,8,8,0,0,100,157525,1414,130
35076,2024,40,32,8,20,80,270217,2853,98
35077,2024,8,8,0,0,100,138711,1234,120
35078,2024,14,13,1,7,93,205284,2316,91
35079,2024,16,15,1,6,94,315272,2955,113
35080,2024,20,18,2,10,90,234562,2412,104
35081,2024,7,7,0,0,100,241000,2554,98
35082,2024,8,8,0,0,100,154688,1739,91
35084,2024,8,8,0,0,100,179479,1941,100
35085,2024,76,60,16,21,79,201856,2308,88
35086,2024,5,5,0,0,100,171600,1640,106
35087,2024,5,5,0,0,100,179342,1594,118
35088,2024,27,21,6,22,78,227682,2535,93
35089,2024,2,2,0,0,100,192000,1855,102
35090,2024,29,27,2,7,93,211683,2237,97
35091,2024,8,8,0,0,100,157500,1733,83
35092,2024,6,6,0,0,100,176833,2010,91
35093,2024,276,108,168,61,39,397576,5677,72
35094,2024,15,15,0,0,100,177794,1986,94
35095,2024,89,55,34,38,62,205457,2355,89
35096,2024,27,20,7,26,74,215219,2183,105
35097,2024,17,17,0,0,100,207507,1826,115
35098,2024,8,8,0,0,100,184435,2105,90
35099,2024,42,24,18,43,57,241316,2574,94
35101,2024,15,15,0,0,100,195287,1835,109
35102,2024,5,5,0,0,100,125586,1885,80
35103,2024,9,9,0,0,100,120111,1451,89
35104,2024,17,17,0,0,100,138294,1752,85
35105,2024,15,15,0,0,100,176070,2072,88
35106,2024,9,9,0,0,100,191076,1854,110
35107,2024,17,17,0,0,100,269745,2469,110
35108,2024,7,7,0,0,100,193110,1960,100
35109,2024,14,12,2,14,86,222929,2139,106
35110,2024,2,2,0,0,100,195000,1266,142
35111,2024,4,4,0,0,100,113140,1079,103
35114,2024,5,5,0,0,100,92442,1242,70
35115,2024,304,163,141,46,54,146300,1853,81
35116,2024,24,23,1,4,96,202004,2307,91
35117,2024,17,16,1,6,94,156291,1335,116
35118,2024,15,15,0,0,100,219524,2293,99
35119,2024,8,8,0,0,100,163404,1406,112
35120,2024,57,46,11,19,81,279808,3048,94
35121,2024,11,10,1,9,91,222525,1980,115
35122,2024,22,21,1,5,95,288721,2966,94
35123,2024,43,39,4,9,91,227221,2393,96
35124,2024,29,29,0,0,100,173705,1536,117
35125,2024,59,49,10,17,83,135823,1532,92
35126,2024,101,77,24,24,76,214647,2418,89
35127,2024,28,28,0,0,100,229223,2244,103
35128,2024,18,17,1,6,94,180104,2216,84
35130,2024,20,19,1,5,95,200558,2304,86
35131,2024,31,25,6,19,81,285061,2852,102
35132,2024,14,14,0,0,100,230629,2338,98
35133,2024,28,27,1,4,96,180708,2113,87
35134,2024,1,1,0,0,100,197668,2865,69
35135,2024,21,18,3,14,86,194363,2102,102
35136,2024,94,61,33,35,65,209873,2391,89
35137,2024,20,20,0,0,100,243268,2181,111
35138,2024,8,8,0,0,100,257444,2236,120
35139,2024,67,51,16,24,76,272207,2630,104
35140,2024,9,9,0,0,100,129029,1682,83
35141,2024,13,13,0,0,100,213577,1906,112
35142,2024,16,14,2,12,88,162998,1440,113
35143,2024,8,8,0,0,100,132635,1598,82
35144,2024,14,11,3,21,79,193546,3014,83
35145,2024,20,20,0,0,100,143604,1406,105
35146,2024,11,11,0,0,100,222901,2338,96
35148,2024,1,1,0,0,100,210000,3500,60
35149,2024,20,20,0,0,100,227190,2461,100
35150,2024,37,37,0,0,100,209701,2110,99
35151,2024,9,9,0,0,100,141754,1306,105
35152,2024,90,72,18,20,80,260829,2746,99
35153,2024,5,5,0,0,100,248104,2622,118
35154,2024,16,16,0,0,100,148202,1565,93
35155,2024,4,4,0,0,100,185579,1787,110
35156,2024,1,1,0,0,100,167000,1452,115
35157,2024,5,5,0,0,100,160939,1621,112
35159,2024,1,1,0,0,100,230000,1533,150
35160,2024,4,4,0,0,100,114500,1674,78
35161,2024,18,18,0,0,100,177301,1864,93
35162,2024,42,42,0,0,100,124154,1416,94
35163,2024,21,21,0,0,100,125940,1256,102
35164,2024,12,12,0,0,100,150492,1617,95
35165,2024,10,10,0,0,100,118800,1441,85
35166,2024,9,9,0,0,100,221711,2104,106
35167,2024,40,39,1,2,98,146992,1464,106
35168,2024,39,39,0,0,100,178651,2090,92
35169,2024,18,18,0,0,100,150663,1652,91
35170,2024,5,4,1,20,80,170800,1705,103
35171,2024,14,14,0,0,100,139280,1768,76
35172,2024,20,20,0,0,100,202865,2298,93
35173,2024,71,54,17,24,76,282527,3059,93
35174,2024,8,8,0,0,100,109625,1137,90
35175,2024,15,15,0,0,100,150664,1701,94
35176,2024,80,75,5,6,94,150691,1769,87
35177,2024,38,27,11,29,71,292624,2900,106
35178,2024,14,14,0,0,100,248641,2139,116
35179,2024,54,50,4,7,93,194756,2297,88
35180,2024,7,7,0,0,100,179583,1478,117
35181,2024,20,19,1,5,95,443684,4038,112
35183,2024,6,6,0,0,100,187416,1900,107
35184,2024,61,48,13,21,79,194341,2242,89
35185,2024,1,1,0,0,100,76000,1689,45
35186,2024,13,13,0,0,100,254141,2340,103
35187,2024,15,15,0,0,100,256732,2280,116
35188,2024,63,45,18,29,71,236631,2445,99
35189,2024,32,23,9,28,72,340301,3502,95
35190,2024,2,2,0,0,100,36500,676,54
35191,2024,25,25,0,0,100,136690,1373,102
35192,2024,3,3,0,0,100,260300,1985,135
35193,2024,30,25,5,17,83,221108,2360,94
35194,2024,7,7,0,0,100,173214,2025,85
35195,2024,25,23,2,8,92,210024,2102,104
35196,2024,74,38,36,49,51,239667,2926,84
35197,2024,9,9,0,0,100,246439,2371,104
35198,2024,7,6,1,14,86,179957,1616,113
35199,2024,1,1,0,0,100,234000,1733,135
35200,2024,2,2,0,0,100,182005,1440,120
35201,2024,18,18,0,0,100,170278,1561,112
35202,2024,10,10,0,0,100,191680,1754,113
35203,2024,2,2,0,0,100,355070,2102,172
35204,2024,45,45,0,0,100,286235,2586,112
35205,2024,7,7,0,0,100,164043,1392,121
35206,2024,98,48,50,51,49,250871,2800,91
35207,2024,74,46,28,38,62,261868,2753,95
35208,2024,45,37,8,18,82,261580,2805,96
35210,2024,108,65,43,40,60,326630,3315,103
35211,2024,27,25,2,7,93,193420,1677,116
35212,2024,7,7,0,0,100,190070,2234,84
35214,2024,10,10,0,0,100,120040,1504,77
35215,2024,17,17,0,0,100,200172,1745,113
35216,2024,21,16,5,24,76,236422,2398,102
35217,2024,17,17,0,0,100,136900,1575,84
35218,2024,5,5,0,0,100,262300,2282,115
35219,2024,39,37,2,5,95,159593,1680,95
35220,2024,27,25,2,7,93,234201,2497,100
35221,2024,27,27,0,0,100,199935,2019,100
35222,2024,22,22,0,0,100,146528,1745,88
35223,2024,38,34,4,11,89,186948,2147,88
35224,2024,16,16,0,0,100,248323,2428,106
35225,2024,11,9,2,18,82,168485,1711,97
35226,2024,15,14,1,7,93,191266,1907,101
35227,2024,18,14,4,22,78,243130,2613,95
35228,2024,77,49,28,36,64,253861,3218,81
35229,2024,8,8,0,0,100,188435,1753,112
35230,2024,6,6,0,0,100,104617,1174,83
35231,2024,16,13,3,19,81,165292,1933,90
35232,2024,6,6,0,0,100,127625,1160,116
35233,2024,10,10,0,0,100,130416,1964,72
35234,2024,9,9,0,0,100,157131,1630,102
35235,2024,9,9,0,0,100,114389,1206,90
35236,2024,134,75,59,44,56,166703,2120,83
35237,2024,10,10,0,0,100,122800,1248,98
35238,2024,2951,398,2553,87,13,239906,3831,64
35239,2024,41,38,3,7,93,194108,1905,103
35240,2024,109,44,65,60,40,241653,2980,83
35241,2024,36,29,7,19,81,383901,3839,101
35242,2024,8,8,0,0,100,102332,1208,81
35243,2024,17,17,0,0,100,208395,1902,110
35244,2024,2,2,0,0,100,45950,483,94
35245,2024,33,27,6,18,82,227920,2355,103
35246,2024,10,10,0,0,100,205150,2022,102
35247,2024,22,17,5,23,77,148546,1696,88
35248,2024,5,5,0,0,100,119060,1929,65
35249,2024,13,13,0,0,100,121416,1319,89
35250,2024,26,21,5,19,81,264179,2756,98
35251,2024,42,32,10,24,76,235856,2417,98
35252,2024,11,11,0,0,100,184194,1712,107
35253,2024,31,28,3,10,90,253980,2394,110
35255,2024,13,11,2,15,85,251468,2846,94
35256,2024,49,40,9,18,82,589504,6491,89
35257,2024,46,46,0,0,100,166599,1699,98
35258,2024,2,2,0,0,100,213250,2954,70
35259,2024,16,15,1,6,94,154084,1932,86
35260,2024,8,8,0,0,100,134050,1499,88
35261,2024,2,2,0,0,100,142700,1344,112
35262,2024,3,3,0,0,100,206000,2323,97
35263,2024,33,32,1,3,97,519200,4344,121
35264,2024,16,16,0,0,100,247556,2304,108
35265,2024,31,28,3,10,90,194039,1955,102
35266,2024,45,34,11,24,76,236223,2576,94
35268,2024,4,4,0,0,100,180572,1738,114
35270,2024,3,3,0,0,100,139975,1612,77
35271,2024,21,21,0,0,100,152243,1680,105
35272,2024,13,13,0,0,100,184972,1749,100
35273,2024,21,21,0,0,100,161601,1772,98
35274,2024,6,5,1,17,83,223433,2160,107
35275,2024,37,30,7,19,81,279341,2790,102
35276,2024,4,4,0,0,100,240675,1984,119
35277,2024,4,4,0,0,100,103625,1443,72
35278,2024,79,41,38,48,52,361159,3580,101
35279,2024,19,18,1,5,95,195771,2360,87
35280,2024,13,12,1,8,92,161442,1579,102
35281,2024,184,51,133,72,28,207586,3144,68
35282,2024,24,24,0,0,100,186076,1892,101
35283,2024,13,13,0,0,100,215135,2211,99
35284,2024,31,25,6,19,81,356641,3793,94
35285,2024,15,15,0,0,100,161428,1809,102
35286,2024,1,1,0,0,100,166000,3074,54
35287,2024,45,33,12,27,73,478512,5105,94
35288,2024,769,280,489,64,36,345995,4837,72
35289,2024,15,14,1,7,93,167060,1634,106
35290,2024,8,8,0,0,100,205650,1605,119
35291,2024,11,11,0,0,100,149605,1692,102
35292,2024,16,16,0,0,100,133262,1496,92
35294,2024,23,23,0,0,100,149043,1822,84
35295,2024,6,5,1,17,83,181517,1561,120
35296,2024,12,12,0,0,100,233854,2397,108
35297,2024,70,51,19,27,73,134672,1701,82
35299,2024,55,46,9,16,84,304164,3216,98
35300,2024,7,7,0,0,100,214171,2011,113
35302,2024,6,6,0,0,100,228654,2187,101
35304,2024,12,12,0,0,100,180724,1693,110
35305,2024,5,5,0,0,100,216090,3612,72
35306,2024,21,20,1,5,95,329223,3333,106
35307,2024,7,7,0,0,100,171216,1741,95
35308,2024,54,54,0,0,100,187396,1959,95
35309,2024,10,10,0,0,100,166360,1819,91
35310,2024,11,11,0,0,100,201073,1597,128
35311,2024,3,3,0,0,100,151310,1477,105
35312,2024,21,21,0,0,100,187923,2129,90
35314,2024,10,10,0,0,100,417318,4466,100
35315,2024,10,10,0,0,100,316000,2749,114
35316,2024,12,12,0,0,100,161875,1562,109
35317,2024,6,6,0,0,100,208167,2131,106
35318,2024,10,10,0,0,100,210412,2583,96
35319,2024,21,15,6,29,71,195834,2089,93
35320,2024,5,5,0,0,100,226760,1964,114
35321,2024,3,3,0,0,100,202833,3113,67
35322,2024,10,10,0,0,100,192264,1823,104
35324,2024,8,8,0,0,100,153375,1480,105
35325,2024,3,3,0,0,100,90000,1257,64
35326,2024,19,18,1,5,95,194719,2002,99
35327,2024,37,33,4,11,89,257355,2620,100
35328,2024,26,25,1,4,96,126857,1469,82
35329,2024,7,7,0,0,100,115543,1295,91
35330,2024,15,14,1,7,93,151132,1478,102
35331,2024,26,24,2,8,92,207977,2267,94
35332,2024,7,7,0,0,100,147975,1417,107
35333,2024,15,11,4,27,73,147517,1918,78
35334,2024,76,51,25,33,67,323597,3164,103
35335,2024,10,10,0,0,100,123570,1435,88
35336,2024,1,1,0,0,100,278000,1986,140
35337,2024,39,31,8,21,79,208067,2634,84
35338,2024,16,16,0,0,100,191747,1900,103
35339,2024,7,7,0,0,100,138281,1533,95
35340,2024,11,11,0,0,100,203097,2069,108
35342,2024,1,1,0,0,100,175000,2500,70
35343,2024,13,12,1,8,92,198137,2068,95
35345,2024,8,8,0,0,100,191512,1887,102
35347,2024,22,22,0,0,100,180177,1757,105
35350,2024,9,9,0,0,100,170193,2021,100
35351,2024,10,8,2,20,80,190230,2320,88
35352,2024,79,53,26,33,67,264951,2743,97
35353,2024,70,32,38,54,46,251684,3126,82
35354,2024,5,5,0,0,100,147800,1502,102
35355,2024,13,13,0,0,100,217783,1889,116
35356,2024,15,15,0,0,100,327915,2905,117
35357,2024,8,8,0,0,100,155084,1588,94
35358,2024,14,14,0,0,100,244821,2592,96
35359,2024,10,9,1,10,90,165800,1373,131
35360,2024,169,103,66,39,61,219216,2565,89
35361,2024,5,5,0,0,100,284998,2987,109
35362,2024,16,14,2,12,88,155814,1905,93
35363,2024,35,22,13,37,63,244839,2801,87
36001,2024,25,25,0,0,100,89456,1148,83
36002,2024,2,2,0,0,100,67000,822,96
36003,2024,9,9,0,0,100,72000,676,104
36004,2024,7,7,0,0,100,79571,1214,75
36005,2024,42,42,0,0,100,130107,1322,96
36006,2024,69,64,5,7,93,114487,1289,92
36007,2024,5,5,0,0,100,59500,777,92
36008,2024,3,3,0,0,100,69833,851,80
36009,2024,12,12,0,0,100,146108,1269,112
36010,2024,13,13,0,0,100,73615,896,77
36011,2024,1,1,0,0,100,105000,1207,87
36012,2024,1,1,0,0,100,62500,625,100
36013,2024,7,7,0,0,100,51360,754,71
36014,2024,2,2,0,0,100,59500,1334,48
36015,2024,1,1,0,0,100,40000,597,67
36016,2024,8,8,0,0,100,89250,742,115
36017,2024,4,4,0,0,100,94750,897,101
36018,2024,86,80,6,7,93,83719,969,87
36019,2024,2,2,0,0,100,76750,896,84
36020,2024,2,2,0,0,100,165500,1508,120
36021,2024,12,12,0,0,100,101817,1000,94
36022,2024,6,6,0,0,100,94767,1143,85
36023,2024,2,2,0,0,100,139375,991,118
36024,2024,2,2,0,0,100,39750,629,60
36025,2024,7,7,0,0,100,87454,918,93
36026,2024,1,1,0,0,100,69500,939,74
36027,2024,2,2,0,0,100,118250,972,119
36028,2024,1,1,0,0,100,15000,429,35
36029,2024,6,6,0,0,100,63371,793,81
36030,2024,3,3,0,0,100,57004,742,102
36031,2024,50,50,0,0,100,94839,1253,79
36032,2024,4,4,0,0,100,93938,922,103
36033,2024,3,3,0,0,100,65167,764,88
36034,2024,35,35,0,0,100,91223,1209,79
36035,2024,17,17,0,0,100,85747,1137,79
36037,2024,2,2,0,0,100,105000,1403,67
36038,2024,3,3,0,0,100,50333,1041,53
36041,2024,2,2,0,0,100,129000,1498,87
36042,2024,11,11,0,0,100,82627,1041,79
36043,2024,8,8,0,0,100,61625,713,83
36044,2024,496,319,177,36,64,113357,1388,82
36045,2024,34,30,4,12,88,73895,869,81
36046,2024,55,46,9,16,84,104023,1126,91
36047,2024,10,10,0,0,100,82705,860,84
36048,2024,4,4,0,0,100,122750,1137,129
36049,2024,2,2,0,0,100,71500,993,72
36050,2024,6,6,0,0,100,135476,1395,109
36051,2024,2,2,0,0,100,85750,848,86
36052,2024,3,3,0,0,100,213333,1201,178
36053,2024,6,6,0,0,100,80833,842,96
36054,2024,2,2,0,0,100,90278,1522,52
36055,2024,11,11,0,0,100,74102,908,89
36056,2024,15,15,0,0,100,111940,1035,108
36057,2024,5,5,0,0,100,188041,1535,137
36058,2024,14,14,0,0,100,89445,1056,86
36059,2024,2,2,0,0,100,185000,1697,108
36060,2024,10,10,0,0,100,68000,1063,72
36061,2024,9,9,0,0,100,117984,1098,104
36062,2024,16,16,0,0,100,115383,1136,96
36063,2024,89,83,6,7,93,127526,1447,87
36064,2024,4,4,0,0,100,156225,1586,100
36065,2024,1,1,0,0,100,44000,863,51
36066,2024,4,4,0,0,100,67125,792,83
36067,2024,1,1,0,0,100,219050,1165,188
36068,2024,4,4,0,0,100,83125,704,99
36069,2024,22,22,0,0,100,67691,932,74
36070,2024,25,25,0,0,100,108802,1385,80
36071,2024,7,7,0,0,100,133244,1314,105
36073,2024,1,1,0,0,100,50000,694,72
36074,2024,9,9,0,0,100,92111,1111,85
36075,2024,2,2,0,0,100,55400,584,92
36076,2024,2,2,0,0,100,131000,1158,116
36077,2024,4,4,0,0,100,91250,1040,88
36078,2024,5,5,0,0,100,139190,1313,111
36079,2024,1,1,0,0,100,48000,1091,44
36080,2024,2,2,0,0,100,92500,876,128
36081,2024,7,7,0,0,100,72957,993,75
36082,2024,4,4,0,0,100,97375,1282,88
36083,2024,2,2,0,0,100,142858,772,166
36084,2024,5,5,0,0,100,61340,1018,67
36085,2024,8,8,0,0,100,121886,1150,99
36086,2024,11,11,0,0,100,106318,1184,91
36087,2024,3,3,0,0,100,60667,744,79
36088,2024,134,124,10,7,93,88344,1062,84
36089,2024,3,3,0,0,100,81667,925,96
36090,2024,4,4,0,0,100,72000,786,86
36091,2024,8,7,1,12,88,155500,1377,114
36092,2024,4,4,0,0,100,53875,754,72
36093,2024,29,29,0,0,100,100922,1162,86
36094,2024,8,8,0,0,100,49775,688,76
36095,2024,5,5,0,0,100,73300,901,88
36096,2024,3,3,0,0,100,84000,962,79
36097,2024,9,9,0,0,100,97349,1215,81
36098,2024,1,1,0,0,100,38000,760,50
36099,2024,4,4,0,0,100,40762,693,60
36101,2024,13,13,0,0,100,140377,1326,106
36102,2024,3,3,0,0,100,108833,1350,82
36103,2024,14,13,1,7,93,79807,919,87
36104,2024,5,5,0,0,100,88884,834,103
36105,2024,5,5,0,0,100,69580,1125,73
36106,2024,4,4,0,0,100,39975,541,72
36107,2024,12,12,0,0,100,115411,1068,103
36108,2024,4,4,0,0,100,85498,1048,78
36109,2024,10,10,0,0,100,127061,1313,93
36110,2024,8,8,0,0,100,85362,1068,86
36111,2024,3,3,0,0,100,81833,1156,73
36112,2024,3,3,0,0,100,158000,1613,100
36113,2024,11,11,0,0,100,98945,1072,88
36114,2024,4,4,0,0,100,101000,853,126
36115,2024,1,1,0,0,100,148000,1644,90
36117,2024,6,6,0,0,100,101119,984,94
36118,2024,5,5,0,0,100,165306,1280,90
36119,2024,7,7,0,0,100,79468,979,86
36120,2024,6,6,0,0,100,161820,1799,91
36121,2024,1,1,0,0,100,54000,857,63
36123,2024,13,13,0,0,100,114396,1154,97
36124,2024,2,2,0,0,100,127000,1448,86
36125,2024,1,1,0,0,100,112000,1273,88
36126,2024,9,9,0,0,100,50965,662,84
36127,2024,25,25,0,0,100,129754,1241,99
36128,2024,11,11,0,0,100,150509,1527,111
36129,2024,9,9,0,0,100,139756,1282,113
36130,2024,1,1,0,0,100,74000,712,104
36131,2024,7,7,0,0,100,118914,952,115
36133,2024,2,2,0,0,100,61000,698,79
36134,2024,9,9,0,0,100,136667,1064,119
36135,2024,5,5,0,0,100,54640,677,88
36136,2024,2,2,0,0,100,91820,986,90
36137,2024,8,8,0,0,100,87375,814,104
36138,2024,4,4,0,0,100,91500,843,102
36139,2024,10,10,0,0,100,105160,1165,89
36140,2024,13,13,0,0,100,102515,1228,80
36141,2024,18,18,0,0,100,99772,993,100
36142,2024,19,19,0,0,100,127947,1300,100
36143,2024,7,7,0,0,100,122321,1100,106
36144,2024,3,3,0,0,100,77267,1428,56
36145,2024,3,3,0,0,100,217173,2103,111
36146,2024,5,5,0,0,100,76060,970,82
36147,2024,4,4,0,0,100,90000,700,134
36148,2024,12,12,0,0,100,93493,1109,84
36149,2024,13,13,0,0,100,87385,1119,85
36150,2024,7,7,0,0,100,107883,1233,85
36152,2024,6,6,0,0,100,84750,1095,77
36153,2024,3,3,0,0,100,57167,721,77
36154,2024,15,15,0,0,100,108414,1322,80
36155,2024,11,10,1,9,91,116115,1928,88
36156,2024,5,5,0,0,100,92600,813,120
36157,2024,6,6,0,0,100,99532,1017,100
36158,2024,11,11,0,0,100,75528,837,89
36159,2024,56,56,0,0,100,155693,1641,95
36160,2024,1,1,0,0,100,98000,1256,78
36161,2024,13,13,0,0,100,103685,1039,98
36162,2024,14,14,0,0,100,112250,1053,102
36163,2024,9,9,0,0,100,87244,889,99
36164,2024,1,1,0,0,100,65000,903,72
36165,2024,11,11,0,0,100,94136,1274,81
36166,2024,4,4,0,0,100,96250,656,120
36168,2024,4,3,1,25,75,57560,992,52
36169,2024,9,9,0,0,100,96056,849,102
36170,2024,1,1,0,0,100,115000,1250,92
36171,2024,35,35,0,0,100,80000,945,87
36172,2024,5,5,0,0,100,70400,662,106
36173,2024,4,4,0,0,100,76030,1019,89
36174,2024,3,3,0,0,100,47250,821,67
36175,2024,3,3,0,0,100,114083,1230,93
36176,2024,8,8,0,0,100,113750,1144,97
36177,2024,1,1,0,0,100,85000,977,87
36178,2024,4,4,0,0,100,93750,1058,98
36179,2024,2,2,0,0,100,253000,2392,118
36180,2024,17,17,0,0,100,105529,1165,95
36181,2024,5,5,0,0,100,137500,1154,127
36182,2024,6,5,1,17,83,142968,986,118
36184,2024,10,10,0,0,100,77971,916,87
36185,2024,5,5,0,0,100,106780,1004,99
36186,2024,5,5,0,0,100,105458,1436,91
36187,2024,2,2,0,0,100,54750,763,85
36188,2024,2,2,0,0,100,81500,1619,54
36189,2024,20,20,0,0,100,110055,1168,89
36190,2024,4,4,0,0,100,94250,1199,78
36191,2024,8,8,0,0,100,89438,1129,79
36192,2024,15,15,0,0,100,98900,1108,88
36193,2024,2,2,0,0,100,97000,1166,79
36194,2024,9,9,0,0,100,80111,1002,80
36195,2024,10,10,0,0,100,134875,1457,105
36196,2024,3,3,0,0,100,59333,676,86
36197,2024,1,1,0,0,100,49000,653,75
36198,2024,7,7,0,0,100,89000,730,117
36199,2024,8,8,0,0,100,109500,953,115
36200,2024,29,29,0,0,100,91866,1056,87
36202,2024,24,23,1,4,96,128392,1334,94
36204,2024,6,6,0,0,100,61225,834,76
36205,2024,1,1,0,0,100,1713000,9517,180
36207,2024,10,10,0,0,100,74533,903,80
36208,2024,13,11,2,15,85,145154,1304,98
36209,2024,4,4,0,0,100,72975,758,85
36210,2024,2,2,0,0,100,36000,806,46
36211,2024,5,5,0,0,100,94900,963,101
36212,2024,2,2,0,0,100,56550,886,61
36214,2024,3,3,0,0,100,85000,973,76
36215,2024,6,6,0,0,100,132875,1155,111
36216,2024,1,1,0,0,100,100000,1724,58
36217,2024,1,1,0,0,100,110000,1000,110
36218,2024,2,2,0,0,100,122500,674,180
36219,2024,9,9,0,0,100,115189,1275,89
36220,2024,18,18,0,0,100,111553,1171,88
36221,2024,11,11,0,0,100,83364,840,95
36222,2024,3,3,0,0,100,82333,1264,65
36223,2024,2,2,0,0,100,73710,702,112
36224,2024,19,19,0,0,100,93387,1077,95
36225,2024,2,2,0,0,100,23000,546,45
36226,2024,4,4,0,0,100,106388,802,131
36227,2024,6,6,0,0,100,59900,808,69
36228,2024,29,29,0,0,100,98165,1083,90
36229,2024,17,17,0,0,100,102685,1070,90
36230,2024,24,24,0,0,100,84128,851,97
36231,2024,4,4,0,0,100,183000,1342,134
36232,2024,14,13,1,7,93,96643,1061,91
36233,2024,5,5,0,0,100,82800,923,91
36234,2024,3,3,0,0,100,146900,1156,143
36235,2024,8,8,0,0,100,146105,1459,125
36236,2024,8,8,0,0,100,92710,920,102
36237,2024,7,7,0,0,100,80486,977,79
36238,2024,4,4,0,0,100,71000,676,88
36239,2024,2,2,0,0,100,124000,936,124
36240,2024,6,6,0,0,100,82500,1284,72
36241,2024,29,23,6,21,79,105486,1470,82
36243,2024,3,3,0,0,100,52000,685,75
36244,2024,9,9,0,0,100,103603,1089,99
36247,2024,12,12,0,0,100,145735,1427,104
36248,2024,3,3,0,0,100,143333,1543,107
37001,2024,8,8,0,0,100,126175,1395,88
37002,2024,15,15,0,0,100,179322,1806,102
37003,2024,160,118,42,26,74,224937,2516,90
37004,2024,6,6,0,0,100,293142,1819,149
37005,2024,8,8,0,0,100,146596,1310,98
37006,2024,28,28,0,0,100,255537,2257,114
37007,2024,3,3,0,0,100,156000,1406,109
37008,2024,22,22,0,0,100,257609,2369,117
37009,2024,2,2,0,0,100,125906,2056,64
37010,2024,16,16,0,0,100,161630,1752,93
37011,2024,16,16,0,0,100,198116,1979,106
37012,2024,7,7,0,0,100,172926,1677,125
37013,2024,6,6,0,0,100,203826,3143,95
37014,2024,27,23,4,15,85,214002,2387,100
37015,2024,32,31,1,3,97,221030,2318,98
37016,2024,2,2,0,0,100,186000,1660,112
37018,2024,77,62,15,19,81,289112,2834,104
37019,2024,6,6,0,0,100,102017,1126,92
37020,2024,27,27,0,0,100,191128,1792,107
37021,2024,15,15,0,0,100,154730,1681,92
37022,2024,25,25,0,0,100,179636,1969,96
37023,2024,3,3,0,0,100,101667,2085,64
37024,2024,11,11,0,0,100,187632,1851,102
37025,2024,10,10,0,0,100,248317,2408,112
37026,2024,11,11,0,0,100,114420,1090,98
37027,2024,45,39,6,13,87,207042,2569,90
37028,2024,12,12,0,0,100,109292,999,108
37029,2024,6,6,0,0,100,174133,1548,104
37030,2024,6,6,0,0,100,218484,1755,123
37031,2024,51,41,10,20,80,154814,1691,92
37032,2024,1,1,0,0,100,80000,721,111
37033,2024,6,6,0,0,100,211352,1710,120
37034,2024,3,3,0,0,100,98167,697,133
37035,2024,4,4,0,0,100,113875,1018,118
37036,2024,4,4,0,0,100,145750,1092,135
37037,2024,3,3,0,0,100,176333,1300,155
37038,2024,7,7,0,0,100,118143,1287,97
37039,2024,5,5,0,0,100,77600,1066,80
37040,2024,2,2,0,0,100,441000,3843,101
37041,2024,5,5,0,0,100,124000,1465,79
37042,2024,9,9,0,0,100,228233,1868,114
37043,2024,14,14,0,0,100,191782,1987,104
37044,2024,2,2,0,0,100,110049,1275,82
37045,2024,10,10,0,0,100,155571,1348,129
37046,2024,4,4,0,0,100,305307,1906,148
37047,2024,11,11,0,0,100,271900,3074,108
37048,2024,4,4,0,0,100,102319,921,113
37049,2024,14,14,0,0,100,173250,1902,95
37050,2024,155,79,76,49,51,220104,2760,81
37051,2024,13,13,0,0,100,203096,1511,130
37052,2024,3,3,0,0,100,199833,2500,85
37053,2024,2,2,0,0,100,212128,2617,82
37054,2024,21,20,1,5,95,240958,2334,103
37055,2024,8,8,0,0,100,158750,1383,114
37056,2024,1,1,0,0,100,145500,1692,86
37057,2024,11,11,0,0,100,134155,1214,110
37058,2024,13,13,0,0,100,140062,1662,87
37059,2024,6,6,0,0,100,255500,2447,106
37060,2024,17,17,0,0,100,196247,1972,100
37061,2024,6,6,0,0,100,107581,878,120
37062,2024,27,27,0,0,100,158868,1628,92
37063,2024,51,47,4,8,92,124132,1518,84
37064,2024,2,2,0,0,100,82000,841,92
37065,2024,4,4,0,0,100,116800,907,143
37066,2024,9,9,0,0,100,167789,1612,103
37067,2024,21,21,0,0,100,209200,2624,82
37068,2024,6,6,0,0,100,150950,1276,126
37069,2024,1,1,0,0,100,130500,1788,73
37070,2024,6,6,0,0,100,165221,1960,82
37071,2024,1,1,0,0,100,150000,1613,93
37072,2024,128,82,46,36,64,149691,1795,83
37073,2024,12,12,0,0,100,165500,2000,94
37074,2024,28,28,0,0,100,159351,1702,110
37075,2024,3,3,0,0,100,146267,1272,119
37076,2024,6,6,0,0,100,165155,1178,128
37077,2024,43,42,1,2,98,203241,2076,102
37078,2024,6,6,0,0,100,152667,1311,116
37079,2024,16,15,1,6,94,190868,2406,93
37080,2024,5,5,0,0,100,139200,1574,94
37081,2024,14,14,0,0,100,218200,1996,109
37082,2024,8,8,0,0,100,141933,1436,92
37083,2024,11,11,0,0,100,199464,1973,105
37084,2024,5,5,0,0,100,73600,789,95
37085,2024,3,3,0,0,100,105667,2081,48
37086,2024,2,2,0,0,100,124500,1028,117
37087,2024,6,6,0,0,100,178514,1504,132
37089,2024,7,7,0,0,100,273005,1999,129
37090,2024,2,2,0,0,100,346825,2359,145
37091,2024,28,28,0,0,100,210747,2067,104
37092,2024,1,1,0,0,100,241400,2414,100
37093,2024,7,7,0,0,100,164943,1648,99
37094,2024,9,9,0,0,100,138918,1391,95
37095,2024,1,1,0,0,100,330000,2025,163
37096,2024,4,4,0,0,100,138075,2288,69
37097,2024,8,8,0,0,100,227484,1812,128
37098,2024,9,8,1,11,89,109136,1489,76
37099,2024,8,8,0,0,100,290035,2544,108
37100,2024,9,9,0,0,100,134517,1433,90
37101,2024,4,4,0,0,100,123075,1382,105
37103,2024,1,1,0,0,100,55000,705,78
37104,2024,57,57,0,0,100,277334,2457,118
37105,2024,3,3,0,0,100,82667,1127,88
37107,2024,6,6,0,0,100,118733,1160,105
37108,2024,7,7,0,0,100,231871,2432,105
37109,2024,95,86,9,9,91,308944,2895,107
37110,2024,16,16,0,0,100,180743,1618,117
37111,2024,31,31,0,0,100,150447,1602,106
37112,2024,8,8,0,0,100,111385,1267,91
37113,2024,11,10,1,9,91,73227,944,75
37114,2024,2,2,0,0,100,35250,500,70
37115,2024,63,54,9,14,86,98568,1180,86
37116,2024,6,6,0,0,100,116665,1078,105
37117,2024,4,4,0,0,100,228500,1735,148
37118,2024,17,17,0,0,100,172035,1516,117
37119,2024,17,17,0,0,100,124632,1540,101
37121,2024,5,5,0,0,100,92920,939,95
37122,2024,497,231,266,54,46,174693,2377,74
37123,2024,35,35,0,0,100,196832,2312,91
37124,2024,25,24,1,4,96,304969,2768,109
37125,2024,2,2,0,0,100,195000,1836,106
37126,2024,3,3,0,0,100,52350,1420,54
37127,2024,1,1,0,0,100,150000,824,182
37128,2024,11,11,0,0,100,212919,2125,102
37129,2024,16,16,0,0,100,201922,1556,137
37130,2024,25,25,0,0,100,113976,1391,83
37131,2024,14,14,0,0,100,167290,1943,91
37132,2024,87,82,5,6,94,181002,1978,95
37133,2024,7,7,0,0,100,99853,1054,99
37134,2024,7,7,0,0,100,177941,1947,98
37136,2024,3,3,0,0,100,179000,1660,108
37137,2024,2,2,0,0,100,58000,595,89
37138,2024,10,10,0,0,100,196355,2319,86
37139,2024,54,53,1,2,98,258503,2511,102
37140,2024,3,3,0,0,100,177900,1588,109
37141,2024,6,6,0,0,100,226401,2203,124
37142,2024,4,4,0,0,100,216080,2089,121
37143,2024,17,17,0,0,100,131688,1349,96
37144,2024,5,5,0,0,100,147200,1923,80
37145,2024,4,4,0,0,100,152500,1422,108
37146,2024,4,4,0,0,100,176400,1495,108
37147,2024,4,4,0,0,100,90950,1042,88
37148,2024,4,4,0,0,100,125625,1726,73
37149,2024,6,6,0,0,100,115500,1151,94
37150,2024,16,16,0,0,100,215819,2111,104
37151,2024,23,22,1,4,96,260075,2589,104
37152,2024,15,15,0,0,100,420200,2985,139
37153,2024,37,35,2,5,95,221142,2230,102
37154,2024,49,47,2,4,96,275385,2437,115
37155,2024,7,7,0,0,100,139415,1497,90
37156,2024,108,97,11,10,90,218833,2373,93
37157,2024,5,5,0,0,100,129341,1538,99
37158,2024,5,5,0,0,100,248223,1666,146
37159,2024,68,63,5,7,93,231228,2327,102
37160,2024,4,4,0,0,100,196462,1725,116
37161,2024,9,9,0,0,100,170889,1866,93
37162,2024,5,5,0,0,100,148920,1685,108
37163,2024,40,40,0,0,100,184046,1986,92
37165,2024,3,3,0,0,100,147333,1603,92
37166,2024,8,8,0,0,100,166938,2025,80
37167,2024,25,18,7,28,72,167633,1878,92
37168,2024,3,3,0,0,100,178667,1769,97
37169,2024,7,7,0,0,100,165786,1977,84
37170,2024,8,8,0,0,100,182175,1879,105
37171,2024,17,17,0,0,100,244225,3382,90
37172,2024,29,26,3,10,90,253326,2639,97
37173,2024,13,13,0,0,100,69038,893,78
37174,2024,15,15,0,0,100,160460,1625,97
37175,2024,9,9,0,0,100,189233,1992,96
37176,2024,8,8,0,0,100,189375,1772,113
37177,2024,6,6,0,0,100,171706,1644,86
37178,2024,5,5,0,0,100,159300,2340,69
37179,2024,17,16,1,6,94,290456,2946,99
37180,2024,5,5,0,0,100,93976,1070,88
37181,2024,4,4,0,0,100,124250,1173,115
37182,2024,10,10,0,0,100,230649,2899,98
37183,2024,24,22,2,8,92,166534,1500,110
37184,2024,3,3,0,0,100,156100,1896,94
37185,2024,14,13,1,7,93,204593,2546,82
37186,2024,13,13,0,0,100,214246,2214,98
37187,2024,5,5,0,0,100,106840,1162,92
37188,2024,9,9,0,0,100,118063,1289,89
37189,2024,23,22,1,4,96,83815,823,91
37190,2024,3,3,0,0,100,109333,991,105
37191,2024,2,2,0,0,100,66500,1019,60
37192,2024,11,11,0,0,100,146864,1874,84
37193,2024,13,13,0,0,100,287577,2155,134
37194,2024,18,18,0,0,100,210118,2071,102
37195,2024,154,50,104,68,32,196131,2798,70
37196,2024,23,21,2,9,91,116305,1184,106
37197,2024,9,9,0,0,100,212089,2050,101
37198,2024,3,3,0,0,100,176544,1423,123
37199,2024,3,3,0,0,100,32833,722,46
37200,2024,15,15,0,0,100,117387,1473,80
37201,2024,8,8,0,0,100,174339,1638,114
37202,2024,8,8,0,0,100,183762,1729,111
37203,2024,35,33,2,6,94,352716,3659,107
37204,2024,16,16,0,0,100,272547,2477,110
37205,2024,10,10,0,0,100,194968,2087,90
37206,2024,14,14,0,0,100,407017,3477,117
37207,2024,6,6,0,0,100,80633,918,90
37208,2024,165,127,38,23,77,286282,2820,101
37210,2024,9,9,0,0,100,195475,1569,119
37211,2024,20,20,0,0,100,204735,2260,94
37212,2024,7,7,0,0,100,176343,1750,100
37213,2024,11,11,0,0,100,118468,1609,72
37214,2024,222,125,97,44,56,289995,3103,91
37216,2024,27,27,0,0,100,145677,1649,95
37217,2024,16,16,0,0,100,300128,2451,122
37218,2024,10,10,0,0,100,173106,1657,110
37219,2024,11,11,0,0,100,190020,2157,81
37220,2024,9,9,0,0,100,125356,1222,103
37221,2024,3,3,0,0,100,161667,1249,134
37222,2024,8,8,0,0,100,127238,1331,100
37223,2024,6,6,0,0,100,166333,1889,96
37224,2024,10,10,0,0,100,180600,1694,105
37225,2024,27,27,0,0,100,243391,2236,114
37226,2024,36,33,3,8,92,144881,1810,83
37228,2024,10,10,0,0,100,188978,2044,104
37229,2024,4,4,0,0,100,188250,1813,108
37230,2024,5,5,0,0,100,265320,2036,133
37231,2024,23,19,4,17,83,130478,1864,78
37232,2024,17,17,0,0,100,155772,1532,101
37233,2024,131,85,46,35,65,173681,2237,79
37234,2024,6,6,0,0,100,173783,1479,116
37236,2024,4,4,0,0,100,212504,1959,116
37237,2024,11,10,1,9,91,281807,2519,110
37238,2024,3,3,0,0,100,177333,1841,88
37240,2024,7,7,0,0,100,150842,1335,107
37241,2024,23,23,0,0,100,132715,1513,86
37242,2024,16,16,0,0,100,195694,1879,109
37243,2024,34,33,1,3,97,269525,2381,113
37244,2024,2,2,0,0,100,139500,1381,96
37245,2024,17,17,0,0,100,281320,2856,105
37246,2024,2,2,0,0,100,192500,1995,86
37247,2024,3,3,0,0,100,73800,1125,69
37248,2024,3,3,0,0,100,159500,1683,91
37249,2024,13,13,0,0,100,185077,1830,104
37250,2024,15,15,0,0,100,200217,2263,95
37251,2024,11,11,0,0,100,227227,2025,134
37252,2024,7,6,1,14,86,124500,1614,75
37253,2024,3,3,0,0,100,207895,1951,97
37254,2024,22,22,0,0,100,187179,2060,94
37255,2024,4,4,0,0,100,111750,1574,76
37256,2024,4,4,0,0,100,127250,2114,72
37257,2024,15,15,0,0,100,193893,1783,108
37258,2024,2,2,0,0,100,182500,1616,106
37259,2024,10,10,0,0,100,68700,979,78
37260,2024,9,9,0,0,100,87222,949,93
37261,2024,1945,434,1511,78,22,190782,2954,65
37262,2024,3,3,0,0,100,130333,1091,120
37263,2024,21,20,1,5,95,220073,2506,89
37264,2024,12,12,0,0,100,253183,2286,116
37265,2024,5,5,0,0,100,67300,1190,64
37266,2024,71,66,5,7,93,261216,2728,98
37267,2024,46,45,1,2,98,250637,2507,103
37269,2024,4,4,0,0,100,63250,887,79
37270,2024,26,26,0,0,100,189399,2271,84
37271,2024,9,9,0,0,100,159623,1660,96
37272,2024,13,13,0,0,100,262576,2346,106
37273,2024,55,50,5,9,91,236745,2558,96
37274,2024,3,3,0,0,100,103333,1012,95
37275,2024,3,3,0,0,100,65633,1018,72
37276,2024,11,11,0,0,100,190534,2010,98
37277,2024,6,6,0,0,100,140000,1332,105
37278,2024,7,7,0,0,100,172564,1998,91
37279,2024,8,8,0,0,100,140534,1437,99
37280,2024,1,1,0,0,100,219100,1685,130
37281,2024,49,41,8,16,84,254183,2897,92
37282,2024,15,14,1,7,93,114556,1752,80
38001,2024,68,56,12,18,82,220094,2484,88
38002,2024,47,4,43,91,9,133525,3281,39
38003,2024,4,4,0,0,100,244741,2336,102
38004,2024,6,6,0,0,100,207391,2187,99
38005,2024,11,8,3,27,73,364494,4035,101
38006,2024,94,26,68,72,28,129284,2152,59
38008,2024,1,1,0,0,100,70000,1077,65
38009,2024,12,10,2,17,83,221006,2158,92
38010,2024,6,6,0,0,100,263717,2767,98
38011,2024,11,9,2,18,82,323925,3521,93
38012,2024,32,24,8,25,75,206001,2330,90
38013,2024,57,32,25,44,56,228218,2689,84
38015,2024,13,11,2,15,85,259394,2654,102
38017,2024,17,17,0,0,100,309085,2865,106
38018,2024,3,3,0,0,100,217667,1834,124
38019,2024,12,12,0,0,100,211771,2112,106
38020,2024,29,4,25,86,14,147317,3911,37
38022,2024,75,66,9,12,88,203963,2260,95
38023,2024,1,1,0,0,100,75000,625,120
38026,2024,14,11,3,21,79,297425,3378,88
38027,2024,16,16,0,0,100,318048,2795,112
38029,2024,23,22,1,4,96,184121,2011,95
38030,2024,8,7,1,12,88,238323,2669,94
38031,2024,1,1,0,0,100,180500,1805,100
38032,2024,5,5,0,0,100,162700,1802,94
38033,2024,4,4,0,0,100,189088,1944,93
38034,2024,51,38,13,25,75,155491,1755,88
38035,2024,10,10,0,0,100,313954,2592,130
38037,2024,8,6,2,25,75,177225,1849,96
38038,2024,3,3,0,0,100,262183,2216,125
38039,2024,12,6,6,50,50,395355,4270,94
38040,2024,3,1,2,67,33,135190,2431,65
38042,2024,4,4,0,0,100,234738,2126,111
38043,2024,13,12,1,8,92,306863,2686,117
38044,2024,9,9,0,0,100,254544,2191,129
38045,2024,19,18,1,5,95,534728,4455,122
38046,2024,5,5,0,0,100,250710,2821,96
38047,2024,2,2,0,0,100,230590,2411,96
38048,2024,4,2,2,50,50,299162,3838,76
38050,2024,5,5,0,0,100,195260,1647,115
38051,2024,8,8,0,0,100,229729,2260,103
38052,2024,38,22,16,42,58,242227,3220,79
38053,2024,335,95,240,72,28,192019,2613,74
38054,2024,17,17,0,0,100,202274,2114,97
38055,2024,4,4,0,0,100,156358,1686,95
38056,2024,1,1,0,0,100,27000,450,60
38057,2024,3,3,0,0,100,597533,4431,139
38058,2024,28,23,5,18,82,211739,2350,94
38059,2024,19,15,4,21,79,430379,3540,123
38060,2024,3,3,0,0,100,391327,3119,144
38061,2024,34,27,7,21,79,337453,3156,102
38062,2024,9,8,1,11,89,321900,2718,120
38063,2024,6,6,0,0,100,248640,2231,110
38064,2024,30,26,4,13,87,280757,3114,95
38065,2024,18,15,3,17,83,220282,2541,91
38067,2024,25,21,4,16,84,292465,2746,110
38068,2024,4,4,0,0,100,414812,3564,118
38069,2024,17,17,0,0,100,189018,1871,99
38070,2024,8,5,3,38,62,244408,2591,86
38071,2024,21,14,7,33,67,232399,2926,82
38072,2024,19,19,0,0,100,235947,2420,99
38073,2024,9,7,2,22,78,134050,2474,55
38074,2024,1,1,0,0,100,292000,1708,171
38075,2024,24,20,4,17,83,293690,2793,106
38076,2024,18,17,1,6,94,216729,2174,105
38077,2024,11,11,0,0,100,217427,2266,98
38078,2024,6,6,0,0,100,236099,2562,94
38080,2024,10,10,0,0,100,264810,2576,101
38081,2024,21,21,0,0,100,248572,2635,101
38082,2024,19,15,4,21,79,240666,2317,109
38083,2024,3,3,0,0,100,240933,3046,85
38084,2024,13,13,0,0,100,273983,2138,130
38085,2024,50,48,2,4,96,299696,3191,95
38086,2024,1,1,0,0,100,349450,2688,130
38087,2024,28,18,10,36,64,258750,2847,92
38089,2024,1,1,0,0,100,180000,1565,115
38090,2024,7,7,0,0,100,213860,2574,84
38091,2024,5,5,0,0,100,299091,2810,108
38093,2024,6,6,0,0,100,250362,2218,111
38094,2024,25,22,3,12,88,195316,2042,97
38095,2024,20,17,3,15,85,208362,2260,94
38097,2024,31,24,7,23,77,268514,3416,85
38098,2024,6,6,0,0,100,272275,2411,114
38099,2024,12,12,0,0,100,253014,2338,112
38100,2024,21,11,10,48,52,196672,2598,76
38101,2024,7,7,0,0,100,285348,2715,107
38102,2024,3,3,0,0,100,425933,2836,149
38103,2024,5,3,2,40,60,243500,3414,73
38104,2024,14,14,0,0,100,260824,2496,108
38105,2024,27,21,6,22,78,259245,2694,99
38106,2024,1,1,0,0,100,35000,500,70
38107,2024,7,7,0,0,100,308479,3078,101
38109,2024,7,7,0,0,100,335609,2711,126
38110,2024,21,20,1,5,95,406347,3402,117
38111,2024,72,45,27,38,62,336228,3503,99
38112,2024,1,1,0,0,100,267000,3814,70
38113,2024,8,7,1,12,88,245694,2595,104
38114,2024,6,6,0,0,100,325808,3177,108
38115,2024,2,2,0,0,100,174000,1444,118
38117,2024,6,6,0,0,100,187675,1560,134
38118,2024,15,15,0,0,100,305628,2814,118
38120,2024,7,7,0,0,100,401356,3365,114
38124,2024,24,16,8,33,67,155959,2002,80
38126,2024,33,25,8,24,76,569492,4360,129
38127,2024,2,2,0,0,100,151072,2050,64
38128,2024,7,6,1,14,86,112571,1511,78
38129,2024,32,10,22,69,31,236684,3922,54
38130,2024,58,37,21,36,64,197686,2406,87
38131,2024,23,14,9,39,61,287414,2742,103
38132,2024,5,5,0,0,100,156192,2487,64
38133,2024,42,33,9,21,79,375113,3180,119
38134,2024,5,5,0,0,100,258716,2395,118
38135,2024,10,10,0,0,100,228458,2316,92
38136,2024,4,4,0,0,100,338278,2736,128
38137,2024,2,2,0,0,100,247500,2674,92
38138,2024,46,22,24,52,48,227409,2741,85
38139,2024,14,14,0,0,100,219116,2301,100
38140,2024,75,44,31,41,59,332176,3491,95
38141,2024,6,6,0,0,100,212583,1843,112
38144,2024,10,10,0,0,100,352765,3607,107
38146,2024,12,12,0,0,100,287838,2648,109
38147,2024,6,6,0,0,100,186337,2076,86
38148,2024,30,28,2,7,93,236237,2364,105
38149,2024,10,10,0,0,100,294238,2808,110
38150,2024,60,23,37,62,38,243802,3234,75
38151,2024,278,36,242,87,13,149262,1982,75
38152,2024,8,8,0,0,100,273751,2402,113
38153,2024,4,4,0,0,100,308270,3249,96
38154,2024,1,1,0,0,100,222500,3048,73
38155,2024,22,12,10,45,55,146832,1978,77
38156,2024,9,8,1,11,89,240844,1986,121
38157,2024,28,25,3,11,89,361079,3378,108
38158,2024,97,21,76,78,22,222954,2906,75
38159,2024,5,5,0,0,100,207550,1869,110
38160,2024,12,9,3,25,75,226133,2691,89
38161,2024,6,6,0,0,100,225867,1973,131
38162,2024,20,20,0,0,100,249002,2354,116
38163,2024,21,4,17,81,19,70514,2104,37
38166,2024,2,2,0,0,100,328000,2974,123
38167,2024,3,3,0,0,100,236850,2291,103
38169,2024,262,29,233,89,11,138229,2140,65
38170,2024,37,12,25,68,32,254891,3148,79
38171,2024,1,1,0,0,100,125000,3289,38
38172,2024,19,16,3,16,84,309586,2719,116
38173,2024,4,4,0,0,100,170448,2605,69
38174,2024,11,11,0,0,100,168380,2206,76
38175,2024,30,16,14,47,53,242357,3250,77
38176,2024,21,20,1,5,95,349241,2861,121
38177,2024,4,2,2,50,50,144908,3127,51
38179,2024,66,11,55,83,17,231386,3372,65
38180,2024,12,12,0,0,100,239939,2405,101
38181,2024,19,13,6,32,68,223154,2672,85
38182,2024,31,24,7,23,77,209749,2209,96
38183,2024,3,3,0,0,100,257600,2256,110
38184,2024,13,11,2,15,85,332223,3457,97
38185,2024,2320,69,2251,97,3,156626,2625,62
38186,2024,21,4,17,81,19,92898,2299,40
38187,2024,16,9,7,44,56,192466,2546,71
38188,2024,5,4,1,20,80,489280,4497,114
38189,2024,58,43,15,26,74,285352,3569,81
38190,2024,10,9,1,10,90,212500,2304,96
38191,2024,170,9,161,95,5,320485,7446,40
38192,2024,2,2,0,0,100,303600,4929,89
38193,2024,180,89,91,51,49,199094,2585,78
38194,2024,13,11,2,15,85,154310,1913,87
38195,2024,7,5,2,29,71,222691,2177,105
38197,2024,7,4,3,43,57,337245,4189,82
38198,2024,5,5,0,0,100,278749,2402,116
38199,2024,18,16,2,11,89,317996,2830,113
38200,2024,34,22,12,35,65,319694,3252,97
38203,2024,6,6,0,0,100,240353,1874,120
38204,2024,1,1,0,0,100,125000,1250,100
38205,2024,50,23,27,54,46,259382,4016,66
38206,2024,4,4,0,0,100,266625,2970,83
38207,2024,1,1,0,0,100,225000,2473,91
38208,2024,2,1,1,50,50,165000,3088,53
38209,2024,1,1,0,0,100,180000,1500,120
38210,2024,4,4,0,0,100,372119,3984,115
38211,2024,9,9,0,0,100,259600,2359,113
38212,2024,16,13,3,19,81,156482,1983,87
38213,2024,9,9,0,0,100,183428,1739,108
38214,2024,19,14,5,26,74,383247,3710,103
38215,2024,10,8,2,20,80,331924,4004,83
38218,2024,7,7,0,0,100,219421,1840,129
38219,2024,5,5,0,0,100,217210,2227,94
38222,2024,6,6,0,0,100,255350,2529,103
38223,2024,10,10,0,0,100,336080,2905,116
38224,2024,1,1,0,0,100,159110,2066,77
38225,2024,61,17,44,72,28,209518,3428,64
38226,2024,20,18,2,10,90,180185,2586,75
38228,2024,7,7,0,0,100,194000,2267,92
38229,2024,189,42,147,78,22,344864,3785,89
38230,2024,2,1,1,50,50,237250,3455,68
38231,2024,4,4,0,0,100,280305,2782,96
38232,2024,5,5,0,0,100,298839,2790,113
38236,2024,13,13,0,0,100,269239,2805,100
38237,2024,2,2,0,0,100,131500,2725,52
38238,2024,9,7,2,22,78,222339,2057,105
38239,2024,88,46,42,48,52,230362,2473,93
38240,2024,11,11,0,0,100,281401,2256,124
38242,2024,17,15,2,12,88,202058,1879,104
38243,2024,5,5,0,0,100,243600,2605,94
38244,2024,8,8,0,0,100,279112,2487,118
38246,2024,4,4,0,0,100,290725,2944,105
38247,2024,40,31,9,22,78,149112,2087,76
38248,2024,1,1,0,0,100,445500,2700,165
38249,2024,60,25,35,58,42,387462,4349,88
38250,2024,2,2,0,0,100,185000,1928,94
38252,2024,2,2,0,0,100,290000,3372,87
38253,2024,227,12,215,95,5,179223,5191,35
38254,2024,8,8,0,0,100,170730,2003,96
38255,2024,1,1,0,0,100,165000,4583,36
38256,2024,17,12,5,29,71,194541,2107,93
38257,2024,3,3,0,0,100,209067,1981,103
38258,2024,1,1,0,0,100,426830,6098,70
38259,2024,2,2,0,0,100,340500,3548,112
38260,2024,2,2,0,0,100,334050,1988,184
38261,2024,56,32,24,43,57,184323,2235,85
38263,2024,3,3,0,0,100,243535,2283,104
38264,2024,16,6,10,62,38,152520,2633,55
38265,2024,16,16,0,0,100,165611,2079,91
38266,2024,4,4,0,0,100,139672,1544,77
38267,2024,9,9,0,0,100,195134,1966,102
38268,2024,3,3,0,0,100,143667,2039,65
38269,2024,59,28,31,53,47,145974,1809,80
38270,2024,12,11,1,8,92,254042,2987,95
38271,2024,7,7,0,0,100,369650,3870,93
38272,2024,2,2,0,0,100,325200,3912,85
38275,2024,1,1,0,0,100,310000,2696,115
38276,2024,28,24,4,14,86,257277,2708,99
38277,2024,7,7,0,0,100,260226,2754,103
38278,2024,3,3,0,0,100,195778,2016,82
38279,2024,10,8,2,20,80,249738,2731,93
38280,2024,2,2,0,0,100,219375,3002,74
38281,2024,30,16,14,47,53,292608,3185,94
38282,2024,6,6,0,0,100,244481,2344,102
38283,2024,1,1,0,0,100,192000,2743,70
38284,2024,5,5,0,0,100,241200,2405,107
38285,2024,1,1,0,0,100,275000,2546,108
38287,2024,13,12,1,8,92,257352,2230,116
38288,2024,7,5,2,29,71,243957,2466,100
38289,2024,17,3,14,82,18,217336,4605,55
38290,2024,3,3,0,0,100,213400,2424,88
38291,2024,11,11,0,0,100,210770,1977,113
38292,2024,25,23,2,8,92,259198,2750,99
38294,2024,3,3,0,0,100,398683,3280,122
38295,2024,8,8,0,0,100,203512,2370,85
38296,2024,7,7,0,0,100,174199,1679,106
38297,2024,16,15,1,6,94,199134,2447,90
38298,2024,67,34,33,49,51,145204,1862,78
38299,2024,4,4,0,0,100,92350,923,110
38300,2024,3,3,0,0,100,322550,2885,111
38303,2024,8,8,0,0,100,340713,3575,94
38304,2024,8,6,2,25,75,206618,2221,87
38307,2024,1,1,0,0,100,449885,3213,140
38308,2024,2,2,0,0,100,247350,2324,106
38309,2024,18,10,8,44,56,315074,3240,96
38310,2024,3,3,0,0,100,282183,2504,114
38311,2024,3,3,0,0,100,201167,2727,73
38313,2024,1,1,0,0,100,530000,3011,176
38314,2024,83,47,36,43,57,237517,3094,78
38315,2024,53,33,20,38,62,167154,2242,80
38316,2024,61,27,34,56,44,201553,2638,78
38317,2024,99,15,84,85,15,147798,2072,71
38318,2024,42,20,22,52,48,222650,2587,84
38319,2024,6,5,1,17,83,134175,1590,88
38320,2024,11,10,1,9,91,202934,2155,99
38321,2024,1,1,0,0,100,140000,1489,94
38322,2024,1,1,0,0,100,284000,2470,115
38323,2024,6,6,0,0,100,299694,2166,127
38324,2024,8,7,1,12,88,240591,2286,101
38325,2024,3,3,0,0,100,310333,3171,105
38326,2024,2,2,0,0,100,375500,2988,126
38328,2024,7,7,0,0,100,442347,3757,116
38330,2024,1,1,0,0,100,182000,1090,167
38331,2024,10,9,1,10,90,282222,2516,116
38332,2024,28,14,14,50,50,149967,1850,86
38333,2024,3,2,1,33,67,308333,3221,98
38334,2024,8,8,0,0,100,370912,4572,95
38335,2024,2,2,0,0,100,140000,2234,64
38336,2024,9,8,1,11,89,255690,2496,105
38337,2024,66,25,41,62,38,181463,2228,82
38338,2024,3,3,0,0,100,329350,3160,107
38339,2024,7,7,0,0,100,345693,3157,110
38340,2024,27,16,11,41,59,195323,2575,85
38341,2024,7,7,0,0,100,263036,2680,108
38342,2024,2,2,0,0,100,151650,1244,110
38343,2024,17,17,0,0,100,231329,2410,102
38344,2024,87,49,38,44,56,184399,1994,90
38345,2024,7,7,0,0,100,251840,2461,102
38346,2024,5,5,0,0,100,240450,2221,113
38347,2024,8,8,0,0,100,193256,1792,118
38348,2024,35,34,1,3,97,356243,3001,117
38349,2024,19,17,2,11,89,191389,2358,83
38350,2024,2,2,0,0,100,410065,4123,120
38351,2024,6,6,0,0,100,321862,3105,104
38352,2024,18,15,3,17,83,304092,3229,93
38353,2024,8,8,0,0,100,239125,2874,86
38354,2024,5,5,0,0,100,230890,2533,97
38355,2024,1,1,0,0,100,181300,2972,61
38356,2024,3,3,0,0,100,422500,2232,184
38357,2024,26,22,4,15,85,245288,2310,110
38358,2024,5,5,0,0,100,220400,2147,104
38359,2024,15,15,0,0,100,240534,2226,110
38360,2024,4,3,1,25,75,343350,2962,135
38362,2024,8,8,0,0,100,271481,2556,104
38363,2024,21,4,17,81,19,160448,1861,92
38364,2024,7,7,0,0,100,185607,1797,98
38365,2024,5,5,0,0,100,236010,1949,122
38368,2024,8,8,0,0,100,325625,2483,131
38369,2024,10,10,0,0,100,290736,2701,107
38370,2024,2,2,0,0,100,296990,3556,88
38372,2024,6,5,1,17,83,208617,2272,91
38373,2024,9,6,3,33,67,335750,2677,123
38374,2024,27,23,4,15,85,251729,2448,108
38375,2024,1,1,0,0,100,200000,3077,65
38376,2024,6,6,0,0,100,226362,2158,116
38377,2024,49,39,10,20,80,198558,2187,92
38378,2024,27,22,5,19,81,264471,2716,99
38379,2024,5,5,0,0,100,186540,2144,92
38381,2024,11,11,0,0,100,239176,1913,125
38382,2024,161,43,118,73,27,238129,2959,79
38383,2024,15,9,6,40,60,222072,2574,88
38384,2024,43,23,20,47,53,193200,2027,95
38386,2024,18,14,4,22,78,181881,2116,92
38387,2024,6,3,3,50,50,185792,2356,78
38388,2024,12,11,1,8,92,311541,3436,91
38389,2024,29,26,3,10,90,304902,2868,108
38390,2024,6,6,0,0,100,278542,2477,120
38392,2024,6,6,0,0,100,181802,2162,87
38393,2024,15,13,2,13,87,249739,2138,117
38394,2024,16,15,1,6,94,210808,2022,108
38395,2024,19,13,6,32,68,272943,3006,89
38396,2024,9,4,5,56,44,143803,1998,62
38397,2024,61,38,23,38,62,485338,4645,108
38398,2024,12,12,0,0,100,211954,2088,99
38399,2024,29,25,4,14,86,202870,2230,96
38400,2024,24,21,3,12,88,343782,3120,106
38401,2024,14,10,4,29,71,237683,2436,98
38402,2024,2,2,0,0,100,208525,2489,74
38403,2024,4,4,0,0,100,214250,1950,118
38404,2024,1,1,0,0,100,341100,4373,78
38405,2024,4,3,1,25,75,208970,2357,92
38406,2024,1,1,0,0,100,200000,2632,76
38407,2024,10,10,0,0,100,339525,2937,116
38408,2024,19,17,2,11,89,356606,3227,110
38409,2024,12,12,0,0,100,227232,2185,104
38410,2024,15,14,1,7,93,252201,2343,108
38412,2024,47,36,11,23,77,196877,2278,84
38413,2024,5,5,0,0,100,185544,2419,71
38414,2024,2,2,0,0,100,61000,914,84
38415,2024,9,8,1,11,89,318282,2627,119
38416,2024,104,30,74,71,29,163576,2141,75
38417,2024,1,1,0,0,100,334000,3093,108
38418,2024,5,5,0,0,100,277287,3663,88
38419,2024,3,3,0,0,100,303327,2448,129
38421,2024,344,39,305,89,11,160077,2457,65
38422,2024,39,25,14,36,64,406438,3819,104
38423,2024,52,16,36,69,31,230883,3088,76
38425,2024,44,38,6,14,86,243290,2486,97
38426,2024,6,6,0,0,100,404485,3896,102
38427,2024,2,2,0,0,100,240250,2232,110
38429,2024,3,3,0,0,100,168637,2673,65
38430,2024,3,3,0,0,100,452433,4239,114
38431,2024,26,17,9,35,65,434208,4262,106
38432,2024,11,11,0,0,100,239315,2512,99
38433,2024,14,5,9,64,36,314809,3894,77
38434,2024,6,6,0,0,100,283903,2561,115
38436,2024,12,11,1,8,92,397980,3307,122
38437,2024,2,2,0,0,100,179900,1384,135
38438,2024,7,7,0,0,100,275400,2236,129
38439,2024,33,31,2,6,94,260850,2796,94
38440,2024,8,8,0,0,100,233338,2149,108
38442,2024,22,10,12,55,45,174832,3561,49
38443,2024,4,4,0,0,100,172762,2321,81
38444,2024,2,2,0,0,100,162000,1850,105
38445,2024,5,5,0,0,100,238580,2948,82
38446,2024,15,14,1,7,93,224890,2305,106
38448,2024,15,13,2,13,87,329553,2928,112
38449,2024,64,57,7,11,89,241593,2705,93
38450,2024,11,10,1,9,91,351015,3557,105
38451,2024,29,29,0,0,100,279420,2709,105
38452,2024,3,3,0,0,100,328333,3110,107
38453,2024,20,18,2,10,90,247220,2293,107
38454,2024,11,10,1,9,91,224161,2269,102
38455,2024,37,35,2,5,95,274275,2700,104
38456,2024,4,4,0,0,100,183054,1858,100
38457,2024,32,26,6,19,81,173854,1876,90
38458,2024,9,8,1,11,89,200661,2075,105
38459,2024,3,3,0,0,100,252667,4444,68
38460,2024,3,3,0,0,100,170676,2427,69
38462,2024,6,5,1,17,83,195283,2484,86
38463,2024,21,17,4,19,81,263165,2667,98
38464,2024,24,20,4,17,83,242446,2586,95
38465,2024,13,13,0,0,100,225376,2177,109
38466,2024,10,9,1,10,90,319564,3399,98
38467,2024,12,10,2,17,83,303177,3561,92
38468,2024,43,34,9,21,79,203752,2207,92
38469,2024,1,1,0,0,100,20250,1012,20
38470,2024,5,5,0,0,100,191781,2087,106
38471,2024,9,6,3,33,67,412517,4830,83
38473,2024,15,14,1,7,93,203194,2064,102
38474,2024,127,40,87,69,31,214257,2779,75
38475,2024,7,7,0,0,100,327021,2993,111
38476,2024,7,7,0,0,100,241986,2541,99
38478,2024,10,7,3,30,70,152398,2157,73
38479,2024,15,15,0,0,100,233720,2336,101
38480,2024,25,22,3,12,88,280386,2832,100
38481,2024,10,10,0,0,100,328996,3028,110
38483,2024,23,21,2,9,91,257304,2602,99
38484,2024,14,11,3,21,79,386448,3803,103
38485,2024,148,24,124,84,16,201977,2608,73
38486,2024,73,25,48,66,34,341637,3475,98
38487,2024,14,11,3,21,79,396085,3704,110
38488,2024,2,2,0,0,100,309250,2784,110
38489,2024,1,1,0,0,100,175000,1423,123
38490,2024,12,11,1,8,92,211326,2075,105
38492,2024,2,2,0,0,100,323950,2284,168
38494,2024,12,12,0,0,100,289237,2700,110
38495,2024,9,8,1,11,89,206726,2062,90
38496,2024,13,11,2,15,85,216969,1850,118
38498,2024,5,5,0,0,100,273256,2507,108
38499,2024,9,9,0,0,100,178729,2367,89
38500,2024,1,1,0,0,100,307640,2930,105
38501,2024,19,7,12,63,37,244496,3293,77
38503,2024,27,12,15,56,44,272773,3420,87
38504,2024,15,15,0,0,100,281454,3454,84
38505,2024,6,5,1,17,83,289119,2706,97
38507,2024,52,42,10,19,81,289448,3042,99
38508,2024,4,4,0,0,100,269362,2834,96
38509,2024,77,30,47,61,39,151997,2092,75
38511,2024,25,14,11,44,56,313016,3408,95
38512,2024,6,6,0,0,100,321783,3015,107
38513,2024,4,4,0,0,100,238250,2062,116
38514,2024,2,2,0,0,100,201885,1892,111
38515,2024,21,21,0,0,100,271363,2995,95
38516,2024,72,17,55,76,24,318049,3906,82
38517,2024,82,50,32,39,61,208370,2372,86
38518,2024,4,4,0,0,100,85500,1518,66
38519,2024,24,16,8,33,67,342916,3773,99
38520,2024,4,4,0,0,100,236825,2098,116
38521,2024,2,2,0,0,100,291095,1862,154
38522,2024,6,4,2,33,67,95333,1645,56
38523,2024,8,8,0,0,100,161245,2018,90
38524,2024,49,28,21,43,57,279674,3452,82
38525,2024,7,6,1,14,86,169705,1749,98
38526,2024,3,3,0,0,100,239000,2383,97
38527,2024,14,2,12,86,14,540413,7206,75
38528,2024,5,5,0,0,100,295740,3647,86
38529,2024,35,18,17,49,51,313877,3531,89
38530,2024,23,13,10,43,57,251051,2825,93
38531,2024,2,2,0,0,100,144500,1377,104
38532,2024,3,3,0,0,100,240850,3184,75
38533,2024,5,4,1,20,80,415180,3371,121
38535,2024,1,1,0,0,100,324900,3610,90
38536,2024,13,13,0,0,100,284758,2732,114
38537,2024,56,27,29,52,48,222190,2875,79
38538,2024,44,25,19,43,57,292910,3498,84
38539,2024,11,11,0,0,100,211054,2089,96
38540,2024,11,11,0,0,100,321697,3250,97
38542,2024,2,2,0,0,100,324692,2290,140
38543,2024,16,12,4,25,75,188269,2188,86
38544,2024,323,81,242,75,25,213105,2562,81
38545,2024,67,41,26,39,61,323884,3616,93
38546,2024,5,5,0,0,100,227300,2777,85
38547,2024,88,43,45,51,49,224727,2947,77
38548,2024,172,22,150,87,13,194848,3638,52
38550,2024,3,3,0,0,100,956500,6323,147
38551,2024,1,1,0,0,100,290000,2132,136
38553,2024,101,71,30,30,70,204432,2295,89
38554,2024,12,12,0,0,100,288762,2931,99
38555,2024,5,5,0,0,100,256211,2245,109
38556,2024,14,12,2,14,86,247081,2768,98
38557,2024,29,25,4,14,86,389249,3727,108
38558,2024,13,8,5,38,62,302305,3517,88
38559,2024,55,28,27,49,51,206707,2458,85
38560,2024,12,9,3,25,75,226081,2473,94
38561,2024,15,15,0,0,100,211409,1992,104
38562,2024,87,30,57,66,34,152815,2288,67
38563,2024,272,63,209,77,23,195046,2515,76
38564,2024,6,6,0,0,100,193201,2302,86
38565,2024,76,48,28,37,63,256856,2879,88
38566,2024,14,14,0,0,100,246771,2503,102
38567,2024,74,1,73,99,1,101912,2976,33
39001,2024,5,4,1,20,80,176800,1722,104
39002,2024,1,1,0,0,100,77000,1540,50
39004,2024,1,1,0,0,100,228900,1449,158
39006,2024,1,1,0,0,100,155000,886,175
39008,2024,5,5,0,0,100,203300,1851,113
39009,2024,2,1,1,50,50,71000,686,109
39011,2024,1,1,0,0,100,80000,1111,72
39013,2024,39,32,7,18,82,164772,1802,95
39014,2024,2,0,2,100,0,88500,1012,90
39015,2024,2,2,0,0,100,91875,1910,48
39016,2024,11,7,4,36,64,133545,1466,107
39017,2024,8,8,0,0,100,161468,1503,106
39018,2024,6,6,0,0,100,133401,1497,88
39019,2024,3,3,0,0,100,194012,3095,73
39021,2024,6,6,0,0,100,141083,1584,89
39022,2024,2,2,0,0,100,219550,1206,188
39024,2024,3,3,0,0,100,177800,1570,115
39025,2024,1,1,0,0,100,158000,1663,95
39026,2024,3,2,1,33,67,192550,1840,96
39027,2024,2,2,0,0,100,181000,1649,104
39028,2024,4,4,0,0,100,174425,1612,108
39029,2024,6,6,0,0,100,147667,1479,98
39030,2024,3,3,0,0,100,159667,1662,97
39032,2024,1,1,0,0,100,120000,1395,86
39034,2024,2,2,0,0,100,217500,1650,127
39035,2024,2,2,0,0,100,108000,1508,72
39038,2024,1,1,0,0,100,478000,3677,130
39039,2024,4,4,0,0,100,198765,2095,92
39040,2024,2,2,0,0,100,77500,740,100
39042,2024,5,5,0,0,100,183670,1860,96
39043,2024,11,10,1,9,91,143543,1604,95
39045,2024,1,1,0,0,100,228300,1887,121
39047,2024,11,7,4,36,64,226944,2427,103
39048,2024,2,2,0,0,100,152500,966,160
39049,2024,4,4,0,0,100,146372,1590,98
39050,2024,2,2,0,0,100,183025,1990,88
39051,2024,4,4,0,0,100,153462,1582,104
39053,2024,1,1,0,0,100,280000,2333,120
39055,2024,2,2,0,0,100,272950,2590,114
39056,2024,14,12,2,14,86,150625,1759,86
39058,2024,1,1,0,0,100,207000,2112,98
39059,2024,28,12,16,57,43,226452,2863,81
39061,2024,1,1,0,0,100,40000,667,60
39068,2024,5,4,1,20,80,182278,2664,79
39070,2024,3,3,0,0,100,256433,2304,121
39072,2024,3,3,0,0,100,126797,1153,116
39073,2024,1,1,0,0,100,104700,1047,100
39074,2024,3,3,0,0,100,179333,1593,106
39076,2024,3,3,0,0,100,118000,1205,101
39078,2024,9,8,1,11,89,192972,2953,100
39079,2024,2,2,0,0,100,242550,1820,134
39080,2024,1,1,0,0,100,85000,1545,55
39081,2024,2,2,0,0,100,225500,1952,121
39083,2024,2,2,0,0,100,230000,2206,102
39084,2024,3,3,0,0,100,197233,1456,135
39085,2024,2,2,0,0,100,262900,3433,88
39086,2024,4,4,0,0,100,188750,1648,100
39088,2024,2,2,0,0,100,101500,1244,78
39090,2024,1,1,0,0,100,233200,2915,80
39091,2024,1,1,0,0,100,34000,405,84
39092,2024,1,1,0,0,100,59950,681,88
39093,2024,3,3,0,0,100,158650,1782,88
39094,2024,1,1,0,0,100,360000,1915,188
39096,2024,2,2,0,0,100,148150,1785,82
39097,2024,98,39,59,60,40,143157,1880,80
39099,2024,2,2,0,0,100,199750,2103,94
39101,2024,12,10,2,17,83,154446,2038,77
39102,2024,2,1,1,50,50,239720,2474,96
39103,2024,2,2,0,0,100,226625,1065,204
39104,2024,5,5,0,0,100,104240,1220,86
39105,2024,1,1,0,0,100,160000,1778,90
39106,2024,3,3,0,0,100,270000,1880,127
39107,2024,3,3,0,0,100,186000,1496,122
39109,2024,1,1,0,0,100,140000,848,165
39110,2024,1,1,0,0,100,140000,2692,52
39112,2024,2,2,0,0,100,121250,1389,89
39114,2024,4,4,0,0,100,302610,2954,120
39116,2024,2,2,0,0,100,221700,1482,150
39119,2024,3,3,0,0,100,128333,1188,108
39120,2024,2,2,0,0,100,225350,2346,98
39121,2024,3,3,0,0,100,171477,1446,116
39122,2024,2,2,0,0,100,37000,1098,48
39124,2024,3,3,0,0,100,134000,1600,82
39126,2024,1,1,0,0,100,150000,2055,73
39128,2024,20,19,1,5,95,119909,1389,92
39129,2024,5,4,1,20,80,257696,2485,98
39130,2024,4,4,0,0,100,104875,1206,80
39131,2024,6,6,0,0,100,187020,1895,101
39132,2024,2,2,0,0,100,103250,1888,54
39134,2024,3,3,0,0,100,156600,1366,119
39137,2024,5,5,0,0,100,182600,1416,131
39138,2024,3,3,0,0,100,157667,1197,138
39140,2024,1,1,0,0,100,157200,1497,105
39141,2024,3,3,0,0,100,171533,1662,107
39142,2024,3,3,0,0,100,127222,1403,94
39145,2024,1,1,0,0,100,120000,1188,101
39146,2024,6,6,0,0,100,285940,1868,145
39149,2024,1,1,0,0,100,55000,618,89
39150,2024,12,11,1,8,92,159517,1912,85
39151,2024,1,1,0,0,100,395750,4947,80
39153,2024,7,7,0,0,100,245893,2409,104
39154,2024,14,11,3,21,79,181916,2115,91
39156,2024,3,3,0,0,100,207367,2275,83
39159,2024,1,1,0,0,100,140000,1373,102
39160,2024,6,6,0,0,100,187512,1378,132
39162,2024,5,5,0,0,100,175110,2154,81
39163,2024,2,2,0,0,100,123000,1081,127
39164,2024,3,3,0,0,100,190800,1551,117
39165,2024,3,3,0,0,100,186183,2765,71
39166,2024,3,3,0,0,100,118000,1834,83
39167,2024,7,7,0,0,100,168964,1465,121
39169,2024,5,5,0,0,100,154780,1242,135
39170,2024,5,5,0,0,100,233320,2062,113
39171,2024,13,13,0,0,100,191654,2042,101
39172,2024,4,4,0,0,100,158458,1856,96
39173,2024,25,19,6,24,76,110417,1360,76
39174,2024,2,2,0,0,100,134000,1684,75
39175,2024,1,1,0,0,100,168700,2191,77
39176,2024,5,5,0,0,100,172730,1496,131
39177,2024,7,7,0,0,100,163671,1508,107
39178,2024,2,2,0,0,100,150125,1912,109
39179,2024,1,1,0,0,100,280000,2435,115
39180,2024,1,1,0,0,100,115000,1337,86
39182,2024,5,5,0,0,100,193200,2173,85
39183,2024,4,4,0,0,100,203125,1456,140
39184,2024,4,2,2,50,50,149150,1378,112
39185,2024,5,5,0,0,100,172390,1716,101
39187,2024,1,1,0,0,100,260000,3611,72
39188,2024,5,5,0,0,100,212260,1706,126
39189,2024,35,30,5,14,86,150090,1630,92
39190,2024,11,10,1,9,91,188954,1855,103
39193,2024,7,7,0,0,100,153007,1363,116
39194,2024,5,5,0,0,100,132086,1333,107
39197,2024,5,5,0,0,100,151910,1728,89
39198,2024,298,122,176,59,41,156879,1867,82
39199,2024,10,10,0,0,100,234619,2337,99
39200,2024,4,4,0,0,100,238738,1703,145
39201,2024,4,4,0,0,100,203480,2954,69
39202,2024,2,2,0,0,100,125275,1666,84
39203,2024,1,1,0,0,100,211612,1959,108
39204,2024,1,1,0,0,100,100000,1449,69
39205,2024,4,4,0,0,100,258075,2025,122
39206,2024,1,1,0,0,100,96550,3713,26
39207,2024,2,2,0,0,100,178500,2839,60
39209,2024,6,6,0,0,100,178050,1519,121
39210,2024,5,4,1,20,80,168458,1418,126
39211,2024,2,2,0,0,100,157500,1291,128
39216,2024,4,3,1,25,75,123500,1230,98
39217,2024,4,4,0,0,100,212350,1845,114
39218,2024,3,3,0,0,100,182148,2013,90
39219,2024,4,3,1,25,75,129100,1626,82
39220,2024,5,5,0,0,100,181830,1766,105
39222,2024,1,1,0,0,100,160600,1338,120
39223,2024,1,1,0,0,100,105000,955,110
39225,2024,4,4,0,0,100,218238,1609,136
39227,2024,4,1,3,75,25,219145,2363,80
39228,2024,8,7,1,12,88,263875,3157,85
39230,2024,1,1,0,0,100,545130,7788,70
39232,2024,6,6,0,0,100,225400,2270,101
39233,2024,30,23,7,23,77,177046,1774,101
39234,2024,2,2,0,0,100,110000,864,128
39235,2024,11,7,4,36,64,139164,1653,88
39237,2024,1,1,0,0,100,204920,1863,110
39238,2024,1,1,0,0,100,346000,2110,164
39239,2024,2,2,0,0,100,316355,2252,138
39241,2024,3,3,0,0,100,184933,1600,113
39244,2024,2,2,0,0,100,137100,1480,102
39245,2024,5,5,0,0,100,179582,1565,115
39246,2024,2,2,0,0,100,147775,1618,92
39247,2024,2,2,0,0,100,103250,1388,74
39250,2024,2,2,0,0,100,189550,1802,116
39251,2024,5,5,0,0,100,183274,1660,109
39252,2024,5,5,0,0,100,188890,1663,115
39253,2024,4,4,0,0,100,133650,1339,100
39255,2024,4,4,0,0,100,186550,1508,126
39258,2024,4,4,0,0,100,258252,2020,125
39261,2024,2,2,0,0,100,82500,676,123
39262,2024,2,2,0,0,100,249475,1786,133
39263,2024,3,3,0,0,100,132483,1686,88
39265,2024,3,3,0,0,100,280167,2154,122
39266,2024,3,3,0,0,100,160167,1855,87
39269,2024,2,1,1,50,50,124650,832,144
39270,2024,4,4,0,0,100,196960,2288,96
39271,2024,5,3,2,40,60,148600,1290,106
39273,2024,5,5,0,0,100,84636,726,117
39274,2024,4,2,2,50,50,202392,3256,64
39275,2024,9,6,3,33,67,327225,3949,83
39278,2024,1,1,0,0,100,201000,2310,87
39279,2024,4,4,0,0,100,213425,1852,110
39280,2024,2,2,0,0,100,129500,1194,110
39282,2024,3,2,1,33,67,130167,1315,98
39283,2024,2,2,0,0,100,169000,1715,100
39284,2024,2,2,0,0,100,143500,1693,84
39285,2024,8,8,0,0,100,137494,1217,113
39286,2024,13,11,2,15,85,136082,1291,105
39288,2024,6,6,0,0,100,223193,1683,118
39289,2024,4,4,0,0,100,115375,1476,76
39290,2024,6,6,0,0,100,127338,1279,96
39291,2024,4,3,1,25,75,173885,2019,86
39292,2024,1,1,0,0,100,121000,1222,99
39293,2024,3,3,0,0,100,145750,1521,100
39295,2024,2,2,0,0,100,125000,930,134
39296,2024,2,2,0,0,100,224740,1872,126
39297,2024,13,12,1,8,92,229054,2422,109
39299,2024,4,4,0,0,100,139980,1071,128
39300,2024,185,50,135,73,27,138638,1764,78
39301,2024,2,2,0,0,100,174000,1386,129
39304,2024,5,1,4,80,20,100800,1143,84
39305,2024,7,7,0,0,100,167386,1598,107
39306,2024,9,8,1,11,89,187026,1905,97
39307,2024,5,5,0,0,100,209460,2765,73
39308,2024,2,2,0,0,100,275450,2022,147
39310,2024,6,6,0,0,100,174150,1750,111
39313,2024,2,1,1,50,50,163500,1189,114
39315,2024,3,3,0,0,100,243200,1629,148
39317,2024,1,1,0,0,100,177500,1972,90
39319,2024,1,1,0,0,100,110000,1158,95
39320,2024,4,4,0,0,100,127599,915,136
39321,2024,1,1,0,0,100,100000,1220,82
39322,2024,2,2,0,0,100,125000,1107,114
39323,2024,4,4,0,0,100,193550,1467,125
39325,2024,6,5,1,17,83,228667,1553,140
39326,2024,3,3,0,0,100,170000,1911,86
39327,2024,5,4,1,20,80,177910,2110,86
39328,2024,2,2,0,0,100,248959,1409,151
39329,2024,2,2,0,0,100,109100,648,187
39331,2024,5,5,0,0,100,167650,1634,101
39333,2024,16,12,4,25,75,122469,1409,85
39338,2024,4,4,0,0,100,133012,1262,99
39339,2024,2,2,0,0,100,335000,1768,189
39342,2024,2,2,0,0,100,262495,2298,112
39344,2024,4,4,0,0,100,239838,2164,112
39345,2024,7,5,2,29,71,189371,2453,79
39348,2024,4,4,0,0,100,200914,1740,132
39349,2024,2,2,0,0,100,191708,1786,120
39350,2024,3,3,0,0,100,160533,1507,106
39353,2024,5,5,0,0,100,144890,1247,109
39354,2024,4,4,0,0,100,185950,1502,134
39355,2024,1,1,0,0,100,88000,863,102
39356,2024,1,1,0,0,100,90000,1125,80
39360,2024,2,2,0,0,100,138200,886,159
39361,2024,2,2,0,0,100,181250,1482,122
39362,2024,45,26,19,42,58,137663,1754,79
39363,2024,1,1,0,0,100,130000,1548,84
39364,2024,4,4,0,0,100,224557,2276,102
39365,2024,11,10,1,9,91,164661,1569,106
39366,2024,2,2,0,0,100,207000,2074,108
39367,2024,16,15,1,6,94,341054,3060,118
39368,2024,84,10,74,88,12,106955,1414,75
39370,2024,4,4,0,0,100,153425,1650,96
39373,2024,5,4,1,20,80,206660,2460,90
39376,2024,1,1,0,0,100,222800,1937,115
39377,2024,4,4,0,0,100,203625,2046,100
39378,2024,13,13,0,0,100,162927,1531,106
39379,2024,4,4,0,0,100,206500,1426,142
39380,2024,1,1,0,0,100,92000,821,112
39385,2024,10,10,0,0,100,114065,1455,89
39387,2024,1,1,0,0,100,225000,1250,180
39388,2024,1,1,0,0,100,80000,1333,60
39389,2024,5,3,2,40,60,212548,1998,106
39390,2024,3,3,0,0,100,246900,2225,112
39391,2024,5,4,1,20,80,192133,1673,109
39392,2024,5,5,0,0,100,156820,1025,149
39394,2024,2,2,0,0,100,127000,1410,90
39396,2024,11,8,3,27,73,122666,1335,89
39397,2024,16,12,4,25,75,148084,1540,100
39398,2024,4,4,0,0,100,177625,1748,117
39399,2024,4,4,0,0,100,197418,1464,136
39401,2024,5,5,0,0,100,147533,1350,123
39402,2024,5,5,0,0,100,217980,2082,98
39403,2024,3,3,0,0,100,175267,1765,99
39404,2024,2,1,1,50,50,158500,6964,49
39405,2024,7,7,0,0,100,261205,1867,139
39406,2024,1,1,0,0,100,200000,2299,87
39407,2024,2,2,0,0,100,136800,1532,90
39408,2024,2,2,0,0,100,96000,1244,73
39409,2024,1,1,0,0,100,90000,750,120
39411,2024,22,16,6,27,73,159427,1864,92
39412,2024,3,3,0,0,100,168883,1473,119
39413,2024,1,1,0,0,100,630000,2351,268
39415,2024,17,17,0,0,100,138162,1394,101
39421,2024,2,2,0,0,100,356250,2326,150
39422,2024,4,4,0,0,100,154540,1605,98
39423,2024,4,4,0,0,100,118000,1123,95
39424,2024,4,4,0,0,100,237745,2262,109
39426,2024,4,4,0,0,100,227638,1663,138
39427,2024,1,1,0,0,100,302500,2382,127
39429,2024,3,3,0,0,100,232000,1688,142
39431,2024,1,1,0,0,100,245100,2580,95
39432,2024,1,1,0,0,100,86000,748,115
39434,2024,49,35,14,29,71,152418,1774,90
39435,2024,10,7,3,30,70,154717,1828,93
39436,2024,1,1,0,0,100,100200,777,129
39437,2024,6,5,1,17,83,154000,1603,98
39439,2024,4,4,0,0,100,243625,2644,92
39441,2024,37,14,23,62,38,204048,3689,57
39444,2024,2,2,0,0,100,161875,1792,94
39446,2024,3,3,0,0,100,135267,1434,100
39447,2024,2,2,0,0,100,245600,1937,128
39448,2024,5,5,0,0,100,199443,1340,178
39449,2024,2,2,0,0,100,216700,2101,101
39451,2024,9,8,1,11,89,171356,2283,84
39452,2024,9,8,1,11,89,208884,1670,126
39453,2024,2,2,0,0,100,151125,1252,104
39456,2024,3,3,0,0,100,104333,1197,95
39460,2024,3,2,1,33,67,214060,1276,161
39461,2024,1,1,0,0,100,170000,1405,121
39462,2024,7,7,0,0,100,174900,1601,120
39463,2024,2,2,0,0,100,181500,1995,91
39464,2024,3,3,0,0,100,249000,1850,134
39465,2024,1,1,0,0,100,260000,1699,153
39466,2024,2,2,0,0,100,82500,1031,80
39467,2024,3,2,1,33,67,111000,1317,80
39468,2024,3,3,0,0,100,110750,1399,83
39470,2024,93,13,80,86,14,178318,3478,53
39471,2024,6,5,1,17,83,137812,1444,97
39472,2024,3,3,0,0,100,125667,2026,67
39474,2024,3,3,0,0,100,179817,1714,103
39475,2024,29,25,4,14,86,156937,1559,98
39476,2024,12,12,0,0,100,169096,1584,96
39478,2024,105,30,75,71,29,85745,1042,80
39479,2024,1,1,0,0,100,145000,1021,142
39481,2024,3,3,0,0,100,231480,2753,86
39485,2024,15,15,0,0,100,96319,1084,89
39486,2024,4,4,0,0,100,148778,1554,92
39487,2024,11,5,6,55,45,196618,2715,81
39489,2024,4,4,0,0,100,165275,1303,126
39490,2024,2,2,0,0,100,141250,1617,88
39491,2024,8,3,5,62,38,101555,1297,80
39492,2024,2,2,0,0,100,118000,1221,92
39493,2024,6,6,0,0,100,144642,1252,111
39494,2024,6,6,0,0,100,298033,2404,130
39498,2024,9,9,0,0,100,292439,2639,111
39500,2024,30,17,13,43,57,130923,1320,100
39501,2024,8,6,2,25,75,143503,1456,98
39502,2024,2,2,0,0,100,172500,1494,115
39503,2024,2,2,0,0,100,266750,1715,158
39504,2024,5,5,0,0,100,224200,1946,127
39508,2024,8,8,0,0,100,162752,1721,99
39510,2024,6,4,2,33,67,287278,3346,79
39511,2024,2,2,0,0,100,75000,766,95
39513,2024,2,2,0,0,100,175900,1172,150
39514,2024,4,4,0,0,100,162730,1172,116
39517,2024,5,3,2,40,60,136609,1448,92
39518,2024,1,1,0,0,100,314000,1359,231
39520,2024,6,6,0,0,100,172092,1586,110
39523,2024,2,2,0,0,100,174120,2129,82
39525,2024,4,4,0,0,100,194325,1830,106
39526,2024,42,34,8,19,81,134512,1561,87
39528,2024,2,2,0,0,100,93500,959,98
39530,2024,10,9,1,10,90,193015,2180,104
39531,2024,2,2,0,0,100,100000,1142,88
39533,2024,1,1,0,0,100,105000,1094,96
39535,2024,6,6,0,0,100,184408,1679,116
39537,2024,3,3,0,0,100,204470,1904,99
39539,2024,2,2,0,0,100,120500,1690,72
39540,2024,1,1,0,0,100,121420,1265,96
39543,2024,5,5,0,0,100,267150,2142,124
39546,2024,1,1,0,0,100,229000,1924,119
39547,2024,3,2,1,33,67,112333,1298,90
39550,2024,2,2,0,0,100,117500,1411,94
39551,2024,1,1,0,0,100,45000,643,70
39552,2024,4,4,0,0,100,92125,1155,88
39553,2024,2,2,0,0,100,69750,761,92
39555,2024,4,4,0,0,100,130631,1217,107
39556,2024,4,4,0,0,100,150475,1730,90
39558,2024,1,1,0,0,100,110000,1038,106
39559,2024,4,4,0,0,100,171990,1307,122
39560,2024,8,7,1,12,88,151688,1740,92
39561,2024,2,2,0,0,100,107500,1115,93
39567,2024,2,1,1,50,50,211725,2325,86
39568,2024,1,1,0,0,100,425000,1778,239
39569,2024,6,6,0,0,100,186492,2115,99
39571,2024,1,1,0,0,100,140000,909,154
39572,2024,4,4,0,0,100,245850,1974,124
39573,2024,7,6,1,14,86,215007,1868,118
39574,2024,1,1,0,0,100,155000,1435,108
39576,2024,5,5,0,0,100,272400,1883,126
39577,2024,6,6,0,0,100,167083,1995,95
39579,2024,5,5,0,0,100,268400,2091,131
39582,2024,10,10,0,0,100,180080,1542,123
39583,2024,3,3,0,0,100,96500,977,104
39584,2024,2,2,0,0,100,132950,1343,104
40001,2024,84,71,13,15,85,145058,1607,94
40002,2024,15,15,0,0,100,197403,1544,134
40003,2024,5,5,0,0,100,221674,2127,101
40004,2024,26,21,5,19,81,481984,4701,101
40005,2024,1,1,0,0,100,165000,2062,80
40006,2024,4,4,0,0,100,233750,1935,128
40007,2024,5,5,0,0,100,197729,1624,118
40008,2024,1,1,0,0,100,20000,417,48
40011,2024,2,2,0,0,100,229475,2663,108
40012,2024,2,2,0,0,100,184000,1831,100
40013,2024,1,1,0,0,100,72850,364,200
40014,2024,3,3,0,0,100,162362,1470,117
40015,2024,1,1,0,0,100,240000,3200,75
40016,2024,4,4,0,0,100,144659,1515,94
40017,2024,5,5,0,0,100,249960,1686,174
40018,2024,6,5,1,17,83,181800,1788,104
40019,2024,30,20,10,33,67,180133,2929,64
40020,2024,9,9,0,0,100,225889,1593,150
40021,2024,27,24,3,11,89,320170,4045,81
40022,2024,5,5,0,0,100,236400,1888,144
40023,2024,2,2,0,0,100,96930,1018,97
40024,2024,1,1,0,0,100,211000,2344,90
40025,2024,8,8,0,0,100,180808,1763,108
40026,2024,6,6,0,0,100,254158,1997,131
40027,2024,2,2,0,0,100,185730,2494,76
40028,2024,3,3,0,0,100,200567,2014,102
40029,2024,2,2,0,0,100,217650,2086,105
40030,2024,1,1,0,0,100,55000,561,98
40031,2024,13,12,1,8,92,205266,1913,109
40032,2024,1,1,0,0,100,160000,2000,80
40033,2024,3,3,0,0,100,215551,1739,113
40034,2024,8,8,0,0,100,304611,2344,125
40035,2024,2,2,0,0,100,232850,1964,118
40036,2024,58,43,15,26,74,330904,3965,84
40037,2024,16,16,0,0,100,247197,2018,128
40038,2024,2,2,0,0,100,90225,1162,82
40039,2024,3,3,0,0,100,111717,1193,91
40040,2024,3,3,0,0,100,177000,1514,115
40041,2024,1,1,0,0,100,319000,1888,169
40042,2024,1,1,0,0,100,310000,2897,107
40043,2024,25,20,5,20,80,178460,2515,74
40044,2024,9,9,0,0,100,402601,3166,126
40046,2024,299,150,149,50,50,296331,3886,79
40047,2024,3,3,0,0,100,110667,1363,83
40049,2024,7,7,0,0,100,207492,1765,127
40050,2024,1,1,0,0,100,161000,1342,120
40051,2024,2,2,0,0,100,187500,2142,87
40052,2024,2,2,0,0,100,161500,2015,81
40053,2024,5,5,0,0,100,147300,1529,106
40054,2024,2,2,0,0,100,128700,1952,66
40055,2024,16,16,0,0,100,242134,2200,108
40056,2024,9,9,0,0,100,197721,1926,102
40057,2024,2,2,0,0,100,172500,1351,128
40058,2024,7,7,0,0,100,135247,1495,104
40059,2024,6,6,0,0,100,107750,1219,105
40060,2024,5,5,0,0,100,248994,2197,116
40061,2024,9,9,0,0,100,187237,2048,92
40062,2024,4,4,0,0,100,238505,2220,110
40063,2024,5,4,1,20,80,312470,2887,107
40065,2024,284,135,149,52,48,413623,6602,65
40066,2024,7,6,1,14,86,217280,1612,134
40067,2024,6,6,0,0,100,240698,2340,106
40068,2024,14,6,8,57,43,124280,1458,72
40069,2024,4,4,0,0,100,181500,1543,127
40070,2024,6,6,0,0,100,195127,1564,130
40071,2024,5,5,0,0,100,193800,1944,104
40072,2024,2,2,0,0,100,176300,1672,142
40073,2024,2,2,0,0,100,125768,1522,85
40074,2024,7,7,0,0,100,169379,1541,116
40075,2024,44,34,10,23,77,237489,2554,94
40076,2024,4,4,0,0,100,116050,1030,126
40077,2024,3,3,0,0,100,343333,2410,142
40078,2024,5,5,0,0,100,120680,1161,116
40080,2024,11,11,0,0,100,131983,1508,93
40081,2024,3,3,0,0,100,263167,1580,157
40082,2024,2,2,0,0,100,152558,1581,96
40084,2024,4,4,0,0,100,258509,2143,123
40085,2024,1,1,0,0,100,275000,2523,109
40086,2024,10,10,0,0,100,174448,1520,114
40087,2024,2,2,0,0,100,107500,1415,66
40088,2024,443,145,298,67,33,155967,2529,64
40089,2024,10,10,0,0,100,187625,1901,101
40090,2024,2,2,0,0,100,215000,1844,122
40091,2024,3,3,0,0,100,89349,765,119
40092,2024,4,4,0,0,100,174750,1449,118
40093,2024,4,4,0,0,100,191250,1719,94
40094,2024,6,5,1,17,83,195471,3005,72
40095,2024,5,5,0,0,100,118583,1002,126
40096,2024,1,1,0,0,100,197000,2096,94
40097,2024,8,3,5,62,38,157108,3207,58
40098,2024,5,5,0,0,100,190934,1742,106
40099,2024,2,2,0,0,100,225765,1576,140
40100,2024,3,3,0,0,100,121333,1800,93
40101,2024,3,3,0,0,100,118748,1077,125
40102,2024,11,9,2,18,82,87527,1146,75
40103,2024,9,9,0,0,100,227833,2283,102
40104,2024,16,16,0,0,100,237932,2061,116
40105,2024,7,7,0,0,100,175886,1289,133
40106,2024,3,3,0,0,100,149600,1254,128
40108,2024,9,9,0,0,100,279466,3700,81
40109,2024,1,1,0,0,100,165000,1833,90
40110,2024,6,6,0,0,100,181922,1669,110
40111,2024,4,4,0,0,100,234575,1946,122
40113,2024,6,6,0,0,100,239641,2245,108
40114,2024,7,7,0,0,100,339358,2549,139
40115,2024,1,1,0,0,100,270000,2700,100
40117,2024,47,45,2,4,96,173042,1662,111
40118,2024,19,18,1,5,95,182815,1841,107
40119,2024,49,42,7,14,86,164085,1724,102
40120,2024,5,5,0,0,100,138800,1471,102
40121,2024,5,5,0,0,100,146202,1241,123
40122,2024,15,15,0,0,100,285966,2137,135
40123,2024,13,12,1,8,92,245311,3035,82
40124,2024,2,2,0,0,100,251000,1764,144
40125,2024,11,11,0,0,100,211885,2455,88
40126,2024,18,17,1,6,94,235877,2182,113
40127,2024,8,8,0,0,100,160250,1383,112
40128,2024,3,3,0,0,100,279605,2547,100
40129,2024,5,5,0,0,100,280600,2402,122
40130,2024,1,1,0,0,100,252200,1751,144
40131,2024,6,6,0,0,100,129758,1367,96
40132,2024,19,19,0,0,100,224758,2093,113
40133,2024,100,39,61,61,39,327983,4204,78
40134,2024,22,22,0,0,100,184054,2051,100
40135,2024,9,9,0,0,100,153990,1592,96
40137,2024,2,2,0,0,100,113250,852,113
40138,2024,3,3,0,0,100,205483,1875,112
40139,2024,1,1,0,0,100,175000,2536,69
40141,2024,6,6,0,0,100,192538,2050,96
40142,2024,11,11,0,0,100,310579,2425,129
40143,2024,1,1,0,0,100,350000,3500,100
40144,2024,5,5,0,0,100,118800,936,139
40145,2024,7,7,0,0,100,176900,1572,124
40146,2024,2,2,0,0,100,152500,1158,132
40149,2024,4,4,0,0,100,176908,1850,96
40150,2024,41,25,16,39,61,300083,4059,78
40151,2024,8,8,0,0,100,203900,1881,109
40152,2024,11,10,1,9,91,276699,2446,108
40154,2024,4,4,0,0,100,327836,2556,130
40155,2024,19,18,1,5,95,330180,3610,89
40156,2024,8,8,0,0,100,271275,2619,104
40157,2024,44,31,13,30,70,338527,3899,84
40158,2024,5,5,0,0,100,156502,1686,95
40159,2024,4,2,2,50,50,180302,2484,70
40160,2024,1,1,0,0,100,146000,1352,108
40161,2024,1,1,0,0,100,149100,987,151
40162,2024,5,5,0,0,100,209693,1920,106
40163,2024,8,8,0,0,100,232242,2599,84
40164,2024,1,1,0,0,100,115000,1162,99
40165,2024,6,6,0,0,100,148519,1473,108
40166,2024,1,1,0,0,100,103000,1062,97
40167,2024,6,6,0,0,100,185753,1948,102
40168,2024,22,20,2,9,91,333626,3027,111
40169,2024,2,2,0,0,100,185750,2178,67
40170,2024,2,2,0,0,100,69100,763,91
40171,2024,1,1,0,0,100,105000,1312,80
40172,2024,2,2,0,0,100,181900,968,211
40173,2024,2,2,0,0,100,191500,1331,148
40174,2024,1,1,0,0,100,180500,1504,120
40175,2024,4,4,0,0,100,185750,2104,91
40177,2024,2,2,0,0,100,245993,2633,92
40178,2024,6,5,1,17,83,271942,2111,128
40179,2024,13,13,0,0,100,419948,2958,143
40180,2024,11,11,0,0,100,233042,2197,109
40181,2024,12,12,0,0,100,489519,4973,99
40182,2024,10,10,0,0,100,287616,3278,91
40183,2024,9,9,0,0,100,254162,2054,143
40184,2024,181,103,78,43,57,241288,3718,70
40185,2024,1,1,0,0,100,46000,346,133
40186,2024,10,10,0,0,100,252740,1837,129
40187,2024,69,34,35,51,49,283753,5083,58
40188,2024,5,5,0,0,100,215209,1713,127
40190,2024,3,3,0,0,100,223667,2081,107
40191,2024,2,2,0,0,100,302000,1686,171
40192,2024,404,244,160,40,60,161423,2117,77
40193,2024,1,1,0,0,100,65000,1102,59
40194,2024,12,11,1,8,92,159888,1777,88
40195,2024,4,4,0,0,100,225872,1601,167
40196,2024,5,5,0,0,100,137000,1297,107
40197,2024,65,64,1,2,98,177788,2102,89
40198,2024,1,1,0,0,100,135000,1753,77
40199,2024,1,1,0,0,100,223540,1720,130
40200,2024,12,11,1,8,92,228667,1978,120
40201,2024,8,8,0,0,100,145404,1688,98
40202,2024,29,24,5,17,83,257682,2819,95
40203,2024,3,3,0,0,100,154602,1547,101
40204,2024,5,5,0,0,100,213800,2225,98
40205,2024,2,2,0,0,100,183580,1834,102
40206,2024,3,1,2,67,33,128867,1839,72
40207,2024,9,9,0,0,100,285299,2957,100
40208,2024,4,4,0,0,100,194750,1654,116
40209,2024,71,34,37,52,48,307951,4345,69
40210,2024,14,12,2,14,86,246375,2573,102
40211,2024,8,8,0,0,100,239462,2288,111
40212,2024,13,13,0,0,100,255214,2269,127
40213,2024,5,5,0,0,100,557477,4715,113
40214,2024,3,3,0,0,100,186667,2371,89
40215,2024,3,3,0,0,100,220333,1408,171
40216,2024,2,2,0,0,100,140000,2019,66
40217,2024,99,85,14,14,86,280472,3044,92
40218,2024,3,3,0,0,100,256667,2090,117
40220,2024,1,1,0,0,100,372200,4379,85
40221,2024,6,6,0,0,100,193167,1933,106
40222,2024,6,6,0,0,100,288442,2792,122
40223,2024,3,3,0,0,100,155706,1284,124
40224,2024,41,22,19,46,54,167516,2081,79
40225,2024,3,3,0,0,100,162545,1466,108
40226,2024,1,1,0,0,100,80000,667,120
40227,2024,7,6,1,14,86,206500,2115,99
40228,2024,9,8,1,11,89,187439,1764,121
40229,2024,14,12,2,14,86,223882,2935,86
40230,2024,21,19,2,10,90,233054,2514,94
40231,2024,9,9,0,0,100,378168,2669,135
40232,2024,2,2,0,0,100,209172,1718,119
40233,2024,21,21,0,0,100,241957,2098,123
40234,2024,4,4,0,0,100,156000,1758,98
40235,2024,5,4,1,20,80,138596,1128,128
40236,2024,1,1,0,0,100,290000,3187,91
40237,2024,6,6,0,0,100,228828,2285,104
40238,2024,4,4,0,0,100,211250,1781,123
40239,2024,1,1,0,0,100,81000,736,110
40240,2024,6,6,0,0,100,175140,1732,106
40242,2024,1,1,0,0,100,121860,916,133
40243,2024,28,28,0,0,100,230341,2040,114
40244,2024,10,9,1,10,90,337833,2852,119
40245,2024,39,37,2,5,95,149117,1744,88
40246,2024,9,8,1,11,89,171683,1921,92
40247,2024,3,3,0,0,100,137667,1003,140
40248,2024,11,11,0,0,100,392250,3948,101
40249,2024,4,4,0,0,100,146528,1414,109
40250,2024,9,9,0,0,100,222451,1877,117
40251,2024,3,3,0,0,100,451733,3015,153
40252,2024,3,3,0,0,100,179100,1820,105
40253,2024,10,10,0,0,100,141410,1434,109
40254,2024,9,9,0,0,100,275671,2628,111
40255,2024,6,6,0,0,100,256922,1984,133
40256,2024,12,11,1,8,92,274383,2677,107
40257,2024,19,19,0,0,100,287521,2764,115
40258,2024,1,1,0,0,100,127000,2016,63
40259,2024,5,5,0,0,100,102680,1327,82
40260,2024,3,3,0,0,100,166000,2107,80
40261,2024,13,11,2,15,85,315764,3027,112
40262,2024,2,2,0,0,100,152000,1996,76
40263,2024,5,4,1,20,80,163040,1847,93
40264,2024,10,9,1,10,90,337322,3361,102
40265,2024,2,2,0,0,100,91462,1279,68
40266,2024,26,14,12,46,54,258405,4343,69
40267,2024,6,6,0,0,100,151300,1324,124
40268,2024,3,3,0,0,100,268167,2029,136
40269,2024,7,7,0,0,100,258367,2435,112
40270,2024,8,8,0,0,100,128272,1433,87
40271,2024,5,5,0,0,100,306220,2276,139
40272,2024,23,17,6,26,74,329260,3187,104
40273,2024,56,42,14,25,75,402884,3941,105
40274,2024,13,13,0,0,100,213078,1994,107
40275,2024,8,8,0,0,100,181488,2000,94
40276,2024,5,4,1,20,80,322000,3468,96
40277,2024,7,7,0,0,100,298104,2360,134
40278,2024,17,16,1,6,94,270146,2922,96
40279,2024,234,118,116,50,50,191660,2761,71
40280,2024,35,25,10,29,71,184433,2039,91
40281,2024,132,86,46,35,65,189018,2349,80
40282,2024,60,46,14,23,77,150720,1619,98
40283,2024,29,20,9,31,69,212007,2557,83
40284,2024,128,71,57,45,55,256285,3366,78
40285,2024,11,11,0,0,100,264635,2132,127
40286,2024,12,12,0,0,100,137523,1316,107
40287,2024,45,36,9,20,80,376290,3910,96
40288,2024,14,14,0,0,100,151956,1648,93
40289,2024,4,4,0,0,100,181750,1890,94
40291,2024,14,13,1,7,93,522156,5051,104
40292,2024,20,20,0,0,100,420974,3457,119
40293,2024,7,7,0,0,100,342071,3016,140
40294,2024,20,20,0,0,100,280222,2703,107
40295,2024,20,20,0,0,100,207131,1975,115
40296,2024,142,66,76,54,46,479629,6657,68
40297,2024,1,1,0,0,100,90000,833,108
40298,2024,8,8,0,0,100,185930,1942,109
40299,2024,2,2,0,0,100,233825,1984,118
40300,2024,11,11,0,0,100,288563,2516,113
40303,2024,7,7,0,0,100,220571,1961,124
40304,2024,99,55,44,44,56,1046473,10022,98
40305,2024,2,2,0,0,100,97500,870,114
40306,2024,7,7,0,0,100,231786,1649,134
40307,2024,8,8,0,0,100,720514,3842,130
40308,2024,9,9,0,0,100,299017,1919,148
40309,2024,14,14,0,0,100,147779,1826,87
40310,2024,191,122,69,36,64,321551,4178,80
40311,2024,2,2,0,0,100,188000,2528,80
40312,2024,132,81,51,39,61,329404,3927,85
40313,2024,43,39,4,9,91,162827,1730,98
40314,2024,9,9,0,0,100,212353,2177,100
40315,2024,4,4,0,0,100,370038,2226,174
40316,2024,4,4,0,0,100,190675,1692,112
40317,2024,36,26,10,28,72,425060,4738,91
40318,2024,2,2,0,0,100,136900,1744,76
40319,2024,1,1,0,0,100,245950,1835,134
40320,2024,4,4,0,0,100,258875,2240,115
40321,2024,4,4,0,0,100,86854,1223,78
40322,2024,1,1,0,0,100,67701,967,70
40323,2024,1,1,0,0,100,77500,601,129
40324,2024,1,1,0,0,100,220000,2444,90
40325,2024,2,2,0,0,100,187000,1253,170
40326,2024,35,27,8,23,77,343993,4192,83
40327,2024,2,2,0,0,100,173250,1978,84
40328,2024,97,33,64,66,34,247667,5216,51
40329,2024,5,5,0,0,100,162710,1912,87
40330,2024,2,2,0,0,100,226275,2122,110
40331,2024,26,25,1,4,96,162395,1989,83
40332,2024,17,17,0,0,100,238324,2740,97
40333,2024,14,14,0,0,100,185730,1617,114
40334,2024,1,1,0,0,100,150000,1705,88
41001,2024,4,4,0,0,100,102625,1174,88
41002,2024,13,13,0,0,100,160786,1675,104
41003,2024,10,10,0,0,100,165830,1948,84
41004,2024,2,2,0,0,100,97000,1062,89
41006,2024,6,6,0,0,100,98333,1344,73
41007,2024,10,10,0,0,100,144300,1328,108
41008,2024,8,8,0,0,100,129025,1473,86
41009,2024,7,7,0,0,100,195766,1450,135
41010,2024,8,8,0,0,100,125375,1390,92
41012,2024,1,1,0,0,100,50000,2500,20
41013,2024,6,6,0,0,100,142508,1628,86
41014,2024,2,2,0,0,100,153500,1075,129
41016,2024,14,14,0,0,100,128027,1197,106
41017,2024,6,6,0,0,100,117833,1906,79
41018,2024,582,212,370,64,36,134331,1915,73
41019,2024,1,1,0,0,100,75800,1148,66
41020,2024,13,13,0,0,100,80628,943,92
41024,2024,5,5,0,0,100,86200,922,98
41025,2024,17,16,1,6,94,180374,2140,93
41026,2024,4,4,0,0,100,134000,1218,111
41027,2024,2,2,0,0,100,100000,901,111
41028,2024,4,4,0,0,100,203750,1143,174
41029,2024,18,18,0,0,100,159492,1576,100
41030,2024,5,5,0,0,100,110400,1277,89
41031,2024,30,28,2,7,93,243974,1947,126
41032,2024,32,32,0,0,100,190302,1904,101
41035,2024,7,7,0,0,100,134886,1213,117
41036,2024,7,7,0,0,100,140329,1301,113
41037,2024,1,1,0,0,100,90000,687,131
41038,2024,7,7,0,0,100,141168,1586,92
41039,2024,8,8,0,0,100,177125,1549,115
41040,2024,5,5,0,0,100,135556,1649,86
41041,2024,1,1,0,0,100,36500,811,45
41042,2024,4,4,0,0,100,163131,1296,135
41043,2024,25,25,0,0,100,100412,1191,89
41044,2024,21,21,0,0,100,109214,1117,100
41045,2024,14,14,0,0,100,156421,1681,91
41046,2024,9,9,0,0,100,152333,1581,107
41047,2024,50,35,15,30,70,163145,2088,80
41048,2024,3,3,0,0,100,131667,1260,94
41049,2024,11,11,0,0,100,116894,1363,95
41050,2024,10,9,1,10,90,199938,2265,87
41051,2024,13,13,0,0,100,140935,1595,86
41052,2024,13,13,0,0,100,139493,1480,94
41053,2024,10,10,0,0,100,113311,1013,113
41054,2024,1,1,0,0,100,180000,1636,110
41055,2024,25,25,0,0,100,154504,1788,92
41057,2024,1,1,0,0,100,50000,833,60
41058,2024,1,1,0,0,100,169000,2561,66
41059,2024,83,83,0,0,100,155325,1571,99
41060,2024,10,10,0,0,100,78846,972,82
41061,2024,10,10,0,0,100,220447,1904,118
41062,2024,7,7,0,0,100,195500,1979,113
41063,2024,5,5,0,0,100,111274,1311,95
41065,2024,7,7,0,0,100,100431,1317,72
41066,2024,3,3,0,0,100,203333,2247,102
41067,2024,29,28,1,3,97,186086,1937,99
41068,2024,10,10,0,0,100,111622,1381,86
41069,2024,4,4,0,0,100,182275,1604,110
41070,2024,9,9,0,0,100,104667,1274,82
41071,2024,8,8,0,0,100,211061,2014,109
41072,2024,8,8,0,0,100,195772,1856,112
41073,2024,2,2,0,0,100,107500,800,141
41074,2024,14,14,0,0,100,204779,1762,101
41075,2024,16,16,0,0,100,71532,903,81
41077,2024,1,1,0,0,100,98000,1089,90
41078,2024,8,8,0,0,100,124750,1095,120
41080,2024,10,10,0,0,100,161783,1675,96
41081,2024,1,1,0,0,100,83000,1221,68
41083,2024,4,4,0,0,100,88500,1645,54
41084,2024,20,20,0,0,100,136840,1364,98
41085,2024,15,15,0,0,100,175600,1709,100
41086,2024,4,4,0,0,100,172408,1612,110
41087,2024,9,9,0,0,100,111000,2189,78
41088,2024,7,7,0,0,100,154843,1326,125
41089,2024,3,2,1,33,67,106333,1282,68
41090,2024,3,3,0,0,100,123333,1136,106
41091,2024,8,8,0,0,100,171454,1728,103
41093,2024,3,3,0,0,100,227333,1570,144
41094,2024,11,11,0,0,100,169511,1809,89
41095,2024,13,11,2,15,85,98176,1350,70
41096,2024,6,6,0,0,100,85500,1316,66
41097,2024,25,25,0,0,100,91786,1178,82
41098,2024,2,2,0,0,100,94500,1316,72
41099,2024,6,6,0,0,100,136333,2122,65
41100,2024,4,4,0,0,100,207550,1864,120
41101,2024,12,12,0,0,100,125900,1360,94
41102,2024,3,3,0,0,100,218967,1402,160
41103,2024,3,3,0,0,100,116167,1480,81
41104,2024,19,17,2,11,89,203297,1969,107
41105,2024,11,10,1,9,91,163591,1322,131
41106,2024,32,32,0,0,100,166671,1724,95
41107,2024,3,3,0,0,100,168733,1604,105
41108,2024,2,2,0,0,100,160250,1828,98
41109,2024,5,5,0,0,100,109200,1588,70
41110,2024,11,11,0,0,100,210733,2065,98
41112,2024,2,2,0,0,100,462450,2240,201
41113,2024,4,4,0,0,100,91500,1186,72
41114,2024,3,3,0,0,100,152333,849,170
41115,2024,10,10,0,0,100,133700,1469,88
41116,2024,1,1,0,0,100,160000,1185,135
41118,2024,3,3,0,0,100,120108,1332,92
41120,2024,9,9,0,0,100,168807,1677,110
41122,2024,1,1,0,0,100,65000,774,84
41123,2024,9,9,0,0,100,126833,1258,107
41124,2024,4,4,0,0,100,106650,1283,88
41125,2024,7,7,0,0,100,128357,1195,115
41126,2024,7,7,0,0,100,78714,1102,71
41127,2024,4,4,0,0,100,88234,1280,71
41128,2024,9,9,0,0,100,162611,1621,102
41129,2024,7,7,0,0,100,183143,1795,108
41130,2024,4,4,0,0,100,117675,1443,82
41131,2024,9,9,0,0,100,118558,1761,67
41132,2024,7,7,0,0,100,118781,1279,94
41134,2024,6,6,0,0,100,155205,1452,122
41135,2024,15,15,0,0,100,118676,1133,105
41136,2024,66,62,4,6,94,137586,1640,88
41137,2024,5,5,0,0,100,150392,1480,93
41139,2024,19,19,0,0,100,88839,1142,75
41140,2024,6,6,0,0,100,115142,1380,81
41141,2024,3,3,0,0,100,49000,859,59
41142,2024,30,30,0,0,100,173019,1650,105
41143,2024,16,16,0,0,100,99438,1136,83
41144,2024,13,12,1,8,92,153207,1538,98
41145,2024,6,6,0,0,100,159198,1728,92
41146,2024,8,8,0,0,100,118175,1650,78
41147,2024,16,15,1,6,94,183538,1830,97
41148,2024,13,13,0,0,100,165871,1672,96
41149,2024,54,52,2,4,96,174370,1632,93
41150,2024,31,31,0,0,100,204197,1831,114
41151,2024,74,58,16,22,78,141442,1734,79
41152,2024,18,18,0,0,100,147703,1535,101
41153,2024,1,1,0,0,100,180000,1429,126
41154,2024,14,14,0,0,100,129446,1351,90
41155,2024,7,7,0,0,100,102000,1076,93
41156,2024,8,8,0,0,100,182062,1851,97
41157,2024,10,10,0,0,100,154650,1675,99
41158,2024,25,23,2,8,92,151942,1744,89
41159,2024,12,12,0,0,100,220847,2006,112
41160,2024,6,6,0,0,100,296909,3468,115
41161,2024,25,25,0,0,100,223030,2262,105
41163,2024,1,1,0,0,100,145000,1495,97
41164,2024,25,24,1,4,96,133094,1432,94
41166,2024,2,2,0,0,100,174100,1380,136
41167,2024,38,37,1,3,97,143803,1647,90
41168,2024,2,2,0,0,100,164585,1660,94
41171,2024,27,27,0,0,100,115285,1371,85
41172,2024,3,3,0,0,100,156302,1373,126
41173,2024,38,38,0,0,100,135115,1298,106
41174,2024,2,2,0,0,100,142000,1712,84
41175,2024,15,15,0,0,100,87850,1456,78
41176,2024,12,12,0,0,100,160742,2156,75
41177,2024,1,1,0,0,100,40500,338,120
41179,2024,2,2,0,0,100,151500,1196,126
41180,2024,16,16,0,0,100,128750,1517,92
41181,2024,9,9,0,0,100,98804,1344,76
41182,2024,3,3,0,0,100,97500,1312,75
41184,2024,8,8,0,0,100,121121,1512,87
41185,2024,17,17,0,0,100,217083,1629,129
41186,2024,2,2,0,0,100,118500,1140,105
41187,2024,5,5,0,0,100,72200,843,84
41188,2024,1,1,0,0,100,40000,702,57
41189,2024,2,2,0,0,100,160250,1073,150
41190,2024,3,3,0,0,100,118000,1088,111
41191,2024,1,1,0,0,100,154000,1692,91
41192,2024,3,3,0,0,100,86833,1366,64
41193,2024,2,2,0,0,100,102500,1047,94
41194,2024,251,219,32,13,87,123490,1511,85
41198,2024,30,30,0,0,100,107549,1339,83
41199,2024,13,13,0,0,100,117646,1215,96
41200,2024,1,1,0,0,100,80000,1159,69
41201,2024,2,2,0,0,100,162500,1486,110
41203,2024,5,5,0,0,100,152540,1776,85
41204,2024,15,14,1,7,93,166053,2040,90
41205,2024,3,3,0,0,100,87333,921,92
41206,2024,2,2,0,0,100,237500,2112,113
41207,2024,8,8,0,0,100,147962,1467,94
41209,2024,7,7,0,0,100,182143,1879,98
41211,2024,39,38,1,3,97,142203,1790,80
41212,2024,39,38,1,3,97,214132,2121,100
41214,2024,6,6,0,0,100,122833,1506,83
41216,2024,12,12,0,0,100,84284,991,92
41217,2024,11,11,0,0,100,136477,1473,96
41218,2024,12,12,0,0,100,159252,1987,92
41219,2024,3,3,0,0,100,123333,1146,122
41220,2024,33,33,0,0,100,176125,1580,114
41221,2024,10,10,0,0,100,135394,1136,117
41222,2024,4,4,0,0,100,83000,1364,64
41223,2024,6,6,0,0,100,121045,1490,84
41224,2024,1,1,0,0,100,94000,803,117
41225,2024,11,11,0,0,100,138841,1483,92
41226,2024,37,37,0,0,100,173096,1639,107
41228,2024,6,6,0,0,100,144758,1627,96
41229,2024,13,13,0,0,100,116388,1209,99
41230,2024,14,13,1,7,93,203974,2063,100
41231,2024,14,14,0,0,100,154686,1517,101
41232,2024,78,74,4,5,95,122624,1517,88
41233,2024,11,11,0,0,100,147445,1485,105
41234,2024,3,3,0,0,100,200000,4152,79
41235,2024,15,15,0,0,100,111501,1283,85
41236,2024,1,1,0,0,100,98000,1849,53
41237,2024,19,19,0,0,100,155748,1747,89
41238,2024,32,26,6,19,81,87503,1508,71
41239,2024,13,12,1,8,92,153461,1680,94
41241,2024,15,15,0,0,100,189048,1561,127
41242,2024,57,56,1,2,98,103979,1420,80
41243,2024,6,6,0,0,100,114333,1361,87
41245,2024,4,4,0,0,100,158250,1289,124
41246,2024,5,5,0,0,100,209000,1410,143
41247,2024,19,19,0,0,100,163127,1539,107
41248,2024,16,16,0,0,100,98699,1234,81
41249,2024,17,17,0,0,100,129629,1312,101
41250,2024,2,2,0,0,100,210450,1445,135
41251,2024,2,2,0,0,100,137500,1850,75
41252,2024,15,15,0,0,100,157684,1662,90
41253,2024,1,1,0,0,100,138000,2091,66
41255,2024,6,6,0,0,100,112764,1157,103
41256,2024,11,11,0,0,100,135536,1360,98
41258,2024,15,15,0,0,100,135593,1326,105
41259,2024,12,12,0,0,100,151708,1543,105
41260,2024,1,1,0,0,100,187000,1069,175
41261,2024,1,1,0,0,100,157500,1750,90
41262,2024,9,9,0,0,100,187493,2306,93
41265,2024,6,6,0,0,100,171667,1887,122
41267,2024,6,6,0,0,100,166971,2148,81
41269,2024,206,129,77,37,63,158780,1860,84
41271,2024,3,3,0,0,100,121667,1134,137
41273,2024,5,5,0,0,100,96060,1113,81
41274,2024,1,1,0,0,100,110000,1375,80
41275,2024,12,12,0,0,100,154323,1256,126
41276,2024,28,26,2,7,93,192023,2034,95
41277,2024,1,1,0,0,100,24500,544,45
41278,2024,4,4,0,0,100,150750,1282,112
41279,2024,6,6,0,0,100,100150,1348,81
41280,2024,35,35,0,0,100,136806,1405,98
41282,2024,2,2,0,0,100,197500,1545,124
41283,2024,2,2,0,0,100,152290,1046,147
41284,2024,2,2,0,0,100,161225,1202,141
41285,2024,6,6,0,0,100,139367,1599,87
41286,2024,3,3,0,0,100,119333,1408,80
41287,2024,3,3,0,0,100,167167,1599,117
41288,2024,6,6,0,0,100,161803,1848,97
41289,2024,7,7,0,0,100,159437,1226,123
41290,2024,2,2,0,0,100,148700,1246,142
41291,2024,2,2,0,0,100,152200,1351,120
41292,2024,3,3,0,0,100,153000,1484,100
41293,2024,3,3,0,0,100,145000,923,132
41294,2024,15,15,0,0,100,164660,1840,84
41295,2024,60,58,2,3,97,193763,2199,90
41296,2024,15,15,0,0,100,193463,1835,108
41297,2024,3,3,0,0,100,529450,2434,139
42001,2024,5,5,0,0,100,149480,1860,88
42002,2024,1,1,0,0,100,135000,1607,84
42003,2024,12,12,0,0,100,157750,1802,92
42005,2024,98,42,56,57,43,196408,2230,85
42006,2024,7,7,0,0,100,204410,2261,99
42007,2024,4,4,0,0,100,85275,849,100
42008,2024,1,1,0,0,100,90000,2432,37
42009,2024,3,3,0,0,100,144167,1426,101
42010,2024,12,12,0,0,100,242361,2217,110
42011,2024,29,27,2,7,93,171201,1683,102
42012,2024,9,9,0,0,100,205522,2075,100
42013,2024,11,10,1,9,91,192686,1534,112
42014,2024,6,6,0,0,100,129167,1452,96
42015,2024,8,8,0,0,100,154064,1389,107
42016,2024,5,5,0,0,100,207790,1689,116
42017,2024,11,11,0,0,100,221233,2525,92
42018,2024,7,7,0,0,100,232771,2546,92
42019,2024,49,40,9,18,82,120562,1459,86
42020,2024,17,14,3,18,82,236200,2301,105
42021,2024,14,14,0,0,100,203261,1874,110
42022,2024,39,35,4,10,90,243036,2378,105
42023,2024,17,11,6,35,65,127857,1491,99
42026,2024,11,11,0,0,100,134794,1719,82
42027,2024,3,3,0,0,100,134000,1362,90
42028,2024,2,2,0,0,100,252500,2941,86
42029,2024,18,18,0,0,100,156128,1727,91
42030,2024,3,3,0,0,100,133000,1540,94
42032,2024,6,6,0,0,100,271583,3250,82
42033,2024,4,3,1,25,75,100000,1348,74
42034,2024,4,4,0,0,100,119412,1094,109
42036,2024,2,2,0,0,100,299650,4845,75
42037,2024,8,8,0,0,100,252054,2282,111
42038,2024,5,5,0,0,100,185510,1853,108
42039,2024,5,5,0,0,100,97112,1031,116
42040,2024,2,2,0,0,100,124000,1501,88
42041,2024,10,10,0,0,100,223769,2428,94
42042,2024,6,6,0,0,100,260908,2339,112
42043,2024,11,11,0,0,100,305624,2994,102
42044,2024,82,42,40,49,51,126805,1523,82
42045,2024,2,2,0,0,100,69150,1194,61
42046,2024,17,14,3,18,82,196267,2065,92
42048,2024,19,19,0,0,100,204688,1977,104
42049,2024,8,8,0,0,100,178464,1442,117
42050,2024,2,2,0,0,100,189325,1334,135
42051,2024,2,2,0,0,100,312495,3132,104
42052,2024,31,14,17,55,45,125464,1410,91
42053,2024,12,12,0,0,100,243719,2430,103
42054,2024,2,2,0,0,100,154500,1215,128
42056,2024,20,19,1,5,95,221562,2271,97
42058,2024,1,1,0,0,100,65000,833,78
42059,2024,45,38,7,16,84,206625,2227,94
42060,2024,1,1,0,0,100,219000,1955,112
42061,2024,3,3,0,0,100,198000,1259,157
42062,2024,8,8,0,0,100,222699,2154,105
42063,2024,3,3,0,0,100,68067,988,68
42064,2024,7,5,2,29,71,301524,3211,96
42065,2024,9,9,0,0,100,225144,2008,113
42066,2024,7,7,0,0,100,180834,2093,94
42067,2024,2,2,0,0,100,140000,1594,92
42068,2024,5,5,0,0,100,206460,1714,121
42069,2024,31,31,0,0,100,197483,1888,106
42070,2024,12,12,0,0,100,174016,1798,96
42071,2024,113,32,81,72,28,116154,1607,75
42072,2024,1,1,0,0,100,110000,458,240
42073,2024,10,10,0,0,100,185586,1793,104
42074,2024,12,12,0,0,100,166330,1772,94
42075,2024,6,6,0,0,100,261442,2526,105
42076,2024,6,6,0,0,100,101822,1284,82
42077,2024,3,3,0,0,100,86333,1073,94
42078,2024,3,3,0,0,100,98283,1371,77
42079,2024,7,7,0,0,100,106799,1073,99
42081,2024,12,11,1,8,92,190625,1662,122
42083,2024,4,4,0,0,100,222650,3065,78
42085,2024,6,5,1,17,83,226367,3147,84
42086,2024,9,9,0,0,100,126089,1253,103
42087,2024,10,10,0,0,100,240595,2051,113
42088,2024,9,9,0,0,100,218994,1747,136
42089,2024,4,4,0,0,100,142125,1506,86
42090,2024,4,4,0,0,100,141250,1281,110
42091,2024,7,7,0,0,100,136836,1695,83
42092,2024,35,19,16,46,54,277454,2520,109
42093,2024,6,6,0,0,100,288583,3697,82
42094,2024,94,49,45,48,52,170343,2061,87
42095,2024,159,50,109,69,31,112961,1342,82
42096,2024,4,3,1,25,75,171000,1626,103
42097,2024,58,39,19,33,67,253345,2391,100
42098,2024,4,3,1,25,75,215600,1372,149
42099,2024,28,13,15,54,46,170376,1960,86
42101,2024,3,3,0,0,100,281000,2542,115
42102,2024,4,4,0,0,100,217770,2075,107
42103,2024,38,20,18,47,53,221226,2379,91
42104,2024,8,8,0,0,100,98981,1046,90
42105,2024,3,3,0,0,100,191856,1568,128
42106,2024,4,4,0,0,100,53988,819,74
42107,2024,1,1,0,0,100,60350,1207,50
42108,2024,8,8,0,0,100,202550,2068,101
42109,2024,2,2,0,0,100,146278,1338,121
42110,2024,53,26,27,51,49,211052,2207,93
42112,2024,4,4,0,0,100,144474,1165,126
42115,2024,11,11,0,0,100,186000,1731,114
42116,2024,3,3,0,0,100,95117,1368,64
42117,2024,1,1,0,0,100,80000,1096,73
42118,2024,5,5,0,0,100,124600,1725,80
42119,2024,6,6,0,0,100,124667,1355,87
42120,2024,8,8,0,0,100,168981,1672,105
42121,2024,2,2,0,0,100,305000,2508,112
42122,2024,11,10,1,9,91,239728,1885,116
42123,2024,50,25,25,50,50,180316,2203,84
42124,2024,3,3,0,0,100,170177,1597,117
42125,2024,1,1,0,0,100,200000,1639,122
42126,2024,9,9,0,0,100,176472,1737,106
42127,2024,63,58,5,8,92,163209,1914,87
42128,2024,3,3,0,0,100,212470,1472,155
42129,2024,10,10,0,0,100,232441,2230,107
42130,2024,2,2,0,0,100,277350,2243,124
42131,2024,1,1,0,0,100,109000,1172,93
42132,2024,4,4,0,0,100,182182,2180,84
42133,2024,2,2,0,0,100,120000,1857,72
42134,2024,16,16,0,0,100,177916,1934,93
42135,2024,1,1,0,0,100,170000,1717,99
42136,2024,6,6,0,0,100,104667,820,133
42137,2024,7,7,0,0,100,165571,1630,124
42138,2024,4,4,0,0,100,265272,2215,119
42139,2024,8,6,2,25,75,165750,1609,102
42140,2024,2,2,0,0,100,183500,2252,87
42141,2024,7,7,0,0,100,132114,1268,105
42142,2024,2,2,0,0,100,127125,1806,70
42143,2024,3,3,0,0,100,192400,1953,97
42145,2024,12,10,2,17,83,165794,1833,86
42146,2024,1,1,0,0,100,160000,1067,150
42147,2024,180,91,89,49,51,169192,2060,83
42148,2024,5,5,0,0,100,111800,1131,95
42149,2024,51,30,21,41,59,186929,2286,82
42150,2024,4,4,0,0,100,142500,1261,114
42151,2024,3,3,0,0,100,272967,2336,122
42152,2024,6,6,0,0,100,261483,2766,109
42153,2024,10,8,2,20,80,183970,1566,126
42154,2024,3,2,1,33,67,79333,826,98
42155,2024,8,8,0,0,100,173350,1781,99
42156,2024,11,10,1,9,91,96893,1212,80
42157,2024,5,5,0,0,100,140348,1991,101
42159,2024,8,8,0,0,100,233988,1801,126
42160,2024,2,2,0,0,100,187325,1904,99
42161,2024,4,4,0,0,100,263792,2267,117
42162,2024,7,7,0,0,100,205807,1914,109
42163,2024,9,9,0,0,100,144367,1574,96
42165,2024,38,36,2,5,95,148229,1505,100
42166,2024,3,3,0,0,100,176333,2035,88
42167,2024,4,3,1,25,75,185375,2542,80
42168,2024,36,27,9,25,75,224366,2301,99
42169,2024,20,20,0,0,100,183532,2027,91
42170,2024,16,16,0,0,100,214894,1842,113
42171,2024,2,2,0,0,100,118618,1638,72
42172,2024,8,7,1,12,88,235512,2144,118
42173,2024,4,4,0,0,100,126790,1546,97
42174,2024,6,6,0,0,100,250708,2248,111
42175,2024,16,16,0,0,100,210587,1937,110
42176,2024,17,17,0,0,100,188410,1971,93
42177,2024,20,17,3,15,85,154352,1554,99
42178,2024,2,2,0,0,100,196500,1866,104
42179,2024,4,4,0,0,100,158621,1155,137
42180,2024,6,5,1,17,83,218325,1961,109
42181,2024,16,15,1,6,94,109172,1210,86
42182,2024,40,40,0,0,100,193825,1900,102
42183,2024,54,19,35,65,35,97647,1188,76
42184,2024,160,84,76,48,52,160030,1825,83
42185,2024,2,2,0,0,100,191600,2259,80
42186,2024,105,54,51,49,51,167034,1890,87
42187,2024,630,155,475,75,25,111626,1458,75
42188,2024,1,1,0,0,100,230000,2000,115
42189,2024,93,61,32,34,66,189697,2205,86
42191,2024,13,11,2,15,85,211858,2360,91
42192,2024,6,6,0,0,100,117333,1506,73
42193,2024,10,9,1,10,90,224798,2084,111
42194,2024,1,1,0,0,100,32000,421,76
42195,2024,16,13,3,19,81,101996,1183,88
42197,2024,13,11,2,15,85,190656,2057,93
42198,2024,5,4,1,20,80,111701,1728,64
42199,2024,21,21,0,0,100,140713,1433,95
42200,2024,21,21,0,0,100,241095,2317,105
42201,2024,7,7,0,0,100,251736,2727,96
42202,2024,8,8,0,0,100,174264,1949,96
42203,2024,7,7,0,0,100,109720,1454,87
42204,2024,14,9,5,36,64,132614,1438,91
42205,2024,9,9,0,0,100,139550,1863,99
42206,2024,21,19,2,10,90,399774,3298,122
42207,2024,294,113,181,62,38,151595,1714,88
42208,2024,15,14,1,7,93,300643,2119,140
42209,2024,7,7,0,0,100,132739,1166,104
42210,2024,4,3,1,25,75,168750,2252,70
42211,2024,16,13,3,19,81,258783,2635,100
42212,2024,15,14,1,7,93,225430,1868,116
42213,2024,2,2,0,0,100,65250,1064,58
42214,2024,10,10,0,0,100,214163,2054,105
42215,2024,12,10,2,17,83,109696,1187,92
42216,2024,5,5,0,0,100,198734,2880,72
42217,2024,5,5,0,0,100,73200,729,94
42218,2024,2497,239,2258,90,10,98093,1379,70
42219,2024,6,6,0,0,100,168593,1299,127
42220,2024,2,2,0,0,100,75850,725,96
42221,2024,5,5,0,0,100,218400,2161,102
42222,2024,47,34,13,28,72,295115,2770,106
42223,2024,61,35,26,43,57,231610,2322,98
42224,2024,28,14,14,50,50,176263,2106,77
42225,2024,27,23,4,15,85,265543,2707,98
42226,2024,2,2,0,0,100,198350,2410,90
42227,2024,2,1,1,50,50,75500,771,120
42228,2024,9,9,0,0,100,263915,2613,113
42229,2024,2,2,0,0,100,186550,1489,125
42230,2024,16,15,1,6,94,86613,1189,78
42231,2024,10,10,0,0,100,133325,1146,110
42232,2024,9,9,0,0,100,142611,1363,104
42233,2024,3,2,1,33,67,180500,1153,143
42234,2024,26,22,4,15,85,253746,2372,110
42235,2024,4,4,0,0,100,146872,1000,145
42236,2024,3,3,0,0,100,155133,1471,122
42237,2024,46,27,19,41,59,194810,2261,84
42238,2024,3,3,0,0,100,166807,1835,95
42239,2024,14,14,0,0,100,170124,1623,100
42240,2024,8,7,1,12,88,151412,1403,110
42241,2024,3,3,0,0,100,97667,1147,87
42242,2024,17,16,1,6,94,247547,2475,102
42243,2024,1,1,0,0,100,124700,2078,60
42245,2024,8,8,0,0,100,101725,1251,80
42246,2024,11,11,0,0,100,114364,1225,104
42247,2024,3,3,0,0,100,166667,1755,93
42248,2024,6,6,0,0,100,118167,956,120
42249,2024,17,16,1,6,94,145324,1649,92
42251,2024,6,6,0,0,100,327517,2634,137
42252,2024,1,1,0,0,100,170500,1705,100
42253,2024,6,6,0,0,100,193350,2214,92
42254,2024,9,9,0,0,100,178229,1415,124
42255,2024,4,4,0,0,100,83750,1102,73
42256,2024,47,43,4,9,91,204313,2375,83
42257,2024,7,7,0,0,100,92714,1080,87
42259,2024,25,22,3,12,88,234828,2526,95
42260,2024,11,11,0,0,100,109003,1399,81
42261,2024,8,8,0,0,100,168669,1540,109
42262,2024,17,15,2,12,88,158071,1713,89
42264,2024,6,6,0,0,100,249117,2305,107
42265,2024,7,6,1,14,86,234386,2110,106
42266,2024,4,4,0,0,100,179125,1658,108
42267,2024,13,13,0,0,100,153049,1456,105
42268,2024,4,4,0,0,100,163302,1640,93
42270,2024,11,8,3,27,73,178044,1916,90
42271,2024,39,26,13,33,67,201932,2138,95
42272,2024,24,18,6,25,75,178834,2184,87
42273,2024,2,2,0,0,100,170750,1510,115
42274,2024,2,2,0,0,100,184782,1469,128
42275,2024,82,24,58,71,29,220339,2503,89
42276,2024,8,8,0,0,100,75420,980,82
42277,2024,4,4,0,0,100,172125,1916,94
42278,2024,2,2,0,0,100,145087,1460,80
42279,2024,132,100,32,24,76,254988,2649,95
42280,2024,4,3,1,25,75,133000,1847,70
42281,2024,3,3,0,0,100,35133,575,72
42282,2024,3,3,0,0,100,138433,1422,133
42283,2024,7,7,0,0,100,213996,2178,101
42284,2024,12,12,0,0,100,209000,2026,105
42285,2024,55,48,7,13,87,194183,2048,98
42286,2024,4,4,0,0,100,183875,1838,101
42287,2024,13,13,0,0,100,174146,1795,96
42288,2024,3,3,0,0,100,174500,1489,108
42289,2024,15,13,2,13,87,213784,1765,125
42290,2024,6,6,0,0,100,194267,2305,91
42293,2024,8,7,1,12,88,181838,1604,114
42294,2024,8,8,0,0,100,311571,2121,136
42295,2024,3,3,0,0,100,94683,1124,89
42296,2024,2,2,0,0,100,154375,1318,120
42297,2024,3,3,0,0,100,156667,1738,90
42298,2024,3,3,0,0,100,130373,1788,84
42299,2024,36,27,9,25,75,208152,2319,92
42300,2024,4,4,0,0,100,137175,1250,110
42301,2024,5,5,0,0,100,153720,1197,127
42302,2024,69,50,19,28,72,247353,2755,90
42303,2024,7,7,0,0,100,107286,1413,84
42304,2024,61,54,7,11,89,186744,2053,92
42305,2024,74,39,35,47,53,207388,2473,85
42306,2024,2,1,1,50,50,146500,2112,60
42307,2024,9,9,0,0,100,335420,3018,111
42308,2024,2,0,2,100,0,143400,1486,94
42310,2024,3,3,0,0,100,158000,1551,110
42311,2024,9,9,0,0,100,381726,2886,132
42312,2024,8,8,0,0,100,218762,2018,111
42313,2024,4,4,0,0,100,213838,2053,105
42314,2024,3,3,0,0,100,96333,766,125
42315,2024,6,6,0,0,100,268620,2432,109
42316,2024,105,66,39,37,63,151152,1896,80
42317,2024,2,2,0,0,100,110000,1121,96
42318,2024,13,12,1,8,92,149700,1725,94
42319,2024,5,5,0,0,100,164650,1934,91
42320,2024,5,3,2,40,60,149680,1836,80
42321,2024,1,1,0,0,100,32000,427,75
42322,2024,12,12,0,0,100,104707,1210,90
42323,2024,90,56,34,38,62,235145,2542,91
42324,2024,16,16,0,0,100,286979,2724,110
42325,2024,4,4,0,0,100,174762,1852,94
42326,2024,8,8,0,0,100,179155,1771,92
42327,2024,7,7,0,0,100,309507,2995,101
42328,2024,5,5,0,0,100,164470,1880,94
42329,2024,3,3,0,0,100,181767,1853,99
42330,2024,105,26,79,75,25,149047,1647,87
42331,2024,11,10,1,9,91,171032,1787,91
42332,2024,49,39,10,20,80,186609,1901,95
42333,2024,2,2,0,0,100,119071,1320,91
42334,2024,8,8,0,0,100,144940,1716,80
42335,2024,5,4,1,20,80,235614,2378,99
42336,2024,6,6,0,0,100,131308,1286,107
42337,2024,3,3,0,0,100,94000,1235,84
42338,2024,20,19,1,5,95,175649,1851,94
42339,2024,1,1,0,0,100,90000,968,93
43001,2024,2,2,0,0,100,63530,638,100
43002,2024,6,4,2,33,67,196960,2470,80
43003,2024,7,7,0,0,100,96686,1078,92
43005,2024,6,6,0,0,100,86367,1425,76
43006,2024,2,2,0,0,100,110000,1310,101
43007,2024,11,11,0,0,100,176315,1971,91
43008,2024,2,2,0,0,100,130500,930,158
43009,2024,2,2,0,0,100,53500,937,60
43010,2024,6,6,0,0,100,191032,1843,102
43011,2024,2,2,0,0,100,96900,892,106
43012,2024,52,35,17,33,67,178111,1954,88
43013,2024,3,3,0,0,100,73567,772,95
43016,2024,11,10,1,9,91,90944,1077,89
43017,2024,2,2,0,0,100,103000,1442,66
43018,2024,12,9,3,25,75,161200,1993,104
43019,2024,1,1,0,0,100,165000,1500,110
43020,2024,32,27,5,16,84,185288,1950,98
43021,2024,13,12,1,8,92,163845,1719,106
43022,2024,3,3,0,0,100,241100,1816,134
43023,2024,1,1,0,0,100,50000,847,59
43024,2024,9,9,0,0,100,152900,1619,95
43025,2024,31,30,1,3,97,148918,1797,75
43026,2024,10,10,0,0,100,128675,1338,91
43027,2024,2,2,0,0,100,141655,1348,104
43028,2024,2,1,1,50,50,76625,907,82
43029,2024,2,2,0,0,100,101250,811,114
43030,2024,4,4,0,0,100,242650,2324,103
43031,2024,4,4,0,0,100,115775,1416,96
43032,2024,14,14,0,0,100,255457,2826,104
43033,2024,11,11,0,0,100,111486,1526,78
43034,2024,4,4,0,0,100,93075,1677,66
43035,2024,1,1,0,0,100,120000,1043,115
43036,2024,1,1,0,0,100,172000,1398,123
43037,2024,4,4,0,0,100,98925,1339,84
43038,2024,6,5,1,17,83,127333,1591,73
43039,2024,7,7,0,0,100,175259,1913,110
43040,2024,69,52,17,25,75,129388,1477,87
43041,2024,48,20,28,58,42,132714,1614,81
43042,2024,6,6,0,0,100,119467,1756,70
43043,2024,7,7,0,0,100,158918,1558,104
43044,2024,1,1,0,0,100,15000,395,38
43045,2024,5,5,0,0,100,179600,1604,110
43046,2024,23,14,9,39,61,179304,2136,91
43047,2024,2,2,0,0,100,119000,1152,108
43048,2024,11,10,1,9,91,81686,1293,75
43049,2024,14,14,0,0,100,102595,1407,73
43051,2024,52,32,20,38,62,163430,1696,97
43052,2024,6,6,0,0,100,63750,552,114
43053,2024,4,4,0,0,100,119668,1689,70
43054,2024,1,1,0,0,100,55000,917,60
43055,2024,3,3,0,0,100,123247,1486,80
43056,2024,4,4,0,0,100,62525,863,77
43057,2024,2,2,0,0,100,73500,712,85
43058,2024,5,5,0,0,100,292400,2717,108
43059,2024,1,1,0,0,100,90000,1084,83
43061,2024,7,7,0,0,100,201771,1810,116
43062,2024,6,6,0,0,100,217750,1990,110
43063,2024,1,1,0,0,100,95000,880,108
43064,2024,1,1,0,0,100,380000,2000,190
43066,2024,2,2,0,0,100,150895,2015,75
43067,2024,3,3,0,0,100,84333,831,94
43068,2024,1,1,0,0,100,27500,458,60
43069,2024,6,6,0,0,100,157783,1855,76
43070,2024,3,3,0,0,100,110483,1493,73
43071,2024,7,7,0,0,100,86243,1319,71
43072,2024,1,1,0,0,100,210000,1927,109
43073,2024,4,4,0,0,100,117100,1159,101
43074,2024,6,6,0,0,100,174850,1743,99
43076,2024,2,2,0,0,100,88350,922,98
43077,2024,7,7,0,0,100,86700,1073,83
43078,2024,18,17,1,6,94,187347,2522,86
43079,2024,3,3,0,0,100,156000,1668,89
43080,2024,28,25,3,11,89,124759,1264,100
43082,2024,2,2,0,0,100,93000,708,119
43083,2024,1,1,0,0,100,30000,375,80
43084,2024,13,12,1,8,92,175621,1863,92
43086,2024,1,1,0,0,100,72580,1117,65
43087,2024,10,8,2,20,80,197341,1952,96
43088,2024,2,2,0,0,100,160050,1658,96
43089,2024,33,24,9,27,73,153744,1578,93
43090,2024,1,1,0,0,100,44000,710,62
43091,2024,4,4,0,0,100,208650,2898,89
43092,2024,8,8,0,0,100,104675,1183,87
43093,2024,7,7,0,0,100,93029,1204,82
43096,2024,9,9,0,0,100,135033,1259,110
43097,2024,2,1,1,50,50,150900,1153,132
43098,2024,2,2,0,0,100,84595,950,90
43099,2024,9,9,0,0,100,104990,1274,82
43100,2024,6,6,0,0,100,196033,1515,126
43101,2024,4,4,0,0,100,91404,780,117
43102,2024,6,6,0,0,100,224996,1900,129
43106,2024,1,1,0,0,100,44000,917,48
43107,2024,2,2,0,0,100,103775,890,111
43108,2024,8,7,1,12,88,107688,1209,89
43109,2024,2,2,0,0,100,84750,1498,60
43110,2024,10,10,0,0,100,139954,1302,108
43111,2024,11,11,0,0,100,126925,1452,89
43112,2024,47,43,4,9,91,115741,1361,88
43113,2024,10,10,0,0,100,173585,2040,93
43114,2024,23,22,1,4,96,120202,1392,91
43115,2024,9,9,0,0,100,107194,1736,70
43117,2024,4,4,0,0,100,214400,1781,108
43118,2024,2,2,0,0,100,51085,636,82
43119,2024,11,10,1,9,91,115591,1392,80
43120,2024,17,17,0,0,100,117909,1210,99
43121,2024,1,1,0,0,100,137000,2978,46
43122,2024,4,4,0,0,100,175608,1770,98
43123,2024,1,1,0,0,100,120000,1277,94
43124,2024,8,8,0,0,100,117369,1302,94
43125,2024,1,1,0,0,100,31000,397,78
43126,2024,8,8,0,0,100,163274,1588,101
43127,2024,7,7,0,0,100,168571,2265,72
43128,2024,1,1,0,0,100,80000,1039,77
43129,2024,3,3,0,0,100,217950,1640,132
43130,2024,17,15,2,12,88,151277,1578,97
43131,2024,2,2,0,0,100,124950,797,142
43132,2024,18,18,0,0,100,102769,1327,81
43135,2024,20,18,2,10,90,115214,1810,77
43136,2024,4,4,0,0,100,74300,729,103
43137,2024,70,50,20,29,71,172795,2034,85
43138,2024,4,4,0,0,100,185468,1454,120
43140,2024,2,2,0,0,100,327750,2174,152
43141,2024,11,9,2,18,82,122200,1515,81
43142,2024,1,1,0,0,100,109800,1307,84
43143,2024,2,2,0,0,100,72500,1868,56
43147,2024,6,6,0,0,100,128743,1324,92
43148,2024,17,16,1,6,94,99173,1180,91
43149,2024,1,1,0,0,100,30000,333,90
43150,2024,6,6,0,0,100,218767,2426,107
43151,2024,2,2,0,0,100,89500,1088,68
43152,2024,19,19,0,0,100,206286,1861,110
43153,2024,9,8,1,11,89,173951,1843,106
43154,2024,7,4,3,43,57,98647,1585,70
43156,2024,3,3,0,0,100,59040,1246,62
43157,2024,327,56,271,83,17,126215,1633,77
43158,2024,5,5,0,0,100,181150,1603,107
43159,2024,5,5,0,0,100,173320,1836,90
43160,2024,2,2,0,0,100,92500,910,104
43162,2024,28,27,1,4,96,121144,1462,82
43163,2024,17,16,1,6,94,138988,1601,83
43164,2024,7,7,0,0,100,109500,1370,86
43165,2024,13,13,0,0,100,145874,1540,98
43166,2024,2,2,0,0,100,49000,543,88
43167,2024,1,1,0,0,100,50000,410,122
43168,2024,1,1,0,0,100,115500,1805,64
43169,2024,2,2,0,0,100,132600,1046,116
43170,2024,4,4,0,0,100,148169,1406,111
43172,2024,3,3,0,0,100,146667,1351,117
43174,2024,6,6,0,0,100,136600,1950,74
43175,2024,1,1,0,0,100,96000,4800,20
43177,2024,20,13,7,35,65,156610,1536,102
43178,2024,2,2,0,0,100,59950,682,87
43180,2024,2,2,0,0,100,61000,828,72
43181,2024,5,5,0,0,100,124166,1311,94
43182,2024,3,3,0,0,100,114167,1315,89
43183,2024,2,2,0,0,100,109715,996,109
43184,2024,17,15,2,12,88,234001,2475,97
43185,2024,45,44,1,2,98,119410,1458,85
43186,2024,12,12,0,0,100,148365,1531,98
43187,2024,5,5,0,0,100,169480,1232,155
43188,2024,4,4,0,0,100,171325,1955,95
43189,2024,5,5,0,0,100,92800,1021,95
43190,2024,22,22,0,0,100,231660,2072,113
43192,2024,5,5,0,0,100,113600,1384,90
43193,2024,1,1,0,0,100,153000,1821,84
43194,2024,5,5,0,0,100,224750,2207,103
43195,2024,6,6,0,0,100,88000,1200,75
43196,2024,2,2,0,0,100,148675,1588,106
43197,2024,3,3,0,0,100,114158,1288,87
43198,2024,2,2,0,0,100,143500,2180,72
43199,2024,14,14,0,0,100,120490,1453,98
43200,2024,23,18,5,22,78,159517,1744,92
43201,2024,2,2,0,0,100,115500,1645,71
43202,2024,3,3,0,0,100,172667,1073,137
43203,2024,3,3,0,0,100,135187,1614,85
43204,2024,4,4,0,0,100,139019,1090,138
43205,2024,37,25,12,32,68,175431,1920,92
43206,2024,6,6,0,0,100,165780,1456,122
43210,2024,6,6,0,0,100,87775,1223,72
43211,2024,23,20,3,13,87,175537,1655,107
43212,2024,11,10,1,9,91,121777,1477,89
43213,2024,18,15,3,17,83,185983,2197,84
43214,2024,1,1,0,0,100,131000,2015,65
43215,2024,4,4,0,0,100,96500,1468,74
43216,2024,22,22,0,0,100,199883,1872,108
43217,2024,8,8,0,0,100,116875,1488,81
43218,2024,9,9,0,0,100,252820,1968,124
43219,2024,1,1,0,0,100,133000,3694,36
43220,2024,3,3,0,0,100,106333,844,127
43221,2024,5,5,0,0,100,151685,1769,88
43222,2024,3,3,0,0,100,60500,675,97
43223,2024,9,9,0,0,100,160991,1494,108
43224,2024,50,37,13,26,74,150021,1590,96
43227,2024,6,5,1,17,83,167683,1901,90
43229,2024,1,1,0,0,100,295350,2461,120
43230,2024,13,12,1,8,92,164905,1459,117
43231,2024,3,3,0,0,100,113217,1952,56
43232,2024,3,3,0,0,100,124963,939,127
43233,2024,8,8,0,0,100,207811,1778,124
43234,2024,15,14,1,7,93,116631,1444,87
43236,2024,17,6,11,65,35,125001,1431,84
43237,2024,4,4,0,0,100,120675,1153,111
43238,2024,8,8,0,0,100,91460,1185,75
43239,2024,6,6,0,0,100,78132,974,77
43240,2024,1,1,0,0,100,146000,2246,65
43241,2024,16,16,0,0,100,172622,1693,102
43242,2024,2,2,0,0,100,90825,768,120
43244,2024,38,31,7,18,82,156092,1696,91
43245,2024,4,4,0,0,100,121288,1462,94
43246,2024,10,10,0,0,100,113975,1380,83
43247,2024,1,1,0,0,100,80000,1778,45
43249,2024,7,7,0,0,100,90325,1116,73
43250,2024,2,2,0,0,100,67000,1092,60
43251,2024,50,17,33,66,34,135820,1746,76
43252,2024,1,1,0,0,100,217000,2411,90
43253,2024,4,4,0,0,100,72450,1354,72
43254,2024,2,2,0,0,100,156300,1607,103
43256,2024,2,2,0,0,100,186415,1937,98
43257,2024,1,1,0,0,100,311000,2073,150
43258,2024,18,17,1,6,94,145923,1453,98
43259,2024,5,5,0,0,100,141820,1263,116
43261,2024,4,4,0,0,100,136222,1497,107
43262,2024,21,18,3,14,86,141743,1481,91
43263,2024,1,1,0,0,100,58000,829,70
43264,2024,7,7,0,0,100,81380,1143,74
43265,2024,15,15,0,0,100,134332,1629,78
43267,2024,17,17,0,0,100,141687,1745,83
43268,2024,59,52,7,12,88,173683,1809,96
44001,2024,21,21,0,0,100,161229,1803,93
44002,2024,25,22,3,12,88,247876,2774,89
44003,2024,109,91,18,17,83,234464,2620,92
44005,2024,79,78,1,1,99,232084,2608,92
44006,2024,32,32,0,0,100,210809,2464,92
44007,2024,22,22,0,0,100,144439,1552,93
44009,2024,64,57,7,11,89,374498,3525,109
44010,2024,77,60,17,22,78,339315,5135,72
44012,2024,76,66,10,13,87,346372,4561,80
44013,2024,27,27,0,0,100,215011,2454,91
44014,2024,30,29,1,3,97,271879,2626,103
44015,2024,99,86,13,13,87,188513,2175,89
44016,2024,5,5,0,0,100,132600,1518,86
44018,2024,63,50,13,21,79,281995,3098,94
44019,2024,13,13,0,0,100,236238,3060,95
44020,2024,183,145,38,21,79,260247,3033,88
44021,2024,60,59,1,2,98,204977,2381,94
44022,2024,43,42,1,2,98,173600,1861,94
44023,2024,20,19,1,5,95,191814,2222,89
44024,2024,21,21,0,0,100,266073,2879,97
44025,2024,29,29,0,0,100,228797,2292,104
44026,2024,200,122,78,39,61,317972,3346,97
44027,2024,22,22,0,0,100,279535,2592,110
44028,2024,21,19,2,10,90,255750,2453,103
44029,2024,50,49,1,2,98,221757,2557,91
44030,2024,37,36,1,3,97,222917,2430,96
44031,2024,10,10,0,0,100,120530,1499,89
44032,2024,22,21,1,5,95,309043,2939,105
44033,2024,23,22,1,4,96,263040,2384,111
44035,2024,174,112,62,36,64,313987,3376,95
44036,2024,135,116,19,14,86,157470,1939,84
44037,2024,19,19,0,0,100,263175,2481,106
44038,2024,25,25,0,0,100,267455,2780,101
44039,2024,6,6,0,0,100,243521,2211,112
44041,2024,72,72,0,0,100,266459,2687,101
44043,2024,98,77,21,21,79,312289,3233,102
44044,2024,11,11,0,0,100,167405,1624,109
44045,2024,24,24,0,0,100,259085,2372,109
44046,2024,28,28,0,0,100,257422,2754,94
44047,2024,251,177,74,29,71,249933,3086,83
44048,2024,14,14,0,0,100,221670,2196,103
44049,2024,115,52,63,55,45,326105,4676,71
44050,2024,27,26,1,4,96,187538,2218,91
44051,2024,27,27,0,0,100,168267,1847,91
44052,2024,103,99,4,4,96,178434,2130,85
44053,2024,19,19,0,0,100,229768,2161,104
44054,2024,28,28,0,0,100,162188,1636,103
44055,2024,565,192,373,66,34,457125,6644,71
44056,2024,43,43,0,0,100,248953,2342,110
44057,2024,28,28,0,0,100,151107,1534,96
44058,2024,5,5,0,0,100,126500,1193,109
44061,2024,33,33,0,0,100,192012,2432,86
44062,2024,25,25,0,0,100,174591,2003,88
44063,2024,29,28,1,3,97,237700,2269,102
44064,2024,46,44,2,4,96,246714,2532,101
44065,2024,12,12,0,0,100,147715,1492,101
44066,2024,47,44,3,6,94,314257,3019,110
44067,2024,66,65,1,2,98,139545,1608,88
44068,2024,39,39,0,0,100,190402,2145,92
44069,2024,207,150,57,28,72,341303,3790,91
44070,2024,47,46,1,2,98,286223,2900,103
44071,2024,39,37,2,5,95,348726,3277,107
44072,2024,71,70,1,1,99,264845,2839,95
44073,2024,49,48,1,2,98,268960,2584,110
44074,2024,51,42,9,18,82,249666,3010,87
44075,2024,17,17,0,0,100,134941,1439,94
44076,2024,15,15,0,0,100,144085,1588,103
44077,2024,22,22,0,0,100,173969,2204,85
44078,2024,2,2,0,0,100,80500,1251,64
44079,2024,23,22,1,4,96,221556,2308,93
44080,2024,7,7,0,0,100,200532,2466,87
44081,2024,44,44,0,0,100,166888,1865,95
44082,2024,46,46,0,0,100,232641,2286,102
44083,2024,20,20,0,0,100,232490,2462,97
44084,2024,62,56,6,10,90,286895,2783,109
44085,2024,5,5,0,0,100,206000,1599,132
44086,2024,16,16,0,0,100,155718,1601,103
44087,2024,100,87,13,13,87,193378,2274,88
44088,2024,26,26,0,0,100,223215,2373,96
44089,2024,42,42,0,0,100,250553,2486,100
44090,2024,12,12,0,0,100,221062,2300,98
44091,2024,35,35,0,0,100,146997,1951,79
44092,2024,11,11,0,0,100,116182,1518,73
44094,2024,32,22,10,31,69,247443,2836,88
44095,2024,19,19,0,0,100,161139,1653,97
44096,2024,29,29,0,0,100,231759,2452,96
44097,2024,54,47,7,13,87,421214,4034,107
44098,2024,45,42,3,7,93,255269,2757,111
44099,2024,20,19,1,5,95,131981,1388,97
44100,2024,17,17,0,0,100,244567,2387,105
44101,2024,54,43,11,20,80,221858,2990,76
44102,2024,24,24,0,0,100,229250,2594,94
44103,2024,56,47,9,16,84,187967,2331,83
44104,2024,6,6,0,0,100,167583,1950,86
44105,2024,2,2,0,0,100,207500,1794,123
44106,2024,35,31,4,11,89,261974,4071,67
44107,2024,13,13,0,0,100,194474,1973,103
44108,2024,26,24,2,8,92,219726,2664,87
44109,2024,4266,871,3395,80,20,242313,3709,65
44110,2024,96,77,19,20,80,243662,2675,91
44111,2024,16,16,0,0,100,217276,2600,86
44112,2024,11,11,0,0,100,149415,1232,122
44113,2024,48,45,3,6,94,206477,2208,98
44114,2024,343,202,141,41,59,298017,3227,92
44115,2024,42,41,1,2,98,241555,2484,103
44116,2024,46,29,17,37,63,168049,2187,80
44117,2024,44,39,5,11,89,220933,2383,96
44118,2024,16,16,0,0,100,189363,1892,101
44119,2024,14,14,0,0,100,173062,1982,99
44120,2024,57,55,2,4,96,225306,2616,87
44121,2024,4,4,0,0,100,117375,1191,99
44122,2024,26,26,0,0,100,255604,2625,102
44123,2024,13,13,0,0,100,121754,1241,101
44124,2024,6,6,0,0,100,154583,1878,79
44125,2024,57,53,4,7,93,376933,4622,86
44126,2024,86,84,2,2,98,301027,4115,79
44127,2024,25,25,0,0,100,223480,2300,102
44128,2024,61,61,0,0,100,170091,1786,96
44129,2024,130,101,29,22,78,210576,2389,91
44130,2024,50,49,1,2,98,279470,2892,99
44131,2024,299,213,86,29,71,410624,5067,82
44132,2024,289,124,165,57,43,411751,6194,71
44133,2024,34,31,3,9,91,249608,2739,91
44134,2024,6,6,0,0,100,166167,1702,109
44135,2024,137,82,55,40,60,434520,5555,79
44136,2024,40,33,7,18,82,421611,5811,75
44137,2024,28,28,0,0,100,260273,2523,104
44138,2024,10,10,0,0,100,191300,2092,93
44139,2024,14,14,0,0,100,190857,2267,92
44140,2024,18,18,0,0,100,180819,1898,98
44141,2024,14,14,0,0,100,222548,2116,106
44142,2024,12,11,1,8,92,255254,2888,114
44143,2024,574,277,297,52,48,230781,3079,75
44144,2024,25,24,1,4,96,174740,1647,114
44145,2024,14,14,0,0,100,292346,2769,108
44146,2024,23,23,0,0,100,111814,1237,91
44148,2024,8,8,0,0,100,109262,991,111
44149,2024,39,37,2,5,95,199553,2123,98
44150,2024,33,33,0,0,100,291853,2710,110
44151,2024,55,50,5,9,91,352736,3283,109
44152,2024,35,35,0,0,100,225012,2447,91
44153,2024,14,14,0,0,100,151546,1373,110
44154,2024,288,198,90,31,69,291893,4023,75
44155,2024,24,24,0,0,100,227027,2379,99
44156,2024,29,29,0,0,100,183292,2018,93
44157,2024,18,18,0,0,100,159061,2173,75
44158,2024,60,55,5,8,92,296400,2956,100
44159,2024,9,8,1,11,89,237378,2639,90
44161,2024,34,34,0,0,100,201562,1871,108
44162,2024,641,195,446,70,30,205104,2768,74
44163,2024,36,34,2,6,94,203225,1972,104
44164,2024,23,23,0,0,100,227151,2439,97
44165,2024,18,18,0,0,100,229860,2340,97
44166,2024,59,52,7,12,88,275229,2939,94
44168,2024,52,52,0,0,100,161413,2136,81
44169,2024,64,61,3,5,95,300785,3072,102
44170,2024,8,8,0,0,100,121625,1396,88
44171,2024,17,17,0,0,100,308132,2689,114
44172,2024,156,106,50,32,68,281688,3256,89
44173,2024,26,26,0,0,100,226412,2457,95
44174,2024,31,31,0,0,100,214228,2324,93
44175,2024,40,40,0,0,100,326957,3184,104
44176,2024,22,22,0,0,100,237207,2156,109
44178,2024,15,15,0,0,100,253557,2515,101
44179,2024,36,36,0,0,100,247966,2428,104
44180,2024,20,19,1,5,95,122170,1654,85
44182,2024,129,103,26,20,80,286838,4306,71
44183,2024,25,25,0,0,100,266744,2900,93
44184,2024,965,436,529,55,45,231781,3092,75
44185,2024,39,33,6,15,85,158244,1978,80
44186,2024,63,61,2,3,97,270752,2849,99
44187,2024,37,34,3,8,92,267055,3044,89
44188,2024,74,71,3,4,96,253178,2934,95
44189,2024,26,25,1,4,96,206715,2189,97
44190,2024,360,199,161,45,55,261106,3353,79
44192,2024,33,33,0,0,100,220822,2690,86
44193,2024,14,14,0,0,100,145605,1406,111
44194,2024,81,53,28,35,65,362617,3469,107
44195,2024,86,76,10,12,88,277730,2740,103
44196,2024,14,14,0,0,100,148660,1708,91
44197,2024,23,23,0,0,100,131139,1267,103
44198,2024,105,71,34,32,68,257549,3126,83
44199,2024,28,28,0,0,100,124133,1349,90
44200,2024,9,9,0,0,100,109111,1156,91
44201,2024,40,39,1,2,98,412007,3681,112
44202,2024,18,18,0,0,100,204389,2126,103
44203,2024,14,14,0,0,100,248819,2732,98
44204,2024,90,67,23,26,74,290745,3308,90
44205,2024,19,19,0,0,100,218395,2389,100
44206,2024,30,30,0,0,100,161474,1873,88
44207,2024,10,10,0,0,100,175538,2010,91
44208,2024,22,22,0,0,100,144967,1341,106
44209,2024,75,68,7,9,91,295053,2866,105
44210,2024,91,74,17,19,81,187690,2475,79
44211,2024,124,90,34,27,73,300311,4462,72
44212,2024,100,98,2,2,98,228673,2552,93
44213,2024,64,64,0,0,100,181960,1976,98
44214,2024,24,24,0,0,100,169606,1797,95
44215,2024,310,253,57,18,82,343024,3619,94
44216,2024,45,45,0,0,100,190373,2114,92
44217,2024,56,54,2,4,96,316747,2822,112
44218,2024,7,7,0,0,100,145629,1485,91
44220,2024,15,15,0,0,100,243967,2598,92
44221,2024,12,12,0,0,100,266663,2451,118
44222,2024,14,14,0,0,100,181821,2007,94
44223,2024,29,27,2,7,93,230634,2485,92
44224,2024,9,9,0,0,100,197810,2200,91
45001,2024,4,4,0,0,100,89000,1081,91
45002,2024,5,5,0,0,100,104800,1015,103
45004,2024,145,128,17,12,88,160605,1893,87
45005,2024,3,3,0,0,100,157567,1704,94
45006,2024,19,11,8,42,58,285196,2816,103
45008,2024,23,21,2,9,91,149085,1799,86
45009,2024,9,9,0,0,100,172189,1754,105
45010,2024,9,9,0,0,100,150961,1315,117
45011,2024,2,2,0,0,100,86000,632,140
45012,2024,1,1,0,0,100,206385,1332,155
45013,2024,1,1,0,0,100,290000,2437,119
45014,2024,4,4,0,0,100,152750,1512,98
45015,2024,9,9,0,0,100,169247,1948,93
45016,2024,16,16,0,0,100,112229,1217,93
45017,2024,7,7,0,0,100,110160,1336,92
45018,2024,12,12,0,0,100,113569,1152,114
45019,2024,5,5,0,0,100,201410,2005,101
45020,2024,6,6,0,0,100,202245,2318,91
45021,2024,4,4,0,0,100,142820,1602,98
45022,2024,6,6,0,0,100,158541,1327,115
45023,2024,3,3,0,0,100,120000,1117,102
45024,2024,21,21,0,0,100,164778,1802,92
45025,2024,15,15,0,0,100,158033,1560,105
45026,2024,10,10,0,0,100,157400,1742,107
45027,2024,4,4,0,0,100,94382,1324,69
45028,2024,99,66,33,33,67,161699,1953,87
45029,2024,24,24,0,0,100,101757,1431,73
45030,2024,11,11,0,0,100,121377,1723,80
45031,2024,19,17,2,11,89,109432,1358,82
45032,2024,4,4,0,0,100,113000,1122,95
45033,2024,4,4,0,0,100,124875,2144,71
45034,2024,28,28,0,0,100,239844,2150,111
45035,2024,15,14,1,7,93,159255,1723,95
45036,2024,6,6,0,0,100,119370,1547,84
45037,2024,6,6,0,0,100,152000,1442,115
45038,2024,1,1,0,0,100,110000,733,150
45039,2024,5,5,0,0,100,116700,1219,96
45040,2024,27,24,3,11,89,112420,1222,94
45041,2024,3,3,0,0,100,131367,1371,94
45042,2024,27,26,1,4,96,160186,1924,86
45043,2024,8,7,1,12,88,209603,1952,108
45044,2024,2,2,0,0,100,158500,1904,84
45045,2024,6,6,0,0,100,162658,1794,93
45046,2024,4,4,0,0,100,162516,1940,80
45047,2024,4,4,0,0,100,120000,1462,72
45049,2024,19,19,0,0,100,163132,1788,89
45050,2024,18,18,0,0,100,142342,1311,108
45051,2024,17,17,0,0,100,163655,1727,102
45052,2024,1,1,0,0,100,127000,1198,106
45053,2024,42,39,3,7,93,156583,1635,97
45054,2024,7,7,0,0,100,170652,1773,102
45055,2024,4,3,1,25,75,252825,1695,134
45056,2024,1,1,0,0,100,160000,1702,94
45058,2024,1,1,0,0,100,115000,1917,60
45059,2024,1,1,0,0,100,235000,2156,109
45060,2024,7,7,0,0,100,100786,1081,92
45061,2024,19,19,0,0,100,131489,1447,99
45062,2024,14,14,0,0,100,191656,2125,93
45063,2024,13,13,0,0,100,120231,1621,86
45064,2024,4,4,0,0,100,109500,1046,100
45065,2024,4,4,0,0,100,160500,1760,100
45066,2024,9,9,0,0,100,153356,1566,98
45067,2024,43,42,1,2,98,263400,2860,104
45068,2024,99,83,16,16,84,118328,1510,80
45069,2024,12,12,0,0,100,145550,1583,98
45072,2024,10,9,1,10,90,189330,1738,115
45073,2024,2,2,0,0,100,91250,1156,83
45074,2024,3,3,0,0,100,121000,1663,73
45075,2024,106,69,37,35,65,205590,2400,85
45076,2024,2,2,0,0,100,60750,868,65
45077,2024,7,7,0,0,100,121500,1191,102
45079,2024,4,4,0,0,100,134250,1222,105
45080,2024,3,3,0,0,100,175567,1291,136
45081,2024,11,11,0,0,100,147782,1150,139
45082,2024,113,86,27,24,76,183637,1993,94
45083,2024,25,22,3,12,88,123349,1418,98
45084,2024,5,5,0,0,100,226500,2658,95
45085,2024,23,21,2,9,91,118666,1142,101
45086,2024,2,2,0,0,100,160185,1264,121
45087,2024,29,28,1,3,97,113711,1357,85
45088,2024,4,4,0,0,100,104500,1220,105
45089,2024,91,80,11,12,88,220250,2162,107
45091,2024,5,5,0,0,100,317649,2088,145
45092,2024,11,10,1,9,91,229045,2803,113
45093,2024,19,19,0,0,100,177364,1937,93
45094,2024,5,5,0,0,100,227924,2260,106
45095,2024,18,17,1,6,94,152460,1618,96
45096,2024,6,6,0,0,100,187600,1834,99
45097,2024,14,14,0,0,100,163433,1398,117
45098,2024,30,30,0,0,100,212412,2120,103
45099,2024,4,4,0,0,100,165875,1681,100
45100,2024,7,7,0,0,100,460341,2935,159
45101,2024,3,3,0,0,100,177667,1619,110
45102,2024,3,3,0,0,100,257000,1906,143
45103,2024,21,21,0,0,100,100991,1439,70
45104,2024,38,38,0,0,100,171198,1828,93
45107,2024,6,6,0,0,100,101771,1138,89
45108,2024,34,34,0,0,100,121179,1389,90
45109,2024,6,6,0,0,100,183078,1390,135
45111,2024,7,7,0,0,100,207570,2181,107
45112,2024,2,2,0,0,100,223125,1806,123
45114,2024,5,5,0,0,100,74700,1435,62
45115,2024,57,55,2,4,96,148612,1561,99
45116,2024,7,7,0,0,100,205936,1539,142
45118,2024,1,1,0,0,100,111400,1826,61
45119,2024,17,17,0,0,100,176018,1800,103
45120,2024,1,1,0,0,100,65500,409,160
45121,2024,11,11,0,0,100,102763,1359,75
45122,2024,7,7,0,0,100,109829,1364,80
45123,2024,25,25,0,0,100,220910,2120,105
45124,2024,2,2,0,0,100,127142,1288,94
45125,2024,1,1,0,0,100,27900,620,45
45126,2024,29,29,0,0,100,205829,2123,102
45127,2024,47,47,0,0,100,173055,1910,93
45129,2024,20,20,0,0,100,119027,1578,79
45130,2024,11,11,0,0,100,209852,2086,102
45131,2024,5,5,0,0,100,96960,1241,82
45132,2024,4,4,0,0,100,111525,1325,80
45133,2024,4,4,0,0,100,192325,1496,130
45134,2024,18,18,0,0,100,180795,1658,110
45135,2024,1,1,0,0,100,138981,643,216
45136,2024,7,7,0,0,100,125479,1673,73
45137,2024,6,6,0,0,100,143120,1658,86
45139,2024,3,3,0,0,100,141667,1443,103
45141,2024,7,7,0,0,100,140436,1374,103
45142,2024,39,35,4,10,90,178001,1881,97
45144,2024,15,15,0,0,100,196396,1814,121
45145,2024,44,44,0,0,100,153751,1895,85
45146,2024,73,68,5,7,93,197614,2102,95
45147,2024,228,136,92,40,60,164657,2088,80
45148,2024,15,15,0,0,100,134393,1347,102
45149,2024,5,5,0,0,100,114120,1348,77
45150,2024,4,4,0,0,100,116100,1144,95
45151,2024,3,3,0,0,100,107500,1253,87
45152,2024,2,2,0,0,100,156500,2058,76
45153,2024,9,9,0,0,100,223281,2324,112
45154,2024,10,10,0,0,100,256316,2203,116
45155,2024,137,95,42,31,69,105259,1272,85
45156,2024,2,2,0,0,100,206000,1998,98
45157,2024,2,2,0,0,100,98500,1407,70
45158,2024,4,4,0,0,100,166295,1332,139
45159,2024,3,3,0,0,100,250667,1914,123
45160,2024,2,2,0,0,100,122500,1126,113
45161,2024,10,10,0,0,100,166800,1843,91
45162,2024,2,2,0,0,100,148250,1792,84
45164,2024,7,7,0,0,100,156500,1769,100
45165,2024,2,2,0,0,100,109000,1060,116
45166,2024,4,4,0,0,100,210750,2080,133
45167,2024,13,12,1,8,92,202155,2043,96
45168,2024,5,5,0,0,100,152964,1839,83
45169,2024,99,87,12,12,88,226105,2308,100
45171,2024,9,9,0,0,100,121846,1318,98
45173,2024,47,40,7,15,85,180048,1923,96
45174,2024,3,3,0,0,100,199233,1804,112
45175,2024,11,11,0,0,100,280000,2677,109
45176,2024,5,5,0,0,100,145970,1561,97
45177,2024,2,2,0,0,100,94500,1134,79
45178,2024,15,15,0,0,100,107147,1243,88
45179,2024,25,23,2,8,92,195420,1913,101
45180,2024,3,3,0,0,100,225820,1653,139
45181,2024,2,2,0,0,100,105000,2058,51
45182,2024,12,12,0,0,100,213070,1917,108
45183,2024,2,2,0,0,100,185500,1528,132
45184,2024,1,1,0,0,100,143300,2866,50
45185,2024,2,2,0,0,100,234600,1676,136
45186,2024,7,7,0,0,100,130771,1284,103
45187,2024,38,38,0,0,100,118026,1412,87
45188,2024,17,17,0,0,100,216315,1789,127
45189,2024,1,1,0,0,100,110000,2292,48
45191,2024,82,61,21,26,74,194952,2207,91
45193,2024,19,19,0,0,100,239124,2358,110
45194,2024,30,27,3,10,90,220461,2119,105
45195,2024,2,2,0,0,100,90000,1106,88
45196,2024,11,11,0,0,100,185691,2047,88
45197,2024,12,12,0,0,100,212948,2509,86
45198,2024,3,3,0,0,100,176333,1537,115
45199,2024,8,8,0,0,100,132475,1805,87
45200,2024,14,14,0,0,100,301134,2085,144
45201,2024,2,2,0,0,100,85500,1552,56
45202,2024,5,5,0,0,100,161456,1699,89
45203,2024,84,72,12,14,86,181980,1984,90
45204,2024,13,13,0,0,100,320192,2319,147
45205,2024,5,5,0,0,100,124700,1118,113
45206,2024,2,2,0,0,100,106000,1565,72
45207,2024,3,3,0,0,100,81997,774,116
45208,2024,187,74,113,60,40,103298,1554,68
45209,2024,5,5,0,0,100,179160,1294,141
45210,2024,13,13,0,0,100,120368,1357,93
45212,2024,17,17,0,0,100,147616,1586,99
45213,2024,5,5,0,0,100,122520,1578,90
45215,2024,1,1,0,0,100,140000,1167,120
45217,2024,5,5,0,0,100,169600,1449,121
45218,2024,2,2,0,0,100,158000,2106,94
45219,2024,1,1,0,0,100,75302,907,83
45220,2024,6,6,0,0,100,117500,1292,92
45222,2024,12,12,0,0,100,205671,1925,117
45223,2024,4,4,0,0,100,202612,1946,110
45224,2024,47,40,7,15,85,179348,1773,101
45225,2024,7,7,0,0,100,135986,1499,97
45226,2024,18,18,0,0,100,147133,1933,81
45227,2024,10,10,0,0,100,142488,1625,87
45228,2024,24,24,0,0,100,130538,1640,86
45229,2024,26,26,0,0,100,125412,1366,92
45230,2024,10,10,0,0,100,106533,1313,79
45231,2024,1,1,0,0,100,140000,903,155
45232,2024,273,138,135,49,51,221599,2785,82
45233,2024,5,5,0,0,100,167300,2098,81
45234,2024,1430,319,1111,78,22,175331,2628,68
45235,2024,26,22,4,15,85,263077,2550,111
45237,2024,4,4,0,0,100,132100,2336,61
45238,2024,10,10,0,0,100,124720,1385,86
45239,2024,6,6,0,0,100,127764,1669,78
45240,2024,9,9,0,0,100,170238,1497,122
45241,2024,6,6,0,0,100,239427,1990,123
45243,2024,3,3,0,0,100,102667,1176,82
45244,2024,26,26,0,0,100,143169,1536,92
45245,2024,17,17,0,0,100,120471,1370,92
45246,2024,3,3,0,0,100,168133,1988,91
45247,2024,43,43,0,0,100,143948,1615,90
45248,2024,43,42,1,2,98,165838,1583,111
45249,2024,8,8,0,0,100,211762,1865,122
45250,2024,2,2,0,0,100,213000,1809,119
45251,2024,4,4,0,0,100,85250,1053,80
45252,2024,62,36,26,42,58,152685,1799,86
45253,2024,11,11,0,0,100,174742,1978,93
45254,2024,36,36,0,0,100,160243,1613,96
45255,2024,2,2,0,0,100,122500,1592,90
45256,2024,4,4,0,0,100,163902,1706,99
45257,2024,4,4,0,0,100,155275,1193,136
45258,2024,32,29,3,9,91,149941,1763,88
45259,2024,19,19,0,0,100,140798,1357,112
45260,2024,2,2,0,0,100,101000,986,102
45261,2024,6,6,0,0,100,257333,2008,138
45263,2024,1,1,0,0,100,82000,1439,57
45265,2024,12,12,0,0,100,139656,1346,106
45266,2024,2,2,0,0,100,132500,1570,84
45268,2024,4,4,0,0,100,209475,1387,173
45269,2024,15,14,1,7,93,179833,1871,99
45270,2024,28,27,1,4,96,227887,2016,114
45271,2024,13,13,0,0,100,136173,1626,87
45272,2024,27,20,7,26,74,210438,2477,89
45273,2024,27,24,3,11,89,208932,2312,96
45274,2024,71,71,0,0,100,305153,2574,119
45275,2024,8,8,0,0,100,101125,1262,79
45276,2024,2,2,0,0,100,160300,1532,113
45277,2024,8,8,0,0,100,121681,1687,83
45278,2024,20,20,0,0,100,116908,1241,93
45279,2024,21,21,0,0,100,172658,1496,114
45280,2024,4,4,0,0,100,139000,1675,84
45281,2024,15,15,0,0,100,136853,1477,94
45282,2024,24,21,3,12,88,246450,2630,98
45283,2024,1,1,0,0,100,195000,1444,135
45284,2024,240,116,124,52,48,181855,2264,80
45285,2024,146,81,65,45,55,152034,1969,77
45286,2024,98,55,43,44,56,209422,2412,88
45288,2024,2,2,0,0,100,211300,3542,70
45289,2024,10,10,0,0,100,217681,2115,102
45290,2024,14,14,0,0,100,181093,1715,114
45291,2024,16,16,0,0,100,157666,1519,106
45292,2024,11,11,0,0,100,86636,1151,78
45293,2024,10,10,0,0,100,117680,1458,80
45294,2024,1,1,0,0,100,250500,1546,162
45296,2024,11,11,0,0,100,179719,1781,105
45297,2024,15,15,0,0,100,159141,1752,94
45298,2024,63,48,15,24,76,238617,2380,97
45299,2024,8,8,0,0,100,146375,1301,114
45300,2024,44,43,1,2,98,228917,2134,112
45302,2024,101,85,16,16,84,191084,2242,87
45303,2024,5,5,0,0,100,109185,1547,81
45305,2024,1,1,0,0,100,197000,1539,128
45306,2024,6,6,0,0,100,138833,1729,82
45307,2024,10,10,0,0,100,133859,1636,91
45308,2024,18,18,0,0,100,298020,2639,117
45309,2024,11,11,0,0,100,317231,3016,99
45310,2024,19,19,0,0,100,191298,2182,91
45311,2024,6,6,0,0,100,146333,1955,79
45312,2024,8,8,0,0,100,118456,1506,79
45313,2024,7,7,0,0,100,159873,1639,101
45314,2024,5,5,0,0,100,149868,2122,75
45315,2024,65,55,10,15,85,138758,1784,86
45316,2024,8,8,0,0,100,137206,1239,119
45317,2024,19,19,0,0,100,180026,2018,90
45320,2024,2,2,0,0,100,203495,1831,112
45321,2024,5,5,0,0,100,118252,1377,84
45322,2024,2,2,0,0,100,132500,944,136
45323,2024,1,1,0,0,100,95000,1267,75
45324,2024,27,27,0,0,100,200618,2052,103
45325,2024,1,1,0,0,100,257000,1469,175
45326,2024,6,6,0,0,100,149322,1500,102
45327,2024,23,23,0,0,100,219044,2150,103
45328,2024,4,4,0,0,100,103750,1024,98
45329,2024,20,20,0,0,100,118465,1376,93
45330,2024,1,1,0,0,100,260000,1757,148
45331,2024,5,5,0,0,100,131300,2054,73
45332,2024,21,21,0,0,100,129648,1509,90
45333,2024,15,14,1,7,93,198809,2106,93
45334,2024,8,8,0,0,100,149000,1300,119
45335,2024,23,21,2,9,91,192123,2034,100
45336,2024,10,10,0,0,100,182380,2604,82
45337,2024,6,6,0,0,100,153233,1462,106
45338,2024,69,66,3,4,96,142740,1778,81
45339,2024,9,9,0,0,100,119871,1490,85
45340,2024,8,8,0,0,100,103775,1262,82
45341,2024,3,3,0,0,100,148833,1605,79
45342,2024,3,3,0,0,100,111000,1829,63
45343,2024,3,3,0,0,100,136333,1294,112
45344,2024,10,10,0,0,100,196000,2058,99
45345,2024,8,8,0,0,100,193768,1606,124
45346,2024,31,31,0,0,100,211835,1930,110
45347,2024,16,16,0,0,100,152315,1678,96
45348,2024,7,7,0,0,100,188183,2055,107
46001,2024,7,7,0,0,100,100030,1229,91
46003,2024,6,6,0,0,100,171767,1890,86
46005,2024,3,3,0,0,100,181000,1933,94
46006,2024,7,7,0,0,100,181260,1854,97
46007,2024,13,13,0,0,100,148342,1319,118
46008,2024,1,1,0,0,100,156900,2615,60
46009,2024,7,6,1,14,86,135357,1681,81
46010,2024,3,3,0,0,100,259717,1698,147
46011,2024,1,1,0,0,100,115000,2738,42
46012,2024,5,5,0,0,100,172360,1552,113
46013,2024,3,3,0,0,100,122625,1892,80
46015,2024,14,14,0,0,100,99164,1046,102
46016,2024,6,6,0,0,100,147183,1321,103
46018,2024,2,2,0,0,100,281075,2127,134
46020,2024,3,3,0,0,100,125333,1074,150
46021,2024,5,5,0,0,100,191924,1511,128
46022,2024,4,4,0,0,100,244062,1536,161
46023,2024,6,6,0,0,100,161033,1467,112
46024,2024,1,1,0,0,100,74000,822,90
46026,2024,3,3,0,0,100,271043,2347,119
46027,2024,1,1,0,0,100,304350,2254,135
46028,2024,10,10,0,0,100,168369,2027,85
46029,2024,20,19,1,5,95,154930,1806,93
46030,2024,1,1,0,0,100,140000,1207,116
46031,2024,2,2,0,0,100,92500,1135,79
46032,2024,4,4,0,0,100,81750,1010,86
46033,2024,2,2,0,0,100,82250,1121,92
46034,2024,7,7,0,0,100,160294,1394,113
46035,2024,1,1,0,0,100,232000,2297,101
46036,2024,3,3,0,0,100,134565,1635,78
46037,2024,1,1,0,0,100,135000,1929,70
46038,2024,15,15,0,0,100,137356,1378,98
46039,2024,1,1,0,0,100,70000,598,117
46040,2024,3,3,0,0,100,88367,917,92
46041,2024,4,4,0,0,100,155980,2310,82
46042,2024,320,150,170,53,47,137219,1782,77
46043,2024,2,2,0,0,100,224850,2587,88
46044,2024,2,2,0,0,100,159740,1712,93
46045,2024,16,16,0,0,100,191898,1934,98
46046,2024,4,4,0,0,100,179425,1783,99
46047,2024,2,2,0,0,100,122335,1522,86
46049,2024,5,5,0,0,100,327926,3705,100
46050,2024,2,2,0,0,100,246000,2386,104
46051,2024,1,1,0,0,100,165767,2210,75
46052,2024,4,4,0,0,100,160832,2061,79
46053,2024,4,4,0,0,100,152500,1509,107
46054,2024,11,11,0,0,100,143536,1638,90
46055,2024,11,10,1,9,91,129152,1446,88
46057,2024,6,6,0,0,100,128417,1838,71
46058,2024,5,5,0,0,100,146545,1617,95
46059,2024,1,1,0,0,100,120000,923,130
46060,2024,2,2,0,0,100,251371,1928,121
46061,2024,1,1,0,0,100,180000,1856,97
46062,2024,7,6,1,14,86,103471,1198,88
46063,2024,25,25,0,0,100,183790,1707,101
46064,2024,11,10,1,9,91,155084,1501,103
46065,2024,3,3,0,0,100,112300,1382,79
46066,2024,14,12,2,14,86,186184,1588,118
46068,2024,2,2,0,0,100,135000,1570,86
46069,2024,1,1,0,0,100,235000,1433,164
46070,2024,4,4,0,0,100,241362,2165,111
46072,2024,3,3,0,0,100,328357,2643,134
46073,2024,11,11,0,0,100,131856,1399,90
46074,2024,2,2,0,0,100,150000,1080,141
46075,2024,1,1,0,0,100,160000,1081,148
46080,2024,6,6,0,0,100,301903,2408,130
46081,2024,1,1,0,0,100,255900,4265,60
46082,2024,2,2,0,0,100,214240,1792,118
46083,2024,14,13,1,7,93,198825,2080,102
46084,2024,3,3,0,0,100,119600,1620,65
46085,2024,5,5,0,0,100,97620,1155,84
46086,2024,8,8,0,0,100,266548,2201,121
46087,2024,10,10,0,0,100,144465,1490,87
46088,2024,7,7,0,0,100,158021,1898,85
46089,2024,9,9,0,0,100,137004,1557,91
46090,2024,1,1,0,0,100,200000,3333,60
46091,2024,1,1,0,0,100,218450,2540,86
46092,2024,1,1,0,0,100,264750,2037,130
46093,2024,1,1,0,0,100,245000,3712,66
46094,2024,5,5,0,0,100,340729,2535,134
46095,2024,9,9,0,0,100,174968,1683,102
46097,2024,1,1,0,0,100,36800,409,90
46098,2024,4,4,0,0,100,161300,1354,116
46100,2024,8,8,0,0,100,203036,2268,90
46101,2024,3,3,0,0,100,185150,1952,94
46102,2024,136,75,61,45,55,138848,1741,80
46103,2024,13,12,1,8,92,177896,1704,104
46105,2024,2,2,0,0,100,154600,1516,98
46106,2024,5,5,0,0,100,120518,1595,82
46107,2024,2,2,0,0,100,516200,3330,158
46108,2024,7,7,0,0,100,396141,2337,159
46109,2024,6,6,0,0,100,191317,1836,100
46112,2024,2,2,0,0,100,179500,1525,115
46113,2024,4,4,0,0,100,169495,1476,113
46114,2024,4,4,0,0,100,142576,1546,84
46115,2024,2,2,0,0,100,112000,1512,68
46116,2024,5,5,0,0,100,170600,1720,124
46117,2024,8,8,0,0,100,141619,1453,101
46118,2024,5,5,0,0,100,290312,1559,178
46119,2024,3,3,0,0,100,98667,1349,72
46121,2024,3,3,0,0,100,210648,1676,129
46123,2024,4,4,0,0,100,142450,1900,122
46124,2024,1,1,0,0,100,229000,1908,120
46125,2024,4,4,0,0,100,181870,1467,127
46126,2024,5,5,0,0,100,261411,2002,149
46127,2024,79,57,22,28,72,130820,1512,83
46128,2024,46,38,8,17,83,142667,1555,90
46129,2024,2,2,0,0,100,195556,3981,72
46130,2024,5,4,1,20,80,268318,2226,117
46131,2024,4,4,0,0,100,130325,1509,88
46132,2024,5,5,0,0,100,123300,1025,121
46133,2024,2,2,0,0,100,183080,2058,88
46134,2024,2,2,0,0,100,139500,1405,101
46136,2024,2,2,0,0,100,188868,2598,63
46137,2024,11,11,0,0,100,182191,1491,123
46138,2024,22,21,1,5,95,131939,1401,101
46140,2024,3,3,0,0,100,196150,1594,132
46142,2024,3,3,0,0,100,119333,1489,88
46143,2024,10,10,0,0,100,112650,1277,86
46144,2024,3,3,0,0,100,298067,2782,106
46145,2024,11,11,0,0,100,163763,1667,100
46148,2024,11,11,0,0,100,290298,2330,129
46149,2024,12,12,0,0,100,177162,1748,109
46151,2024,1,1,0,0,100,50000,943,53
46152,2024,4,4,0,0,100,141125,1078,129
46153,2024,5,5,0,0,100,357200,3591,136
46154,2024,3,3,0,0,100,231165,1977,134
46155,2024,2,2,0,0,100,51500,1006,52
46156,2024,15,15,0,0,100,119826,1367,93
46157,2024,3,3,0,0,100,187100,1930,96
46159,2024,7,7,0,0,100,103500,1538,72
46160,2024,5,4,1,20,80,59800,785,77
46162,2024,2,2,0,0,100,150500,1654,100
46163,2024,5,5,0,0,100,77950,1157,67
46164,2024,3,3,0,0,100,106333,1151,96
46165,2024,4,4,0,0,100,171650,1616,116
46167,2024,1,1,0,0,100,90000,1915,47
46168,2024,1,1,0,0,100,45000,570,79
46169,2024,4,4,0,0,100,134798,1187,118
46170,2024,5,5,0,0,100,166716,1481,112
46171,2024,7,7,0,0,100,177781,1881,86
46172,2024,4,4,0,0,100,165222,1651,107
46173,2024,11,10,1,9,91,150153,1713,91
46174,2024,1,1,0,0,100,75000,1042,72
46175,2024,8,8,0,0,100,157988,1536,116
46176,2024,9,8,1,11,89,254028,3132,106
46177,2024,5,5,0,0,100,180800,1497,124
46178,2024,2,2,0,0,100,185250,1910,96
46179,2024,1,1,0,0,100,150000,1230,122
46180,2024,6,6,0,0,100,201000,1686,119
46182,2024,22,21,1,5,95,133105,1595,81
46183,2024,6,6,0,0,100,176800,1571,125
46184,2024,5,5,0,0,100,203900,1575,134
46185,2024,23,23,0,0,100,234687,2338,108
46186,2024,3,3,0,0,100,140333,1150,141
46187,2024,8,8,0,0,100,286538,2333,118
46188,2024,1,1,0,0,100,230000,1769,130
46189,2024,5,5,0,0,100,92244,1082,90
46190,2024,2,2,0,0,100,306195,2361,131
46191,2024,10,9,1,10,90,158762,1580,104
46193,2024,5,5,0,0,100,114540,1188,101
46194,2024,2,1,1,50,50,239000,2534,98
46195,2024,1,1,0,0,100,100000,1429,70
46197,2024,3,3,0,0,100,195322,1779,109
46198,2024,1,1,0,0,100,438000,1991,220
46199,2024,7,7,0,0,100,211869,2213,94
46200,2024,3,3,0,0,100,178333,2023,85
46201,2024,27,26,1,4,96,160751,1798,88
46202,2024,4,4,0,0,100,207973,1799,109
46203,2024,3,3,0,0,100,141800,2054,72
46204,2024,1,1,0,0,100,80000,1455,55
46205,2024,8,8,0,0,100,200589,1931,106
46206,2024,2,2,0,0,100,280465,1981,146
46207,2024,3,3,0,0,100,103333,963,104
46208,2024,2,2,0,0,100,222500,2503,87
46209,2024,3,3,0,0,100,171733,1436,114
46210,2024,2,2,0,0,100,131000,1526,82
46211,2024,3,3,0,0,100,155667,1622,95
46212,2024,1,1,0,0,100,140000,2456,57
46213,2024,2,2,0,0,100,47500,446,97
46214,2024,6,6,0,0,100,144000,1520,102
46215,2024,7,7,0,0,100,160781,1582,103
46216,2024,9,9,0,0,100,205518,2061,98
46217,2024,1,1,0,0,100,72760,674,108
46218,2024,3,3,0,0,100,106667,993,110
46219,2024,5,5,0,0,100,109139,1768,62
46220,2024,6,6,0,0,100,171167,1861,124
46221,2024,3,3,0,0,100,194833,3011,72
46222,2024,1,1,0,0,100,428600,3061,140
46223,2024,2,2,0,0,100,115000,1775,82
46224,2024,38,35,3,8,92,175141,1853,96
46225,2024,40,38,2,5,95,182668,1834,100
46226,2024,3,3,0,0,100,111801,1578,94
46227,2024,6,6,0,0,100,142400,1654,87
46228,2024,4,4,0,0,100,146101,1600,93
46229,2024,16,15,1,6,94,159416,1585,101
46230,2024,2,2,0,0,100,86000,910,104
46231,2024,41,38,3,7,93,207492,1710,116
46232,2024,13,13,0,0,100,184510,1662,104
46233,2024,2,2,0,0,100,138000,1494,92
46236,2024,3,3,0,0,100,188333,1732,113
46237,2024,2,2,0,0,100,142965,1778,80
46238,2024,3,3,0,0,100,78733,1594,37
46239,2024,2,2,0,0,100,101500,958,114
46240,2024,4,4,0,0,100,120750,1532,81
46241,2024,1,1,0,0,100,566100,2292,247
46242,2024,2,2,0,0,100,110196,1486,78
46243,2024,2,2,0,0,100,152496,1698,96
46244,2024,1,1,0,0,100,154400,2573,60
46245,2024,1,1,0,0,100,140000,1867,75
46247,2024,1,1,0,0,100,60000,741,81
46249,2024,1,1,0,0,100,197234,1315,150
46250,2024,1,1,0,0,100,150000,1304,115
46251,2024,42,36,6,14,86,128162,1620,82
46252,2024,4,4,0,0,100,155812,1749,110
46253,2024,1,1,0,0,100,379000,2016,188
46254,2024,1,1,0,0,100,322300,1612,200
46255,2024,3,3,0,0,100,160098,1511,100
46256,2024,4,4,0,0,100,261625,2530,106
46257,2024,1,1,0,0,100,135000,1627,83
46258,2024,1,1,0,0,100,369410,2323,159
46260,2024,2,2,0,0,100,105000,742,140
46262,2024,7,7,0,0,100,159799,1922,96
46263,2024,5,5,0,0,100,158164,1634,98
46264,2024,1,1,0,0,100,125000,1453,86
46265,2024,6,6,0,0,100,117083,1250,94
46266,2024,2,2,0,0,100,233900,1923,122
46267,2024,11,11,0,0,100,169725,1841,94
46268,2024,15,15,0,0,100,159134,2037,83
46270,2024,4,4,0,0,100,239187,1917,120
46271,2024,6,6,0,0,100,155250,1636,100
46272,2024,4,4,0,0,100,183720,2015,88
46273,2024,8,7,1,12,88,196089,1775,125
46276,2024,2,2,0,0,100,135500,1648,79
46277,2024,1,1,0,0,100,282855,1489,190
46280,2024,2,2,0,0,100,53409,644,78
46281,2024,3,3,0,0,100,247043,2046,115
46282,2024,1,1,0,0,100,220000,1630,135
46283,2024,3,3,0,0,100,148500,1504,95
46284,2024,4,4,0,0,100,125712,1328,97
46288,2024,1,1,0,0,100,185000,2434,76
46289,2024,1,1,0,0,100,127400,2089,61
46290,2024,7,7,0,0,100,213314,1673,134
46292,2024,4,4,0,0,100,254250,1916,127
46293,2024,7,7,0,0,100,193400,1788,114
46294,2024,3,3,0,0,100,404534,1909,174
46295,2024,2,2,0,0,100,171750,1950,70
46296,2024,4,4,0,0,100,179300,2400,79
46297,2024,17,17,0,0,100,138171,1450,98
46299,2024,1,1,0,0,100,75000,1172,64
46301,2024,9,9,0,0,100,189894,1497,130
46303,2024,3,3,0,0,100,119667,1383,81
46304,2024,3,2,1,33,67,273333,2644,128
46305,2024,6,6,0,0,100,347558,2911,123
46306,2024,2,2,0,0,100,110000,1414,76
46307,2024,9,9,0,0,100,183287,1388,140
46308,2024,2,2,0,0,100,110615,1498,70
46309,2024,56,38,18,32,68,105835,1428,75
46310,2024,2,2,0,0,100,105500,956,92
46311,2024,15,15,0,0,100,122382,1254,112
46312,2024,1,1,0,0,100,180000,2250,80
46313,2024,4,4,0,0,100,181902,1806,102
46314,2024,2,2,0,0,100,115000,1582,87
46315,2024,1,1,0,0,100,76000,1462,52
46316,2024,3,3,0,0,100,173333,1600,110
46317,2024,5,5,0,0,100,135050,1604,95
46318,2024,3,3,0,0,100,77333,1082,81
46319,2024,3,3,0,0,100,96667,1178,92
46320,2024,6,6,0,0,100,219288,2414,96
46321,2024,5,5,0,0,100,108845,1379,77
46322,2024,10,9,1,10,90,151456,1628,94
46323,2024,1,1,0,0,100,56604,1179,48
46324,2024,3,3,0,0,100,104792,1175,166
46328,2024,4,4,0,0,100,90348,1462,62
46329,2024,2,2,0,0,100,70000,924,98
46330,2024,13,12,1,8,92,139188,1540,85
46332,2024,3,3,0,0,100,169933,1243,136
46333,2024,2,2,0,0,100,63500,1412,46
46334,2024,18,17,1,6,94,216316,2277,107
46335,2024,2,2,0,0,100,350000,3313,100
46336,2024,7,7,0,0,100,219422,2191,101
46337,2024,3,3,0,0,100,181153,1932,92
46338,2024,2,2,0,0,100,59326,578,102
46339,2024,3,3,0,0,100,96600,1471,66
46340,2024,6,6,0,0,100,220583,2200,112
47001,2024,554,183,371,67,33,122164,1785,71
47002,2024,1,1,0,0,100,156000,1114,140
47003,2024,11,11,0,0,100,232274,1942,119
47004,2024,57,48,9,16,84,121148,1368,94
47005,2024,2,2,0,0,100,167500,1790,97
47006,2024,3,3,0,0,100,196993,1125,185
47007,2024,1,1,0,0,100,90000,1071,84
47008,2024,5,5,0,0,100,93000,1137,82
47009,2024,3,3,0,0,100,169867,969,171
47010,2024,1,1,0,0,100,192000,2110,91
47011,2024,2,2,0,0,100,183500,2598,70
47012,2024,1,1,0,0,100,200000,1538,130
47013,2024,6,6,0,0,100,247042,1682,144
47015,2024,20,20,0,0,100,141210,1251,109
47016,2024,6,6,0,0,100,258590,2345,110
47017,2024,3,3,0,0,100,106930,1220,111
47018,2024,6,6,0,0,100,198505,1472,131
47019,2024,4,4,0,0,100,257929,1826,145
47020,2024,3,3,0,0,100,300589,1999,154
47021,2024,18,18,0,0,100,147177,1571,95
47022,2024,1,1,0,0,100,300000,2804,107
47023,2024,5,5,0,0,100,188936,1388,124
47024,2024,10,10,0,0,100,219290,1992,112
47025,2024,10,10,0,0,100,142086,1974,88
47026,2024,1,1,0,0,100,142000,2582,55
47027,2024,34,34,0,0,100,149762,1575,97
47028,2024,4,4,0,0,100,250750,1920,132
47029,2024,8,8,0,0,100,220943,1929,124
47030,2024,5,5,0,0,100,168390,1235,138
47031,2024,43,40,3,7,93,194306,2037,96
47032,2024,62,56,6,10,90,171077,1873,92
47033,2024,3,3,0,0,100,172860,1770,86
47034,2024,3,3,0,0,100,124950,1187,101
47035,2024,4,4,0,0,100,228655,1843,122
47036,2024,3,3,0,0,100,182667,1114,156
47037,2024,2,2,0,0,100,72500,588,122
47038,2024,7,7,0,0,100,167364,1552,110
47039,2024,1,1,0,0,100,207190,2072,100
47040,2024,21,21,0,0,100,241387,2186,109
47041,2024,9,9,0,0,100,117728,980,130
47042,2024,1,1,0,0,100,95000,742,128
47043,2024,16,16,0,0,100,142799,1341,102
47044,2024,3,3,0,0,100,233967,1905,114
47045,2024,6,6,0,0,100,116083,1098,107
47046,2024,12,11,1,8,92,162519,1923,91
47047,2024,2,2,0,0,100,188500,1400,136
47048,2024,15,15,0,0,100,138567,1208,115
47049,2024,25,25,0,0,100,147280,1435,103
47050,2024,1,1,0,0,100,190000,1583,120
47051,2024,29,26,3,10,90,239462,2092,114
47052,2024,69,54,15,22,78,155464,1738,93
47053,2024,4,4,0,0,100,223538,2503,96
47054,2024,16,16,0,0,100,160205,1294,124
47055,2024,5,3,2,40,60,89256,1210,74
47056,2024,5,5,0,0,100,220778,1813,119
47057,2024,26,24,2,8,92,144359,1369,103
47058,2024,3,3,0,0,100,176000,1911,96
47059,2024,5,5,0,0,100,232880,2364,98
47060,2024,7,7,0,0,100,176858,1764,100
47061,2024,9,9,0,0,100,156489,1401,120
47062,2024,4,4,0,0,100,257178,2222,129
47063,2024,1,1,0,0,100,47500,528,90
47064,2024,5,5,0,0,100,198058,1859,101
47065,2024,25,25,0,0,100,142239,1347,114
47066,2024,7,7,0,0,100,170356,1476,123
47067,2024,4,4,0,0,100,225175,1723,133
47068,2024,11,11,0,0,100,193986,1876,112
47069,2024,29,23,6,21,79,169827,1790,92
47070,2024,10,10,0,0,100,124702,1262,96
47071,2024,1,1,0,0,100,48000,533,90
47072,2024,1,1,0,0,100,100000,1493,67
47073,2024,1,1,0,0,100,409000,2045,200
47074,2024,4,4,0,0,100,84558,970,92
47075,2024,10,10,0,0,100,192411,1922,103
47076,2024,2,2,0,0,100,170500,1977,88
47077,2024,8,8,0,0,100,164533,1506,107
47078,2024,13,10,3,23,77,82885,996,98
47079,2024,2,2,0,0,100,92000,1386,82
47080,2024,2,2,0,0,100,287800,3024,94
47081,2024,7,7,0,0,100,218708,2072,108
47083,2024,2,2,0,0,100,94000,604,154
47084,2024,8,8,0,0,100,230010,2070,105
47086,2024,15,15,0,0,100,198647,1447,135
47087,2024,1,1,0,0,100,362520,3152,115
47088,2024,12,8,4,33,67,139845,1275,101
47089,2024,2,2,0,0,100,331159,1896,170
47090,2024,1,1,0,0,100,217490,2417,90
47091,2024,20,17,3,15,85,199793,2267,86
47092,2024,3,3,0,0,100,100000,885,114
47093,2024,3,3,0,0,100,142983,1220,120
47094,2024,10,10,0,0,100,164490,1542,111
47095,2024,13,13,0,0,100,115303,1200,96
47096,2024,2,2,0,0,100,222500,1152,189
47097,2024,15,15,0,0,100,143333,1280,116
47098,2024,2,2,0,0,100,311000,1502,187
47099,2024,9,9,0,0,100,161017,1515,105
47100,2024,54,51,3,6,94,227408,2056,110
47101,2024,8,8,0,0,100,135312,1459,99
47102,2024,8,8,0,0,100,178070,1435,121
47104,2024,1,1,0,0,100,178000,1780,100
47105,2024,3,3,0,0,100,186990,2260,84
47106,2024,70,68,2,3,97,120648,1329,91
47107,2024,3,3,0,0,100,149967,1409,113
47108,2024,2,2,0,0,100,47850,462,100
47109,2024,4,4,0,0,100,249725,2134,120
47110,2024,7,7,0,0,100,153531,1351,128
47111,2024,7,7,0,0,100,124600,1179,110
47112,2024,4,4,0,0,100,124450,1250,112
47114,2024,6,6,0,0,100,266233,2169,128
47115,2024,2,2,0,0,100,242500,2030,112
47117,2024,10,10,0,0,100,216107,1874,117
47118,2024,2,2,0,0,100,260736,1630,160
47119,2024,8,8,0,0,100,123215,1574,82
47120,2024,1,1,0,0,100,173800,1609,108
47121,2024,4,4,0,0,100,249250,2132,116
47122,2024,2,2,0,0,100,166500,1322,119
47123,2024,6,6,0,0,100,117317,1173,98
47124,2024,3,3,0,0,100,272193,1842,160
47125,2024,4,4,0,0,100,153300,998,144
47127,2024,9,9,0,0,100,104056,1098,102
47128,2024,13,11,2,15,85,167140,1817,91
47129,2024,2,2,0,0,100,74000,778,116
47130,2024,4,4,0,0,100,184800,1760,103
47131,2024,9,9,0,0,100,189856,1729,116
47132,2024,7,7,0,0,100,203321,2129,97
47133,2024,5,5,0,0,100,206000,1556,142
47134,2024,5,5,0,0,100,175384,1908,95
47135,2024,7,6,1,14,86,150260,1327,130
47137,2024,8,7,1,12,88,202806,2252,99
47138,2024,16,16,0,0,100,166387,1596,107
47140,2024,9,9,0,0,100,196528,1925,108
47141,2024,7,7,0,0,100,189297,1650,118
47142,2024,21,21,0,0,100,258945,1803,145
47143,2024,26,26,0,0,100,144338,1379,106
47144,2024,10,10,0,0,100,220793,2003,102
47145,2024,35,27,8,23,77,163838,1756,94
47146,2024,10,10,0,0,100,157530,1639,100
47147,2024,6,6,0,0,100,159959,1587,104
47150,2024,2,2,0,0,100,167500,1741,97
47151,2024,8,8,0,0,100,223826,1582,145
47152,2024,3,3,0,0,100,109333,1142,88
47154,2024,5,5,0,0,100,197464,1811,109
47155,2024,4,4,0,0,100,188575,1538,159
47156,2024,5,5,0,0,100,138777,1371,101
47157,2024,240,186,54,22,78,133759,1602,84
47158,2024,3,3,0,0,100,230300,1973,111
47159,2024,14,14,0,0,100,116491,1073,105
47160,2024,5,5,0,0,100,288080,2903,95
47161,2024,1,1,0,0,100,150810,1754,86
47162,2024,1,1,0,0,100,352000,2708,130
47163,2024,2,2,0,0,100,364860,2036,186
47164,2024,1,1,0,0,100,22000,400,55
47165,2024,14,14,0,0,100,184636,1271,147
47167,2024,17,16,1,6,94,112851,1078,101
47168,2024,47,40,7,15,85,81262,1067,77
47169,2024,9,9,0,0,100,219058,1887,115
47170,2024,6,6,0,0,100,182293,1348,137
47171,2024,3,3,0,0,100,367088,2487,153
47172,2024,5,5,0,0,100,219330,1894,117
47173,2024,11,11,0,0,100,141482,1404,92
47174,2024,15,15,0,0,100,197037,1647,129
47175,2024,41,33,8,20,80,144413,1574,84
47176,2024,2,2,0,0,100,72500,636,116
47177,2024,1,1,0,0,100,174000,2559,68
47178,2024,2,2,0,0,100,180450,1818,100
47179,2024,30,28,2,7,93,124562,1389,88
47180,2024,2,2,0,0,100,85000,1204,77
47181,2024,3,3,0,0,100,127536,1528,82
47182,2024,3,3,0,0,100,242333,1632,146
47183,2024,5,5,0,0,100,160051,1124,147
47184,2024,8,8,0,0,100,259037,1887,160
47185,2024,31,31,0,0,100,142544,1342,102
47186,2024,6,6,0,0,100,221605,2037,109
47188,2024,1,1,0,0,100,220000,1272,173
47189,2024,1,1,0,0,100,77500,923,84
47190,2024,4,4,0,0,100,224662,2018,106
47191,2024,7,7,0,0,100,148571,1662,96
47192,2024,1,1,0,0,100,135000,1534,88
47193,2024,1,1,0,0,100,330000,1587,208
47194,2024,2,2,0,0,100,160783,787,210
47195,2024,82,65,17,21,79,162442,1557,103
47196,2024,4,4,0,0,100,60755,717,98
47197,2024,2,2,0,0,100,310475,1492,195
47198,2024,2,2,0,0,100,103000,809,132
47199,2024,3,3,0,0,100,577783,2334,249
47201,2024,134,119,15,11,89,156306,1863,84
47202,2024,2,2,0,0,100,126000,1297,88
47203,2024,38,32,6,16,84,189496,1775,108
47204,2024,3,3,0,0,100,133467,1623,79
47205,2024,5,5,0,0,100,299477,2492,132
47206,2024,6,6,0,0,100,271183,2194,118
47207,2024,1,1,0,0,100,81000,1373,59
47209,2024,50,45,5,10,90,155084,1795,86
47210,2024,14,14,0,0,100,84191,1050,84
47211,2024,4,4,0,0,100,100750,864,110
47212,2024,4,4,0,0,100,209825,1920,102
47213,2024,7,7,0,0,100,209229,2084,108
47214,2024,12,12,0,0,100,175986,1835,93
47215,2024,43,40,3,7,93,163682,1956,92
47216,2024,4,4,0,0,100,225525,1678,133
47217,2024,13,13,0,0,100,137760,1386,103
47218,2024,2,2,0,0,100,390142,2526,156
47219,2024,1,1,0,0,100,386980,2977,130
47220,2024,2,2,0,0,100,199065,1738,115
47221,2024,7,7,0,0,100,219387,1619,140
47222,2024,2,2,0,0,100,67500,764,88
47223,2024,4,4,0,0,100,194625,1730,113
47224,2024,1,1,0,0,100,165000,1650,100
47225,2024,19,19,0,0,100,217385,2182,104
47226,2024,9,9,0,0,100,177637,1562,109
47227,2024,1,1,0,0,100,190000,2088,91
47228,2024,4,4,0,0,100,159350,1238,130
47230,2024,3,3,0,0,100,180833,1662,104
47231,2024,3,3,0,0,100,184197,1044,156
47232,2024,6,6,0,0,100,178183,1109,160
47233,2024,38,33,5,13,87,139194,1454,98
47234,2024,3,3,0,0,100,306333,2225,138
47235,2024,10,10,0,0,100,164378,1863,83
47236,2024,1,1,0,0,100,266000,1330,200
47237,2024,3,3,0,0,100,245833,2439,124
47238,2024,15,15,0,0,100,294020,2999,107
47239,2024,11,11,0,0,100,209532,1755,126
47240,2024,4,4,0,0,100,266950,2021,134
47241,2024,5,5,0,0,100,220759,1994,110
47242,2024,7,7,0,0,100,172714,2063,91
47244,2024,3,3,0,0,100,233333,2216,106
47246,2024,9,9,0,0,100,214778,1797,125
47247,2024,3,3,0,0,100,229356,1332,189
47248,2024,6,6,0,0,100,180967,1768,103
47249,2024,6,6,0,0,100,172812,1357,124
47250,2024,1,1,0,0,100,150000,1364,110
47251,2024,2,2,0,0,100,82500,776,99
47252,2024,56,56,0,0,100,140464,1369,99
47253,2024,4,4,0,0,100,210875,1636,117
47254,2024,2,2,0,0,100,194750,1066,161
47255,2024,2,2,0,0,100,252250,1918,130
47257,2024,5,5,0,0,100,180904,1292,139
47258,2024,5,5,0,0,100,227287,2363,121
47260,2024,8,8,0,0,100,206402,2082,121
47262,2024,1,1,0,0,100,250000,2778,90
47263,2024,7,7,0,0,100,164343,1388,114
47264,2024,14,14,0,0,100,140644,1538,94
47265,2024,7,7,0,0,100,167762,1640,107
47266,2024,1,1,0,0,100,63000,643,98
47267,2024,3,3,0,0,100,308333,2086,149
47269,2024,4,4,0,0,100,170500,2000,87
47271,2024,4,4,0,0,100,165082,1899,92
47272,2024,3,3,0,0,100,115667,988,115
47273,2024,4,4,0,0,100,325884,1826,186
47274,2024,4,4,0,0,100,268775,2522,119
47275,2024,3,3,0,0,100,121667,1313,94
47276,2024,2,2,0,0,100,76000,764,90
47277,2024,5,5,0,0,100,141821,1491,95
47278,2024,8,8,0,0,100,414306,2235,194
47279,2024,5,5,0,0,100,136581,1428,97
47280,2024,23,23,0,0,100,150523,1876,83
47281,2024,1,1,0,0,100,105000,875,120
47282,2024,1,1,0,0,100,168000,1976,85
47283,2024,8,8,0,0,100,136252,1363,102
47284,2024,4,4,0,0,100,235000,1975,113
47285,2024,9,9,0,0,100,151594,1380,102
47288,2024,7,7,0,0,100,219686,2461,107
47289,2024,4,4,0,0,100,151500,1538,118
47290,2024,13,13,0,0,100,227641,1824,138
47291,2024,6,6,0,0,100,149250,1734,87
47292,2024,9,9,0,0,100,87667,954,96
47293,2024,4,4,0,0,100,194200,1947,97
47294,2024,4,4,0,0,100,219125,1864,114
47295,2024,3,3,0,0,100,169000,1325,137
47296,2024,2,2,0,0,100,212342,1631,120
47299,2024,9,9,0,0,100,262765,2352,121
47300,2024,13,13,0,0,100,173922,1610,111
47301,2024,7,7,0,0,100,128071,1552,81
47302,2024,8,8,0,0,100,105900,1070,101
47303,2024,1,1,0,0,100,50000,515,97
47304,2024,1,1,0,0,100,167990,1750,96
47305,2024,5,5,0,0,100,254040,1772,158
47306,2024,12,12,0,0,100,182541,1713,107
47307,2024,1,1,0,0,100,116000,2578,45
47308,2024,3,3,0,0,100,72333,784,89
47309,2024,7,7,0,0,100,101278,945,119
47310,2024,121,100,21,17,83,111752,1276,92
47311,2024,1,1,0,0,100,116000,1137,102
47312,2024,6,6,0,0,100,264132,1508,159
47313,2024,2,2,0,0,100,357750,1466,236
47314,2024,3,3,0,0,100,230033,1260,185
47315,2024,11,11,0,0,100,171868,1541,111
47316,2024,5,5,0,0,100,180500,1487,123
47317,2024,1,1,0,0,100,80000,833,96
47318,2024,16,16,0,0,100,138319,1289,111
47320,2024,4,4,0,0,100,195000,1559,122
47321,2024,3,2,1,33,67,85000,718,98
47323,2024,345,273,72,21,79,132215,1434,89
47324,2024,28,28,0,0,100,194742,2077,98
47325,2024,5,5,0,0,100,121247,3189,78
47326,2024,14,14,0,0,100,146486,1554,97
47327,2024,4,4,0,0,100,230958,1964,126
47328,2024,6,6,0,0,100,182067,1628,116
48002,2024,3,3,0,0,100,203691,1853,113
48003,2024,4,4,0,0,100,121250,1300,86
48004,2024,5,5,0,0,100,131145,1304,108
48005,2024,2,2,0,0,100,169150,1710,127
48009,2024,15,15,0,0,100,116861,1424,86
48010,2024,3,3,0,0,100,53000,1219,51
48012,2024,5,5,0,0,100,125258,1120,103
48013,2024,13,12,1,8,92,171520,1864,96
48015,2024,4,3,1,25,75,263750,3346,96
48016,2024,5,5,0,0,100,211600,2378,89
48017,2024,10,10,0,0,100,137395,1428,90
48018,2024,9,8,1,11,89,171650,1724,99
48019,2024,3,3,0,0,100,116000,2267,67
48020,2024,1,1,0,0,100,125540,2092,60
48021,2024,4,4,0,0,100,126175,1434,91
48025,2024,2,2,0,0,100,457995,7487,98
48026,2024,2,2,0,0,100,77500,1056,67
48027,2024,16,10,6,38,62,128980,2116,77
48029,2024,1,1,0,0,100,50000,758,66
48030,2024,1,1,0,0,100,174000,2486,70
48032,2024,3,3,0,0,100,135033,1575,85
48034,2024,18,16,2,11,89,132118,1567,89
48036,2024,2,2,0,0,100,94278,2404,36
48037,2024,2,2,0,0,100,216750,1816,122
48038,2024,3,2,1,33,67,75563,631,125
48039,2024,17,17,0,0,100,168331,1712,105
48041,2024,1,1,0,0,100,77000,1069,72
48042,2024,6,6,0,0,100,265603,2756,109
48043,2024,2,2,0,0,100,275800,3689,90
48044,2024,1,1,0,0,100,22000,917,24
48045,2024,5,5,0,0,100,112250,1107,99
48048,2024,1,0,1,100,0,230000,2644,87
48050,2024,7,7,0,0,100,257623,2796,111
48051,2024,4,2,2,50,50,104625,1540,61
48053,2024,8,8,0,0,100,123619,1352,90
48055,2024,3,3,0,0,100,161100,2248,73
48056,2024,1,1,0,0,100,105000,1221,86
48058,2024,2,2,0,0,100,117500,2521,50
48059,2024,2,2,0,0,100,148525,1850,85
48061,2024,13,10,3,23,77,148980,1575,94
48063,2024,5,5,0,0,100,117910,1531,94
48064,2024,1,1,0,0,100,233500,2624,89
48067,2024,1,1,0,0,100,360000,2571,140
48068,2024,2,2,0,0,100,205410,2128,80
48070,2024,9,9,0,0,100,116963,1785,80
48072,2024,4,3,1,25,75,186360,1934,96
48074,2024,2,2,0,0,100,307500,2932,98
48075,2024,11,8,3,27,73,147182,1551,87
48079,2024,1,1,0,0,100,90000,1286,70
48080,2024,35,19,16,46,54,138979,1555,90
48081,2024,2,2,0,0,100,85000,834,100
48083,2024,5,5,0,0,100,115170,966,132
48085,2024,1,1,0,0,100,120000,1043,115
48086,2024,11,9,2,18,82,76989,1262,63
48087,2024,3,3,0,0,100,130183,1130,124
48088,2024,3,3,0,0,100,140767,2118,75
48089,2024,3,3,0,0,100,108717,1359,76
48090,2024,4,3,1,25,75,157638,1682,86
48091,2024,1,1,0,0,100,200000,2500,80
48092,2024,52,27,25,48,52,97921,1409,71
48094,2024,8,8,0,0,100,133506,1736,82
48095,2024,93,31,62,67,33,164865,2107,78
48096,2024,11,10,1,9,91,109345,1668,65
48097,2024,4,4,0,0,100,166780,1686,96
48098,2024,2,2,0,0,100,186350,2704,85
48099,2024,20,20,0,0,100,159020,1544,106
48100,2024,3,2,1,33,67,109320,1115,82
48103,2024,5,5,0,0,100,180900,1576,115
48104,2024,5,5,0,0,100,112500,1755,65
48105,2024,3,2,1,33,67,212233,1429,156
48108,2024,3,3,0,0,100,221000,3478,65
48111,2024,4,3,1,25,75,93125,1224,80
48112,2024,1,1,0,0,100,159400,1660,96
48115,2024,4,4,0,0,100,112500,1408,86
48116,2024,7,6,1,14,86,106143,1740,68
48117,2024,3,3,0,0,100,156733,2219,80
48119,2024,1,1,0,0,100,80750,1009,80
48121,2024,3,3,0,0,100,115000,1203,92
48123,2024,2,2,0,0,100,197050,1862,100
48124,2024,1,1,0,0,100,110000,1375,80
48126,2024,6,5,1,17,83,83634,998,86
48127,2024,8,8,0,0,100,187450,1510,125
48128,2024,3,3,0,0,100,160746,1608,98
48129,2024,4,4,0,0,100,82250,1018,100
48131,2024,3,1,2,67,33,80773,1208,73
48132,2024,19,19,0,0,100,122848,1406,90
48135,2024,1,1,0,0,100,17000,340,50
48137,2024,1,1,0,0,100,217000,1855,117
48140,2024,29,25,4,14,86,158081,1723,94
48141,2024,3,3,0,0,100,98500,1556,61
48144,2024,3,3,0,0,100,231932,2062,110
48145,2024,2,2,0,0,100,62500,1284,48
48146,2024,16,15,1,6,94,142065,1910,75
48147,2024,3,3,0,0,100,212217,1893,114
48148,2024,7,6,1,14,86,151307,2764,67
48150,2024,4,4,0,0,100,142788,1234,112
48152,2024,6,5,1,17,83,94352,1246,86
48155,2024,7,7,0,0,100,156143,2039,88
48156,2024,6,6,0,0,100,170730,1648,106
48158,2024,1,1,0,0,100,135000,1500,90
48160,2024,1,1,0,0,100,132110,887,149
48161,2024,1,1,0,0,100,67500,1350,50
48166,2024,3,3,0,0,100,102383,2035,59
48168,2024,2,2,0,0,100,114172,1666,69
48169,2024,2,2,0,0,100,144018,1726,85
48171,2024,2,2,0,0,100,135000,1660,74
48173,2024,2,2,0,0,100,127250,3112,40
48174,2024,1,1,0,0,100,135000,1552,87
48175,2024,3,3,0,0,100,173367,1649,104
48176,2024,1,1,0,0,100,591460,4447,133
48177,2024,2,1,1,50,50,154250,1238,104
48178,2024,6,5,1,17,83,88917,1013,90
48179,2024,2,2,0,0,100,119750,1301,93
48181,2024,3,3,0,0,100,107333,2521,47
48182,2024,1,1,0,0,100,61900,774,80
48185,2024,3,3,0,0,100,232067,1977,118
48187,2024,1,1,0,0,100,77000,642,120
48188,2024,6,5,1,17,83,178263,2062,93
48191,2024,1,1,0,0,100,75000,1000,75
48192,2024,1,1,0,0,100,101700,2421,42
48193,2024,5,5,0,0,100,94806,1350,86
48194,2024,8,6,2,25,75,241188,4285,70
48198,2024,12,8,4,33,67,106125,1548,78
49002,2024,23,23,0,0,100,164935,1638,101
49003,2024,11,11,0,0,100,230425,1980,113
49007,2024,2021,546,1475,73,27,227536,3256,72
49008,2024,9,9,0,0,100,131089,1441,91
49009,2024,4,4,0,0,100,95475,1257,77
49010,2024,3,3,0,0,100,141667,1453,108
49011,2024,3,3,0,0,100,185267,1988,88
49012,2024,4,4,0,0,100,204425,1456,142
49015,2024,186,91,95,51,49,258985,3130,86
49017,2024,9,9,0,0,100,174656,2060,90
49018,2024,138,135,3,2,98,157860,1578,101
49020,2024,35,33,2,6,94,308280,2963,108
49021,2024,76,73,3,4,96,182592,1868,100
49022,2024,19,17,2,11,89,237211,2130,114
49023,2024,230,205,25,11,89,161092,1793,93
49026,2024,27,27,0,0,100,199736,2231,95
49027,2024,18,18,0,0,100,194094,2006,102
49028,2024,3,3,0,0,100,318833,3417,87
49029,2024,9,9,0,0,100,275776,2614,109
49030,2024,12,12,0,0,100,187333,2324,103
49035,2024,51,48,3,6,94,444793,3358,129
49036,2024,10,10,0,0,100,109969,1061,103
49038,2024,8,8,0,0,100,121322,1214,102
49041,2024,17,17,0,0,100,145681,1502,99
49045,2024,9,9,0,0,100,242393,1638,148
49048,2024,35,31,4,11,89,256390,2272,114
49050,2024,105,101,4,4,96,220731,2128,108
49053,2024,3,3,0,0,100,117333,1216,107
49054,2024,27,27,0,0,100,168635,1593,105
49055,2024,21,20,1,5,95,343282,2843,121
49056,2024,2,2,0,0,100,72500,861,85
49057,2024,2,2,0,0,100,108000,1324,88
49058,2024,6,6,0,0,100,137199,1364,100
49060,2024,39,37,2,5,95,150425,1647,91
49061,2024,7,7,0,0,100,165054,1384,123
49063,2024,63,48,15,24,76,210829,2255,94
49064,2024,6,6,0,0,100,128333,1319,100
49067,2024,4,4,0,0,100,298750,2060,160
49068,2024,16,15,1,6,94,177259,1678,104
49069,2024,147,145,2,1,99,204759,2241,94
49070,2024,4,4,0,0,100,112625,1308,86
49076,2024,10,10,0,0,100,192850,1838,109
49080,2024,98,97,1,1,99,177356,1643,109
49082,2024,8,8,0,0,100,208444,2072,109
49086,2024,51,51,0,0,100,186429,1791,108
49089,2024,10,10,0,0,100,180786,1604,108
49090,2024,18,17,1,6,94,174801,1769,109
49092,2024,171,168,3,2,98,176400,1660,107
49099,2024,664,429,235,35,65,175837,2172,82
49100,2024,6,6,0,0,100,116500,1266,92
49102,2024,4,4,0,0,100,104250,1232,86
49107,2024,9,9,0,0,100,236422,2008,118
49109,2024,7,7,0,0,100,127543,1524,89
49110,2024,13,13,0,0,100,155231,1726,97
49112,2024,7,7,0,0,100,130569,1688,73
49113,2024,4,4,0,0,100,200625,1808,112
49114,2024,4,4,0,0,100,90375,1252,72
49120,2024,16,15,1,6,94,238374,2373,105
49121,2024,4,4,0,0,100,128902,1507,86
49123,2024,23,23,0,0,100,219160,2199,103
49125,2024,100,99,1,1,99,187611,1814,105
49127,2024,30,30,0,0,100,143389,1474,95
49129,2024,47,44,3,6,94,253672,2549,101
49130,2024,7,7,0,0,100,274286,2092,131
49131,2024,7,6,1,14,86,132713,1224,96
49132,2024,20,20,0,0,100,219804,1992,112
49135,2024,20,19,1,5,95,233251,2217,108
49138,2024,27,27,0,0,100,164889,1646,102
49140,2024,13,13,0,0,100,142488,1630,92
49155,2024,7,7,0,0,100,340929,2191,163
49160,2024,18,18,0,0,100,176278,1945,97
49161,2024,7,7,0,0,100,153500,2138,82
49163,2024,23,22,1,4,96,168489,1790,95
49167,2024,49,47,2,4,96,313895,2715,118
49170,2024,9,9,0,0,100,198389,1926,116
49171,2024,1,1,0,0,100,177000,2011,88
49174,2024,17,17,0,0,100,134164,1442,97
49176,2024,54,51,3,6,94,205229,2163,99
49178,2024,9,9,0,0,100,167111,1320,134
49180,2024,63,63,0,0,100,151515,1562,97
49182,2024,12,12,0,0,100,173833,1916,92
49183,2024,43,42,1,2,98,174884,1770,104
49188,2024,7,7,0,0,100,211143,1769,122
49192,2024,20,20,0,0,100,186326,1758,107
49193,2024,40,40,0,0,100,144868,1632,89
49194,2024,50,48,2,4,96,202625,1958,109
49195,2024,7,7,0,0,100,262571,2239,119
49200,2024,47,46,1,2,98,264716,2582,104
49201,2024,20,19,1,5,95,185532,1590,124
49205,2024,13,13,0,0,100,122438,1378,88
49209,2024,6,6,0,0,100,146833,1412,106
49211,2024,11,11,0,0,100,119068,1286,92
49214,2024,52,41,11,21,79,267159,2707,100
49215,2024,35,33,2,6,94,135229,1353,101
49216,2024,1,1,0,0,100,194000,2156,90
49217,2024,5,5,0,0,100,208059,1793,109
49218,2024,180,179,1,1,99,149807,1610,95
49219,2024,6,6,0,0,100,188600,2195,88
49220,2024,48,47,1,2,98,161413,1573,109
49221,2024,10,10,0,0,100,97040,1575,82
49222,2024,10,10,0,0,100,294200,2089,139
49223,2024,57,47,10,18,82,266218,2597,104
49224,2024,11,11,0,0,100,225293,1955,105
49228,2024,85,85,0,0,100,107501,1149,95
49231,2024,17,17,0,0,100,199029,1878,111
49235,2024,1,1,0,0,100,177000,1500,118
49240,2024,6,6,0,0,100,167080,1377,120
49241,2024,14,14,0,0,100,302639,2361,134
49244,2024,144,139,5,3,97,174092,1819,99
49246,2024,110,77,33,30,70,229639,2648,87
49247,2024,20,20,0,0,100,340150,2489,129
49248,2024,105,103,2,2,98,139523,1339,104
49253,2024,12,12,0,0,100,119272,1132,103
49257,2024,15,15,0,0,100,155933,1507,106
49259,2024,25,25,0,0,100,252312,2293,117
49260,2024,21,21,0,0,100,196790,1890,108
49261,2024,117,115,2,2,98,202929,1978,103
49262,2024,4,4,0,0,100,236250,1609,146
49266,2024,14,14,0,0,100,227607,1988,122
49267,2024,101,69,32,32,68,259261,2707,96
49269,2024,22,22,0,0,100,223700,2075,107
49271,2024,20,20,0,0,100,279887,2318,124
49272,2024,17,17,0,0,100,179300,1748,112
49278,2024,41,34,7,17,83,319952,2994,109
49283,2024,23,22,1,4,96,219615,2252,101
49284,2024,18,18,0,0,100,210634,2025,108
49288,2024,2,2,0,0,100,177500,1794,101
49291,2024,1,1,0,0,100,130000,684,190
49292,2024,41,40,1,2,98,192432,1968,98
49294,2024,38,37,1,3,97,296380,2536,119
49298,2024,25,24,1,4,96,300284,2645,114
49299,2024,16,16,0,0,100,222760,2256,99
49301,2024,242,242,0,0,100,181497,1896,96
49302,2024,5,5,0,0,100,121900,1055,116
49306,2024,13,13,0,0,100,273546,2409,130
49307,2024,127,125,2,2,98,242294,2260,108
49308,2024,23,22,1,4,96,279087,2502,115
49310,2024,9,9,0,0,100,133328,1052,129
49311,2024,4,4,0,0,100,150625,1601,96
49323,2024,86,75,11,13,87,255138,2629,99
49326,2024,4,4,0,0,100,299000,2476,118
49328,2024,373,198,175,47,53,172130,1980,85
49329,2024,20,20,0,0,100,239825,2389,101
49330,2024,13,13,0,0,100,226515,2170,106
49331,2024,191,165,26,14,86,142279,1615,89
49332,2024,33,32,1,3,97,210152,1998,104
49333,2024,32,31,1,3,97,188519,1933,101
49334,2024,2,2,0,0,100,170000,1766,96
49336,2024,13,13,0,0,100,126668,1584,79
49338,2024,7,7,0,0,100,341514,2752,142
49339,2024,13,13,0,0,100,246043,2363,100
49341,2024,9,9,0,0,100,279444,1956,136
49343,2024,22,20,2,9,91,227993,2094,108
49344,2024,7,7,0,0,100,156084,1616,111
49345,2024,68,68,0,0,100,174581,1822,98
49347,2024,52,51,1,2,98,243583,2262,110
49352,2024,9,9,0,0,100,210710,2011,104
49353,2024,162,138,24,15,85,222153,2460,91
49355,2024,29,29,0,0,100,200179,1958,103
49358,2024,6,6,0,0,100,305933,1748,137
49359,2024,3,3,0,0,100,109333,1653,68
49361,2024,21,21,0,0,100,182183,1902,105
49362,2024,9,9,0,0,100,293222,1953,146
49364,2024,12,12,0,0,100,142650,1540,95
49367,2024,52,52,0,0,100,185371,1851,101
49368,2024,23,23,0,0,100,137049,1356,97
49369,2024,25,24,1,4,96,138362,1679,86
49370,2024,4,4,0,0,100,138875,1401,101
49371,2024,24,24,0,0,100,167450,1730,99
49373,2024,92,91,1,1,99,145998,1525,99
49374,2024,17,17,0,0,100,159424,1626,103
49377,2024,57,57,0,0,100,232878,2103,111
49378,2024,33,31,2,6,94,183681,1877,106
49381,2024,15,15,0,0,100,166025,1518,110
50002,2024,59,48,11,19,81,168634,1881,91
50003,2024,54,47,7,13,87,353008,4577,84
50004,2024,11,11,0,0,100,103136,1188,90
50006,2024,2,2,0,0,100,142112,1026,150
50008,2024,5,4,1,20,80,298200,2911,104
50013,2024,10,10,0,0,100,130250,1472,91
50016,2024,5,5,0,0,100,175300,2016,98
50019,2024,6,6,0,0,100,177500,1652,110
50022,2024,3,3,0,0,100,151667,1617,93
50023,2024,7,7,0,0,100,196267,1793,110
50024,2024,4,4,0,0,100,99102,1344,74
50025,2024,113,62,51,45,55,192161,2178,89
50027,2024,8,8,0,0,100,222972,2071,112
50029,2024,14,14,0,0,100,56161,914,73
50030,2024,13,8,5,38,62,209462,3125,72
50031,2024,69,52,17,25,75,264080,3709,76
50032,2024,15,15,0,0,100,208483,1712,123
50033,2024,1,1,0,0,100,103000,3219,32
50034,2024,2,2,0,0,100,139000,1754,80
50036,2024,3,3,0,0,100,92167,821,113
50038,2024,5,5,0,0,100,148200,1378,99
50039,2024,4,4,0,0,100,135995,1421,95
50040,2024,2,2,0,0,100,162500,1360,114
50041,2024,104,104,0,0,100,220875,2400,99
50042,2024,2,2,0,0,100,295000,2178,152
50044,2024,4,4,0,0,100,180875,1608,102
50045,2024,8,8,0,0,100,157612,1806,90
50046,2024,5,5,0,0,100,150800,1289,120
50048,2024,6,6,0,0,100,148033,1542,96
50049,2024,11,11,0,0,100,150507,1559,98
50050,2024,1,1,0,0,100,52000,1156,45
50052,2024,2,2,0,0,100,239500,2786,94
50054,2024,2,2,0,0,100,78000,870,98
50055,2024,2,2,0,0,100,165000,1120,148
50058,2024,22,22,0,0,100,246023,2804,98
50059,2024,5,5,0,0,100,152000,1580,99
50060,2024,10,10,0,0,100,146600,1666,88
50064,2024,2,2,0,0,100,157500,2626,61
50066,2024,51,44,7,14,86,312143,3995,83
50069,2024,5,5,0,0,100,131600,1907,73
50070,2024,2,2,0,0,100,178771,2264,78
50072,2024,2,2,0,0,100,210400,1849,118
50074,2024,25,24,1,4,96,130300,1518,92
50076,2024,60,57,3,5,95,277804,3374,88
50077,2024,15,15,0,0,100,255338,2725,99
50078,2024,14,14,0,0,100,208695,2896,83
50081,2024,13,13,0,0,100,368566,3524,116
50082,2024,63,62,1,2,98,185583,1918,99
50083,2024,7,7,0,0,100,201000,2186,89
50084,2024,4,4,0,0,100,198662,1995,96
50085,2024,12,12,0,0,100,219296,2348,95
50086,2024,7,7,0,0,100,179514,1922,93
50087,2024,18,18,0,0,100,191573,2434,81
50088,2024,7,7,0,0,100,106414,960,116
50090,2024,10,10,0,0,100,64000,784,81
50092,2024,11,11,0,0,100,130852,1484,86
50094,2024,9,9,0,0,100,151102,1591,96
50095,2024,19,19,0,0,100,180385,1610,115
50096,2024,3,3,0,0,100,177300,1670,107
50097,2024,1,1,0,0,100,250000,2551,98
50098,2024,13,13,0,0,100,153985,1389,109
50099,2024,141,121,20,14,86,152002,1677,94
50101,2024,3,3,0,0,100,258333,2370,110
50102,2024,22,21,1,5,95,254109,3788,75
50105,2024,3,3,0,0,100,86000,796,123
50106,2024,3,3,0,0,100,146283,1812,80
50108,2024,4,4,0,0,100,136650,1554,89
50109,2024,23,23,0,0,100,164622,1700,97
50110,2024,12,12,0,0,100,101241,1295,82
50111,2024,15,15,0,0,100,129733,1290,99
50112,2024,3,3,0,0,100,104000,1069,87
50115,2024,4,4,0,0,100,147500,1344,104
50117,2024,10,10,0,0,100,327180,2950,109
50118,2024,4,4,0,0,100,102750,981,127
50120,2024,4,4,0,0,100,199875,2614,76
50121,2024,4,4,0,0,100,103500,877,118
50124,2024,3,3,0,0,100,110167,1058,103
50126,2024,1,1,0,0,100,180000,1800,100
50129,2024,866,594,272,31,69,188220,2301,84
50130,2024,4,4,0,0,100,114745,1098,116
50135,2024,3,3,0,0,100,228333,2675,90
50137,2024,7,7,0,0,100,141525,1572,106
50138,2024,5,5,0,0,100,171060,1849,95
50139,2024,41,41,0,0,100,168658,1712,101
50142,2024,14,14,0,0,100,247286,2319,109
50143,2024,9,9,0,0,100,220244,2335,89
50144,2024,8,8,0,0,100,89006,1177,74
50145,2024,5,5,0,0,100,290600,1694,160
50146,2024,2,2,0,0,100,52000,684,76
50147,2024,102,62,40,39,61,177206,2115,86
50148,2024,11,11,0,0,100,154688,1706,97
50149,2024,16,16,0,0,100,229551,2250,104
50151,2024,26,25,1,4,96,199915,2044,99
50152,2024,3,3,0,0,100,96667,1749,49
50155,2024,2,2,0,0,100,171000,1267,137
50158,2024,6,6,0,0,100,55974,850,90
50159,2024,7,7,0,0,100,164429,1262,127
50161,2024,6,6,0,0,100,123167,1259,103
50162,2024,14,14,0,0,100,231112,2704,92
50164,2024,12,12,0,0,100,174148,1629,107
50165,2024,66,40,26,39,61,281304,3714,76
50166,2024,5,5,0,0,100,193600,1675,115
50167,2024,9,9,0,0,100,247250,2475,98
50168,2024,25,25,0,0,100,173912,1941,89
50169,2024,2,2,0,0,100,170300,1720,121
50172,2024,3,3,0,0,100,177000,2061,85
50174,2024,2,2,0,0,100,167500,1470,117
50175,2024,4,4,0,0,100,129250,1304,102
50176,2024,4,4,0,0,100,210725,2062,102
50177,2024,6,6,0,0,100,117250,1376,80
50178,2024,16,16,0,0,100,196250,2412,81
50181,2024,4,4,0,0,100,180125,1931,94
50182,2024,6,6,0,0,100,165683,1887,89
50183,2024,6,6,0,0,100,210147,2881,81
50184,2024,15,13,2,13,87,190980,2108,94
50185,2024,16,16,0,0,100,147905,1666,92
50188,2024,15,15,0,0,100,159420,1747,103
50190,2024,3,3,0,0,100,188167,2001,94
50193,2024,3,3,0,0,100,80833,1282,68
50194,2024,2,2,0,0,100,197000,1598,125
50195,2024,5,5,0,0,100,124494,1226,105
50196,2024,7,7,0,0,100,235200,2894,87
50197,2024,37,37,0,0,100,135335,1498,92
50198,2024,5,5,0,0,100,168800,1886,86
50199,2024,4,4,0,0,100,194750,2966,84
50200,2024,14,13,1,7,93,86857,1141,77
50205,2024,2,2,0,0,100,147000,1949,64
50208,2024,2,2,0,0,100,80482,1278,63
50209,2024,18,18,0,0,100,215882,2184,107
50210,2024,4,4,0,0,100,159462,1516,105
50214,2024,2,2,0,0,100,90316,948,84
50215,2024,51,51,0,0,100,217470,2459,92
50216,2024,9,9,0,0,100,132489,1241,106
50217,2024,7,7,0,0,100,122143,1555,85
50218,2024,288,97,191,66,34,226828,3717,65
50219,2024,10,10,0,0,100,173430,2590,91
50221,2024,1,1,0,0,100,152500,1694,90
50222,2024,7,7,0,0,100,176929,2107,96
50225,2024,2,2,0,0,100,109500,976,110
50228,2024,16,16,0,0,100,187338,1644,114
50229,2024,1,1,0,0,100,150000,1596,94
50230,2024,13,13,0,0,100,237208,1843,128
50231,2024,17,16,1,6,94,238600,2909,83
50232,2024,7,7,0,0,100,138786,1424,98
50233,2024,2,2,0,0,100,199000,2071,104
50234,2024,5,5,0,0,100,110640,1321,76
50235,2024,2,2,0,0,100,196105,1556,132
50236,2024,53,52,1,2,98,169336,2015,87
50237,2024,18,18,0,0,100,121509,1364,89
50238,2024,5,5,0,0,100,154800,1731,92
50239,2024,18,18,0,0,100,141622,1210,116
50240,2024,3,3,0,0,100,294000,3279,103
50241,2024,2,2,0,0,100,237500,1612,148
50243,2024,7,7,0,0,100,242986,2416,98
50246,2024,1,1,0,0,100,115000,2300,50
50247,2024,1,1,0,0,100,135000,1688,80
50251,2024,1,1,0,0,100,178700,1375,130
50252,2024,15,15,0,0,100,172490,1844,96
50253,2024,3,3,0,0,100,404167,3503,143
50256,2024,44,44,0,0,100,137349,1636,87
50258,2024,1,1,0,0,100,150000,1685,89
50259,2024,14,14,0,0,100,162407,1766,98
50260,2024,39,36,3,8,92,109405,1397,89
50261,2024,3,3,0,0,100,186267,1642,113
50262,2024,7,7,0,0,100,140486,1201,109
50263,2024,7,7,0,0,100,95571,1182,80
50266,2024,6,6,0,0,100,175785,1753,98
50267,2024,21,20,1,5,95,158343,2108,80
50268,2024,2,2,0,0,100,85000,1427,65
50269,2024,2,2,0,0,100,85500,1000,86
50270,2024,7,7,0,0,100,206571,2075,98
50271,2024,2,2,0,0,100,123920,868,134
50272,2024,33,32,1,3,97,205090,2305,92
50273,2024,13,13,0,0,100,115135,1252,100
50274,2024,11,11,0,0,100,86613,1283,74
50275,2024,2,2,0,0,100,180000,2545,80
50276,2024,2,2,0,0,100,104096,1222,70
50277,2024,5,5,0,0,100,196340,2283,92
50278,2024,2,2,0,0,100,155606,1510,108
50279,2024,2,2,0,0,100,114000,1292,89
50281,2024,7,7,0,0,100,162143,1816,92
50282,2024,1,1,0,0,100,67331,1202,56
50285,2024,3,3,0,0,100,83333,1208,72
50288,2024,11,11,0,0,100,144955,1995,78
50289,2024,4,4,0,0,100,114375,2054,65
50290,2024,5,5,0,0,100,128800,1009,132
50291,2024,3,3,0,0,100,86667,975,89
50292,2024,34,34,0,0,100,184370,1960,98
50294,2024,12,12,0,0,100,202500,2399,86
50295,2024,2,2,0,0,100,95000,623,167
50296,2024,2,2,0,0,100,372410,2192,128
50297,2024,7,7,0,0,100,164000,1444,106
50298,2024,6,6,0,0,100,151750,1610,94
50299,2024,1,1,0,0,100,205000,2470,83
50300,2024,5,5,0,0,100,92083,1008,90
50302,2024,3,3,0,0,100,155833,1588,102
50304,2024,2,2,0,0,100,96000,1048,106
50305,2024,9,9,0,0,100,224444,2131,107
50310,2024,6,6,0,0,100,118032,1237,92
50311,2024,1,1,0,0,100,225000,2961,76
50312,2024,4,4,0,0,100,95500,1075,93
50315,2024,4,4,0,0,100,135438,1814,78
50317,2024,4,4,0,0,100,177498,1719,108
50321,2024,5,5,0,0,100,267700,1644,155
50324,2024,2,2,0,0,100,105000,799,118
50326,2024,6,6,0,0,100,76833,946,81
50327,2024,1,1,0,0,100,271000,1856,146
50328,2024,9,9,0,0,100,135161,1223,113
50332,2024,12,11,1,8,92,246766,2529,103
50334,2024,4,4,0,0,100,99500,926,108
50335,2024,8,8,0,0,100,197012,2008,106
50336,2024,3,3,0,0,100,117667,2382,65
50338,2024,10,10,0,0,100,88519,1026,90
50340,2024,3,3,0,0,100,127667,1537,83
50341,2024,15,15,0,0,100,163430,1909,91
50342,2024,11,11,0,0,100,212715,2345,122
50345,2024,9,9,0,0,100,196429,1684,117
50347,2024,3,3,0,0,100,141000,1131,129
50349,2024,27,25,2,7,93,263440,2341,121
50350,2024,8,8,0,0,100,136875,1500,91
50351,2024,1,1,0,0,100,208900,1393,150
50352,2024,3,3,0,0,100,150310,1517,101
50356,2024,15,15,0,0,100,147773,1466,105
50357,2024,3,3,0,0,100,99833,1120,91
50359,2024,45,34,11,24,76,91164,1106,81
50360,2024,1,1,0,0,100,180000,3600,50
50361,2024,4,4,0,0,100,171200,2467,77
50362,2024,6,6,0,0,100,90833,1069,86
50363,2024,14,14,0,0,100,158188,1440,106
50364,2024,6,6,0,0,100,132283,1259,97
50365,2024,3,3,0,0,100,250000,2433,101
50368,2024,1,1,0,0,100,45500,758,60
50369,2024,4,4,0,0,100,145388,1601,93
50370,2024,6,6,0,0,100,154466,1835,88
50371,2024,7,7,0,0,100,86000,1162,80
50372,2024,4,4,0,0,100,105380,1514,66
50373,2024,2,2,0,0,100,207500,1677,126
50376,2024,5,5,0,0,100,251446,1822,137
50378,2024,13,13,0,0,100,122675,1239,101
50379,2024,2,2,0,0,100,135000,1387,96
50382,2024,3,3,0,0,100,269867,2403,114
50387,2024,2,2,0,0,100,141250,1708,80
50388,2024,13,13,0,0,100,204962,2068,122
50389,2024,2,2,0,0,100,128250,1238,104
50390,2024,5,5,0,0,100,144800,1431,109
50391,2024,24,24,0,0,100,183518,2982,76
50393,2024,25,25,0,0,100,134282,1292,105
50394,2024,31,31,0,0,100,113770,1341,89
50395,2024,4,4,0,0,100,159775,1870,90
50397,2024,3,3,0,0,100,101378,948,111
50398,2024,2,2,0,0,100,242500,1783,132
50399,2024,5,5,0,0,100,185400,1446,125
50400,2024,50,50,0,0,100,159713,1767,100
50401,2024,5,5,0,0,100,244800,2399,103
50402,2024,24,24,0,0,100,277570,2468,115
50403,2024,39,39,0,0,100,228132,2505,99
50405,2024,9,9,0,0,100,134973,1682,96
50407,2024,8,8,0,0,100,131625,1484,89
50408,2024,5,5,0,0,100,164278,2025,82
50409,2024,22,19,3,14,86,132184,1483,90
50410,2024,65,58,7,11,89,131109,1531,88
50411,2024,11,11,0,0,100,187842,1945,101
50412,2024,60,60,0,0,100,253448,2682,102
50413,2024,4,4,0,0,100,107000,1265,92
50417,2024,40,38,2,5,95,210543,2309,95
50419,2024,26,26,0,0,100,207113,1816,108
50420,2024,6,6,0,0,100,135750,1495,88
50421,2024,5,5,0,0,100,245180,2905,84
50422,2024,3,3,0,0,100,140000,1550,92
50423,2024,3,3,0,0,100,180333,1562,117
50425,2024,16,16,0,0,100,187494,1960,101
50426,2024,7,7,0,0,100,118543,1673,72
50428,2024,13,13,0,0,100,103713,1185,93
50429,2024,12,12,0,0,100,272536,3325,96
50430,2024,1,1,0,0,100,234500,1846,127
50431,2024,22,22,0,0,100,154257,1473,110
50433,2024,11,11,0,0,100,364771,3696,97
50435,2024,5,5,0,0,100,174000,1815,96
50436,2024,16,16,0,0,100,98860,1030,100
50437,2024,12,12,0,0,100,114967,1287,92
50442,2024,5,5,0,0,100,213400,2182,96
50443,2024,7,7,0,0,100,100429,1390,71
50444,2024,30,30,0,0,100,155268,1473,105
50445,2024,5,5,0,0,100,157300,1150,131
50446,2024,4,4,0,0,100,162592,1722,102
50447,2024,6,6,0,0,100,333888,3138,101
50448,2024,15,15,0,0,100,142384,1456,101
50450,2024,5,5,0,0,100,103840,1139,93
50451,2024,2,2,0,0,100,225000,2078,110
50452,2024,13,13,0,0,100,110000,1437,84
50453,2024,12,12,0,0,100,158675,1584,108
50454,2024,4,4,0,0,100,192658,1556,112
50455,2024,11,11,0,0,100,151864,1412,109
50456,2024,8,8,0,0,100,99722,1028,96
50457,2024,2,2,0,0,100,121500,1342,97
50461,2024,1,1,0,0,100,215000,1693,127
50462,2024,4,4,0,0,100,45000,882,51
50463,2024,12,12,0,0,100,128778,1253,110
50464,2024,8,8,0,0,100,157904,1578,100
50467,2024,4,4,0,0,100,145000,1693,85
50468,2024,9,8,1,11,89,122833,988,131
50469,2024,3,3,0,0,100,164333,1608,106
50471,2024,8,8,0,0,100,143125,3412,46
50472,2024,3,3,0,0,100,110333,1276,81
50473,2024,4,4,0,0,100,171138,1474,120
50474,2024,5,5,0,0,100,89848,1388,64
50475,2024,12,12,0,0,100,183748,1673,112
50476,2024,2,2,0,0,100,102250,1164,90
50478,2024,3,3,0,0,100,167000,2626,79
50479,2024,1,1,0,0,100,170000,1954,87
50480,2024,9,9,0,0,100,186956,2092,91
50481,2024,25,25,0,0,100,218308,2738,85
50482,2024,2,2,0,0,100,175100,1486,123
50483,2024,9,9,0,0,100,205644,1877,113
50484,2024,78,72,6,8,92,144377,1550,92
50486,2024,6,6,0,0,100,162250,1692,97
50487,2024,48,47,1,2,98,123195,1427,88
50488,2024,4,4,0,0,100,188475,1563,127
50489,2024,5,5,0,0,100,149500,1559,93
50490,2024,9,8,1,11,89,268539,3425,90
50491,2024,6,6,0,0,100,177792,1608,115
50492,2024,29,29,0,0,100,137930,1304,104
50493,2024,13,13,0,0,100,200732,1886,107
50496,2024,10,8,2,20,80,230888,2459,88
50498,2024,12,12,0,0,100,210810,1952,110
50499,2024,9,9,0,0,100,138722,1321,98
50500,2024,9,9,0,0,100,134847,1372,90
50502,2024,244,124,120,49,51,125976,1601,78
50504,2024,6,6,0,0,100,91317,879,101
50505,2024,10,10,0,0,100,189300,1792,105
50506,2024,7,7,0,0,100,182731,2299,85
50507,2024,10,10,0,0,100,150925,1903,86
50509,2024,7,7,0,0,100,154143,1608,98
50510,2024,7,7,0,0,100,158871,1854,83
50511,2024,2,2,0,0,100,165850,1510,130
50512,2024,5,5,0,0,100,189580,1742,106
50513,2024,3,3,0,0,100,103833,1378,85
50514,2024,7,7,0,0,100,151571,1866,92
50517,2024,2,2,0,0,100,243500,1791,140
50518,2024,6,6,0,0,100,119667,1222,96
50519,2024,5,5,0,0,100,240072,1963,120
50521,2024,1,1,0,0,100,118800,1485,80
50522,2024,4,4,0,0,100,174250,2087,84
50523,2024,52,52,0,0,100,169924,1976,90
50525,2024,8,8,0,0,100,108978,1077,104
50528,2024,3,3,0,0,100,103500,1836,63
50529,2024,1,1,0,0,100,72750,3464,21
50531,2024,11,11,0,0,100,138509,1519,91
50532,2024,98,70,28,29,71,300511,3631,85
50533,2024,4,4,0,0,100,105888,1570,66
50535,2024,13,13,0,0,100,130308,1449,86
50536,2024,3,3,0,0,100,140000,1685,83
50537,2024,6,6,0,0,100,247275,2591,102
50538,2024,5,5,0,0,100,209100,1595,129
50539,2024,16,15,1,6,94,144712,1736,81
50540,2024,4,4,0,0,100,168318,1861,86
50541,2024,14,14,0,0,100,220900,2499,93
50542,2024,10,10,0,0,100,150635,1916,100
50543,2024,8,8,0,0,100,175439,2115,84
50546,2024,42,42,0,0,100,150895,1513,103
50548,2024,7,7,0,0,100,169362,1915,94
50549,2024,8,8,0,0,100,252394,2244,108
50550,2024,39,39,0,0,100,147039,1409,103
50551,2024,19,19,0,0,100,151912,1528,104
50552,2024,1,1,0,0,100,85000,726,117
50553,2024,3,3,0,0,100,96000,1129,107
50554,2024,12,12,0,0,100,318588,2852,122
50556,2024,6,6,0,0,100,140117,1508,97
50562,2024,29,27,2,7,93,252317,2459,106
50563,2024,4,4,0,0,100,70872,831,94
50564,2024,20,20,0,0,100,145425,1340,111
50565,2024,25,23,2,8,92,207843,2182,102
50567,2024,11,11,0,0,100,183491,1885,108
50568,2024,9,9,0,0,100,177100,1571,115
50569,2024,3,3,0,0,100,142500,1291,116
50570,2024,9,9,0,0,100,111522,1482,86
50571,2024,1,1,0,0,100,20000,500,40
50572,2024,4,4,0,0,100,231750,1933,118
50574,2024,3,3,0,0,100,74167,996,76
50575,2024,6,6,0,0,100,259086,2536,95
50576,2024,13,9,4,31,69,194491,3481,66
50577,2024,3,3,0,0,100,177667,3570,60
50579,2024,10,10,0,0,100,225120,1759,122
50580,2024,4,4,0,0,100,267750,1774,164
50582,2024,51,50,1,2,98,115482,1307,88
50584,2024,4,4,0,0,100,261750,2048,128
50585,2024,15,15,0,0,100,220867,2270,105
50588,2024,4,4,0,0,100,248975,2560,117
50589,2024,5,5,0,0,100,130600,1305,94
50590,2024,5,5,0,0,100,169086,1553,105
50591,2024,27,27,0,0,100,118593,1209,101
50592,2024,20,20,0,0,100,130148,1315,109
50593,2024,5,5,0,0,100,98730,1282,83
50594,2024,7,7,0,0,100,267659,2458,112
50596,2024,2,2,0,0,100,233260,2056,112
50597,2024,21,21,0,0,100,145485,1844,87
50598,2024,2,2,0,0,100,80800,1162,60
50599,2024,15,15,0,0,100,266017,2083,126
50601,2024,58,57,1,2,98,160789,1571,108
50603,2024,12,12,0,0,100,296930,2429,124
50604,2024,11,11,0,0,100,215264,2141,103
50606,2024,7,7,0,0,100,151557,1190,130
50607,2024,1,1,0,0,100,50000,407,123
50609,2024,3,3,0,0,100,148333,2182,66
50610,2024,1,1,0,0,100,115000,1065,108
50612,2024,11,11,0,0,100,308987,3101,115
50613,2024,2,2,0,0,100,224500,2616,86
50615,2024,64,53,11,17,83,207476,2341,91
50616,2024,16,16,0,0,100,267670,2165,122
50617,2024,5,5,0,0,100,129703,1694,80
50618,2024,2,2,0,0,100,188200,1614,120
50619,2024,11,11,0,0,100,193765,2104,98
50624,2024,2,2,0,0,100,266000,1636,162
50626,2024,6,6,0,0,100,117738,1414,83
50629,2024,14,14,0,0,100,122095,1281,98
50633,2024,3,3,0,0,100,233500,3307,89
50634,2024,4,4,0,0,100,154500,1624,96
50637,2024,8,8,0,0,100,105402,1080,98
50639,2024,63,59,4,6,94,136185,1694,87
50641,2024,11,11,0,0,100,143865,1206,123
50643,2024,10,10,0,0,100,198592,2366,86
50647,2024,17,17,0,0,100,306103,2821,114
50648,2024,4,4,0,0,100,157450,2116,80
51001,2024,3,2,1,33,67,136167,1021,136
51002,2024,14,13,1,7,93,183057,1659,114
51003,2024,4,4,0,0,100,158570,1644,96
51005,2024,3,3,0,0,100,199000,1290,153
51006,2024,1,1,0,0,100,71000,724,98
51007,2024,7,7,0,0,100,222971,2019,108
51008,2024,2,2,0,0,100,159550,1422,110
51009,2024,10,10,0,0,100,110710,1414,80
51010,2024,2,2,0,0,100,80250,1260,59
51013,2024,1,1,0,0,100,350000,2059,170
51014,2024,3,3,0,0,100,200548,3117,85
51015,2024,2,2,0,0,100,87500,963,98
51016,2024,3,3,0,0,100,115000,1205,100
51017,2024,1,1,0,0,100,206400,1042,198
51018,2024,7,6,1,14,86,215857,1663,124
51022,2024,3,3,0,0,100,116583,1419,83
51023,2024,4,4,0,0,100,187360,1405,133
51025,2024,9,8,1,11,89,172189,1756,107
51027,2024,7,7,0,0,100,149857,1186,134
51028,2024,8,8,0,0,100,219042,2076,100
51029,2024,6,5,1,17,83,187572,1945,88
51030,2024,51,43,8,16,84,171160,1726,100
51031,2024,1,1,0,0,100,256770,1834,140
51032,2024,5,5,0,0,100,214000,1533,139
51033,2024,4,3,1,25,75,147925,832,203
51035,2024,4,4,0,0,100,152875,1248,128
51036,2024,6,6,0,0,100,130417,1502,91
51037,2024,7,7,0,0,100,200429,1686,117
51038,2024,1,1,0,0,100,397000,2377,167
51040,2024,3,3,0,0,100,119500,877,166
51041,2024,1,1,0,0,100,205000,1847,111
51042,2024,7,7,0,0,100,128700,1174,100
51043,2024,23,23,0,0,100,219984,1950,113
51044,2024,9,9,0,0,100,250478,2457,104
51045,2024,2,2,0,0,100,172500,3083,60
51046,2024,9,9,0,0,100,274651,2525,112
51048,2024,2,2,0,0,100,135700,1463,94
51049,2024,4,4,0,0,100,183605,1770,104
51050,2024,2,2,0,0,100,153500,1832,93
51051,2024,3,3,0,0,100,301407,2120,142
51052,2024,5,5,0,0,100,292082,2506,123
51054,2024,9,8,1,11,89,143651,1537,96
51055,2024,106,83,23,22,78,230334,2562,92
51056,2024,6,6,0,0,100,142932,1408,102
51057,2024,2,2,0,0,100,165250,1220,112
51058,2024,35,15,20,57,43,305600,3640,85
51059,2024,5,5,0,0,100,151466,1511,98
51060,2024,1,1,0,0,100,140000,1414,99
51061,2024,2,1,1,50,50,297545,2512,118
51062,2024,2,2,0,0,100,132250,1037,127
51065,2024,7,7,0,0,100,177857,1461,128
51066,2024,2,2,0,0,100,209025,1534,132
51068,2024,2,2,0,0,100,90500,1072,83
51070,2024,1,1,0,0,100,110000,1236,89
51071,2024,3,3,0,0,100,107000,1600,74
51072,2024,2,2,0,0,100,311700,2322,138
51073,2024,1,1,0,0,100,171100,2139,80
51074,2024,18,16,2,11,89,217128,2262,103
51075,2024,12,12,0,0,100,234017,2426,100
51076,2024,5,5,0,0,100,179164,1976,90
51077,2024,1,1,0,0,100,202000,2061,98
51078,2024,4,4,0,0,100,170242,1954,92
51079,2024,13,13,0,0,100,182551,1785,106
51080,2024,3,3,0,0,100,151517,1486,104
51081,2024,5,5,0,0,100,191100,1976,101
51082,2024,1,1,0,0,100,78500,604,130
51084,2024,1,1,0,0,100,150000,777,193
51085,2024,2,2,0,0,100,114000,1466,76
51087,2024,1,1,0,0,100,256750,1646,156
51088,2024,2,2,0,0,100,229000,1970,116
51090,2024,3,3,0,0,100,76667,676,108
51092,2024,7,7,0,0,100,102129,1304,82
51093,2024,3,3,0,0,100,244724,2842,88
51094,2024,1,1,0,0,100,258150,1062,243
51099,2024,2,2,0,0,100,56000,852,66
51100,2024,2,2,0,0,100,143000,1404,100
51101,2024,8,8,0,0,100,277475,2821,102
51102,2024,1,1,0,0,100,136000,2566,53
51103,2024,5,5,0,0,100,93600,1333,83
51104,2024,3,3,0,0,100,75667,859,83
51105,2024,18,18,0,0,100,355657,3075,119
51106,2024,2,2,0,0,100,168250,1330,128
51107,2024,4,4,0,0,100,144312,1632,94
51108,2024,431,182,249,58,42,130963,1603,80
51109,2024,2,2,0,0,100,337500,2138,145
51110,2024,1,1,0,0,100,147000,891,165
51111,2024,2,2,0,0,100,302700,2583,121
51112,2024,3,3,0,0,100,289667,1545,191
51113,2024,5,5,0,0,100,186067,1293,142
51115,2024,4,4,0,0,100,289150,4157,80
51116,2024,2,2,0,0,100,128813,1636,84
51117,2024,1,1,0,0,100,275000,1846,149
51118,2024,10,10,0,0,100,404310,3032,128
51119,2024,4,4,0,0,100,317725,2632,122
51120,2024,2,2,0,0,100,367500,3008,122
51127,2024,1,1,0,0,100,50000,633,79
51129,2024,2,2,0,0,100,147250,1675,88
51130,2024,2,2,0,0,100,105000,1149,94
51132,2024,1,1,0,0,100,69500,724,96
51134,2024,2,2,0,0,100,96750,1333,76
51135,2024,4,4,0,0,100,142618,1853,78
51136,2024,8,7,1,12,88,150607,1617,91
51137,2024,4,4,0,0,100,91500,1347,64
51138,2024,1,1,0,0,100,20000,364,55
51140,2024,1,1,0,0,100,75000,605,124
51141,2024,5,5,0,0,100,186886,1545,128
51142,2024,1,1,0,0,100,290000,1160,250
51144,2024,6,6,0,0,100,105167,1148,89
51145,2024,6,6,0,0,100,418515,3012,127
51147,2024,1,1,0,0,100,149250,1716,87
51148,2024,3,3,0,0,100,173333,1760,102
51149,2024,4,4,0,0,100,135638,1348,90
51150,2024,1,1,0,0,100,158000,1436,110
51151,2024,3,3,0,0,100,143667,1333,106
51152,2024,4,3,1,25,75,254520,2017,124
51153,2024,13,13,0,0,100,294003,2979,98
51154,2024,2,2,0,0,100,101500,718,121
51155,2024,4,4,0,0,100,99450,1100,88
51157,2024,3,3,0,0,100,147013,1300,108
51158,2024,4,4,0,0,100,135588,863,146
51160,2024,8,8,0,0,100,181335,1657,116
51161,2024,9,9,0,0,100,178589,1721,104
51162,2024,6,6,0,0,100,111967,1513,75
51163,2024,3,3,0,0,100,158333,1364,122
51165,2024,8,7,1,12,88,136062,1145,117
51166,2024,1,1,0,0,100,195000,1857,105
51167,2024,1,1,0,0,100,92300,832,111
51169,2024,1,1,0,0,100,144500,1003,144
51171,2024,13,13,0,0,100,243518,2262,110
51172,2024,68,59,9,13,87,247825,2682,96
51173,2024,6,6,0,0,100,191908,1990,97
51174,2024,3,3,0,0,100,215000,2209,88
51176,2024,3,3,0,0,100,184700,1478,130
51177,2024,2,2,0,0,100,417500,3976,105
51179,2024,1,1,0,0,100,200000,2500,80
51181,2024,6,6,0,0,100,578667,2922,185
51182,2024,4,4,0,0,100,96675,1376,74
51183,2024,9,8,1,11,89,292130,2389,123
51184,2024,1,1,0,0,100,50000,1064,47
51185,2024,6,6,0,0,100,167333,1714,104
51186,2024,1,1,0,0,100,300000,4167,72
51187,2024,4,4,0,0,100,217962,2038,108
51188,2024,3,3,0,0,100,346700,2525,135
51190,2024,1,1,0,0,100,221000,2167,102
51192,2024,5,5,0,0,100,245895,1470,153
51193,2024,19,19,0,0,100,197763,1717,127
51194,2024,5,5,0,0,100,253540,1998,125
51195,2024,4,4,0,0,100,136500,1400,97
51196,2024,6,6,0,0,100,216756,1754,132
51197,2024,1,1,0,0,100,80000,909,88
51198,2024,2,2,0,0,100,278300,2770,122
51199,2024,5,5,0,0,100,167570,1576,110
51200,2024,2,2,0,0,100,108000,1424,76
51201,2024,1,1,0,0,100,230550,1830,126
51202,2024,9,8,1,11,89,140094,1541,104
51203,2024,1,1,0,0,100,180500,2006,90
51204,2024,27,27,0,0,100,195850,2083,97
51208,2024,2,2,0,0,100,261750,1450,180
51210,2024,10,8,2,20,80,234605,2168,108
51212,2024,1,1,0,0,100,217000,2284,95
51214,2024,3,3,0,0,100,125000,1093,113
51216,2024,2,2,0,0,100,146500,1840,82
51217,2024,30,30,0,0,100,146110,1824,91
51218,2024,2,2,0,0,100,64500,592,109
51219,2024,1,1,0,0,100,52500,505,104
51222,2024,3,3,0,0,100,87333,647,128
51225,2024,1,1,0,0,100,328000,1885,174
51227,2024,2,2,0,0,100,193225,1836,106
51228,2024,1,1,0,0,100,75000,938,80
51229,2024,3,3,0,0,100,52167,734,73
51230,2024,284,114,170,60,40,148856,2064,75
51231,2024,3,3,0,0,100,308413,2265,138
51232,2024,6,6,0,0,100,239892,1808,130
51233,2024,3,3,0,0,100,127333,1391,97
51234,2024,7,7,0,0,100,152571,1539,97
51235,2024,3,3,0,0,100,114000,1417,84
51236,2024,5,5,0,0,100,138700,1231,113
51237,2024,13,13,0,0,100,141512,1512,104
51238,2024,2,2,0,0,100,201500,996,199
51242,2024,35,30,5,14,86,174163,1830,96
51243,2024,2,2,0,0,100,100500,1226,84
51244,2024,2,2,0,0,100,154500,1490,104
51245,2024,2,2,0,0,100,185850,1912,106
51246,2024,2,2,0,0,100,87500,907,97
51247,2024,1,1,0,0,100,70000,729,96
51248,2024,30,27,3,10,90,92335,1289,85
51249,2024,5,5,0,0,100,264540,4097,77
51250,2024,54,51,3,6,94,181898,1915,97
51251,2024,2,2,0,0,100,239375,1889,122
51252,2024,4,4,0,0,100,97500,1002,100
51254,2024,3,3,0,0,100,73333,949,75
51255,2024,1,1,0,0,100,85000,934,91
51256,2024,3,3,0,0,100,262133,1849,143
51258,2024,1,1,0,0,100,90000,874,103
51260,2024,1,1,0,0,100,194220,1184,164
51262,2024,28,25,3,11,89,101682,1260,80
51263,2024,2,2,0,0,100,151450,1726,88
51264,2024,7,7,0,0,100,181357,1400,154
51265,2024,7,7,0,0,100,128214,1586,83
51266,2024,3,3,0,0,100,299667,2085,150
51267,2024,3,3,0,0,100,216500,2386,92
51269,2024,9,9,0,0,100,127136,3185,41
51270,2024,2,2,0,0,100,126000,974,128
51272,2024,4,4,0,0,100,80350,803,104
51273,2024,1,1,0,0,100,203000,1598,127
51274,2024,1,1,0,0,100,60000,385,156
51275,2024,3,3,0,0,100,158533,1300,116
51276,2024,1,1,0,0,100,136000,1054,129
51277,2024,4,4,0,0,100,123000,1144,94
51278,2024,1,1,0,0,100,100000,685,146
51279,2024,4,4,0,0,100,121625,1288,93
51281,2024,4,4,0,0,100,235000,1951,121
51282,2024,18,17,1,6,94,467108,3346,140
51284,2024,6,6,0,0,100,159142,1377,122
51287,2024,9,6,3,33,67,182900,2631,81
51288,2024,1,1,0,0,100,174500,1662,105
51289,2024,4,4,0,0,100,122125,1487,86
51290,2024,1,1,0,0,100,68000,756,90
51291,2024,16,16,0,0,100,297588,2589,119
51293,2024,5,5,0,0,100,239300,1713,139
51295,2024,2,2,0,0,100,172200,1672,103
51298,2024,5,5,0,0,100,148530,1700,89
51299,2024,1,1,0,0,100,156000,2400,65
51300,2024,1,1,0,0,100,215000,1236,174
51301,2024,2,2,0,0,100,227488,1142,201
51302,2024,2,2,0,0,100,167500,1236,136
51303,2024,6,6,0,0,100,201875,1695,115
51304,2024,1,1,0,0,100,214150,1418,151
51305,2024,2,2,0,0,100,112666,756,174
51308,2024,23,19,4,17,83,222609,2258,100
51311,2024,1,1,0,0,100,109800,1372,80
51312,2024,9,9,0,0,100,181232,1738,103
51313,2024,5,5,0,0,100,140620,1581,91
51314,2024,3,3,0,0,100,129000,1291,99
51316,2024,4,4,0,0,100,76850,1092,66
51318,2024,5,5,0,0,100,220800,1739,129
51319,2024,1,1,0,0,100,80000,667,120
51320,2024,5,5,0,0,100,130106,1391,92
51326,2024,10,10,0,0,100,213107,2033,107
51327,2024,1,1,0,0,100,170000,1349,126
51328,2024,7,7,0,0,100,156636,1605,100
51329,2024,13,13,0,0,100,286970,2472,115
51333,2024,8,8,0,0,100,261935,2369,112
51334,2024,1,1,0,0,100,130000,1711,76
51336,2024,1,1,0,0,100,34500,627,55
51338,2024,6,6,0,0,100,235408,2033,124
51339,2024,2,2,0,0,100,232000,1650,149
51340,2024,3,3,0,0,100,183000,1692,107
51343,2024,10,10,0,0,100,122015,1300,98
51344,2024,16,16,0,0,100,189478,2073,98
51345,2024,3,3,0,0,100,179950,1465,120
51346,2024,12,12,0,0,100,143052,1514,108
51348,2024,1,1,0,0,100,170000,1932,88
51349,2024,2,2,0,0,100,100000,1138,83
51352,2024,6,6,0,0,100,97625,1139,86
51354,2024,1,1,0,0,100,115000,2018,57
51356,2024,2,2,0,0,100,234250,5068,78
51357,2024,8,8,0,0,100,179695,2062,89
51358,2024,4,4,0,0,100,81750,1093,91
51360,2024,4,4,0,0,100,103250,1640,72
51361,2024,2,2,0,0,100,123250,1223,102
51362,2024,13,13,0,0,100,240577,2195,109
51365,2024,9,9,0,0,100,414150,3223,128
51367,2024,9,9,0,0,100,153653,1498,104
51368,2024,1,1,0,0,100,50000,500,100
51369,2024,2,2,0,0,100,217000,2010,108
51370,2024,1,1,0,0,100,150000,1261,119
51371,2024,1,1,0,0,100,60000,455,132
51373,2024,1,1,0,0,100,103000,1084,95
51375,2024,4,4,0,0,100,399462,2932,130
51378,2024,5,5,0,0,100,243400,1819,150
51379,2024,3,3,0,0,100,81667,1201,66
51380,2024,21,20,1,5,95,128452,1498,87
51381,2024,10,5,5,50,50,111050,1519,73
51382,2024,1,1,0,0,100,255000,3750,68
51384,2024,3,3,0,0,100,218799,2428,91
51386,2024,1,1,0,0,100,75000,1500,50
51387,2024,1,1,0,0,100,145795,1012,144
51388,2024,37,36,1,3,97,167981,1640,104
51389,2024,8,8,0,0,100,183138,2291,90
51390,2024,7,7,0,0,100,214643,2107,105
51391,2024,21,19,2,10,90,212403,2143,97
51392,2024,2,2,0,0,100,173500,2806,65
51393,2024,2,2,0,0,100,168000,1971,94
51395,2024,1,1,0,0,100,60000,923,65
51396,2024,1,1,0,0,100,116000,1450,80
51397,2024,1,1,0,0,100,177500,1994,89
51398,2024,2,2,0,0,100,175875,1446,126
51399,2024,2,2,0,0,100,66750,576,115
51402,2024,2,2,0,0,100,144000,1460,98
51403,2024,5,5,0,0,100,242700,1880,125
51404,2024,1,1,0,0,100,156450,1203,130
51406,2024,1,0,1,100,0,107500,1654,65
51407,2024,6,6,0,0,100,150725,1822,90
51409,2024,2,2,0,0,100,174500,1411,122
51410,2024,5,5,0,0,100,177900,1563,125
51413,2024,9,9,0,0,100,170197,2391,94
51414,2024,3,3,0,0,100,113600,1141,90
51415,2024,4,4,0,0,100,138250,1365,102
51416,2024,11,11,0,0,100,72609,907,84
51417,2024,2,2,0,0,100,245000,1197,198
51418,2024,6,6,0,0,100,302292,3248,93
51419,2024,3,3,0,0,100,101000,792,123
51421,2024,3,3,0,0,100,117753,980,116
51422,2024,1,1,0,0,100,170000,1259,135
51423,2024,15,14,1,7,93,83627,979,86
51424,2024,2,2,0,0,100,81900,602,135
51425,2024,3,3,0,0,100,143733,1918,76
51428,2024,3,3,0,0,100,220967,1937,113
51429,2024,2,2,0,0,100,335450,2522,132
51431,2024,15,15,0,0,100,255450,2391,111
51432,2024,10,10,0,0,100,97950,1341,76
51433,2024,3,3,0,0,100,163183,1511,109
51434,2024,7,7,0,0,100,299929,2928,105
51435,2024,1,1,0,0,100,210000,778,270
51436,2024,9,9,0,0,100,152289,1519,106
51437,2024,1,1,0,0,100,350000,2000,175
51439,2024,3,0,3,100,0,130983,1854,76
51440,2024,14,13,1,7,93,185074,2092,88
51442,2024,2,2,0,0,100,45500,594,78
51444,2024,2,2,0,0,100,378100,2390,162
51445,2024,2,2,0,0,100,297138,2144,140
51446,2024,2,2,0,0,100,156750,1670,94
51447,2024,2,2,0,0,100,226740,2273,108
51448,2024,12,12,0,0,100,189686,2076,96
51449,2024,3,3,0,0,100,206833,2242,93
51450,2024,2,2,0,0,100,427500,3054,138
51451,2024,2,2,0,0,100,159100,1284,116
51452,2024,1,1,0,0,100,1021300,5106,200
51453,2024,6,6,0,0,100,312182,2162,147
51454,2024,2166,470,1696,78,22,182916,2698,69
51456,2024,2,2,0,0,100,110750,1483,72
51457,2024,5,5,0,0,100,308490,2068,132
51459,2024,1,1,0,0,100,130000,915,142
51460,2024,3,3,0,0,100,197667,2466,95
51461,2024,9,9,0,0,100,259388,2392,111
51463,2024,1,1,0,0,100,129700,1457,89
51464,2024,4,4,0,0,100,235762,2191,108
51465,2024,1,1,0,0,100,600000,3947,152
51468,2024,4,4,0,0,100,534875,2961,184
51469,2024,1,1,0,0,100,130000,1161,112
51471,2024,2,2,0,0,100,222000,2281,98
51472,2024,6,6,0,0,100,167210,1493,107
51473,2024,1,1,0,0,100,157490,1079,146
51474,2024,23,16,7,30,70,239844,2613,92
51475,2024,1,1,0,0,100,132872,1356,98
51476,2024,6,6,0,0,100,178400,1430,130
51477,2024,6,6,0,0,100,234308,2204,110
51478,2024,4,4,0,0,100,177000,1758,104
51479,2024,2,2,0,0,100,244000,2406,100
51482,2024,4,4,0,0,100,163275,2284,88
51483,2024,3,3,0,0,100,169500,1273,125
51484,2024,1,1,0,0,100,145000,1151,126
51485,2024,2,2,0,0,100,139250,1114,127
51486,2024,2,2,0,0,100,165000,2130,80
51487,2024,3,3,0,0,100,130233,1372,93
51488,2024,3,3,0,0,100,208600,2266,93
51489,2024,1,1,0,0,100,108000,1800,60
51491,2024,2,2,0,0,100,176900,1379,128
51492,2024,21,21,0,0,100,100990,1292,78
51493,2024,5,3,2,40,60,379218,3453,114
51496,2024,2,2,0,0,100,153500,1876,85
51498,2024,1,1,0,0,100,165000,1587,104
51499,2024,1,1,0,0,100,109000,1090,100
51501,2024,2,2,0,0,100,123200,1050,118
51503,2024,1,1,0,0,100,190000,2021,94
51504,2024,12,12,0,0,100,202988,2155,99
51505,2024,6,6,0,0,100,259133,2048,136
51506,2024,44,26,18,41,59,137680,1547,90
51507,2024,45,34,11,24,76,95271,956,102
51509,2024,4,4,0,0,100,133725,1268,102
51510,2024,1,1,0,0,100,95000,1056,90
51511,2024,2,2,0,0,100,144000,1169,135
51512,2024,3,3,0,0,100,243210,2603,94
51513,2024,5,5,0,0,100,111650,1042,105
51514,2024,1,1,0,0,100,72000,986,73
51515,2024,1,1,0,0,100,155000,861,180
51516,2024,1,1,0,0,100,35000,500,70
51518,2024,5,5,0,0,100,310650,2481,128
51521,2024,1,1,0,0,100,172100,1006,171
51522,2024,4,4,0,0,100,155550,1324,118
51524,2024,5,5,0,0,100,141520,1193,127
51525,2024,17,17,0,0,100,219763,2110,106
51526,2024,5,5,0,0,100,113100,1716,73
51527,2024,3,3,0,0,100,149643,1820,98
51529,2024,2,2,0,0,100,201838,2294,88
51530,2024,4,4,0,0,100,191500,2010,96
51531,2024,8,8,0,0,100,99344,907,109
51532,2024,5,5,0,0,100,346534,2807,123
51533,2024,1,1,0,0,100,61500,384,160
51534,2024,3,3,0,0,100,317033,2196,145
51535,2024,48,37,11,23,77,92412,1243,77
51536,2024,19,13,6,32,68,261948,2688,100
51537,2024,2,2,0,0,100,73500,846,74
51542,2024,1,1,0,0,100,176500,1783,99
51544,2024,4,4,0,0,100,92500,1002,88
51545,2024,4,4,0,0,100,103688,1318,78
51546,2024,3,3,0,0,100,116667,1293,88
51548,2024,2,2,0,0,100,202035,2174,93
51549,2024,2,2,0,0,100,116650,1620,78
51550,2024,1,1,0,0,100,113100,877,129
51552,2024,4,4,0,0,100,152700,1342,122
51553,2024,3,3,0,0,100,157983,1817,87
51555,2024,1,1,0,0,100,145000,1450,100
51556,2024,5,5,0,0,100,123570,1236,108
51557,2024,3,3,0,0,100,115000,1508,83
51558,2024,1,1,0,0,100,449200,1996,225
51559,2024,30,30,0,0,100,118335,1355,86
51562,2024,21,19,2,10,90,273191,2614,104
51563,2024,1,1,0,0,100,150000,3571,42
51564,2024,2,2,0,0,100,196500,1622,117
51566,2024,3,3,0,0,100,152350,1423,111
51567,2024,4,4,0,0,100,233000,1371,172
51568,2024,1,1,0,0,100,186000,1860,100
51569,2024,2,2,0,0,100,289980,2672,109
51570,2024,1,1,0,0,100,160000,1250,128
51571,2024,11,11,0,0,100,284143,2260,131
51572,2024,3,3,0,0,100,170103,1626,104
51573,2024,104,57,47,45,55,200844,2418,84
51574,2024,1,1,0,0,100,220000,1350,163
51576,2024,17,17,0,0,100,186965,1776,110
51579,2024,1,1,0,0,100,177000,1106,160
51580,2024,2,2,0,0,100,170375,1786,94
51581,2024,4,4,0,0,100,306700,2110,141
51582,2024,6,6,0,0,100,265233,2213,118
51584,2024,3,3,0,0,100,265467,2483,104
51585,2024,5,5,0,0,100,130820,1622,76
51586,2024,3,3,0,0,100,260667,2119,124
51587,2024,1,1,0,0,100,226450,1903,119
51588,2024,2,2,0,0,100,68750,596,110
51590,2024,2,2,0,0,100,117500,788,160
51591,2024,1,1,0,0,100,195000,2349,83
51592,2024,3,3,0,0,100,48333,896,62
51594,2024,2,2,0,0,100,126250,1124,112
51596,2024,2,2,0,0,100,125500,1264,97
51597,2024,3,3,0,0,100,194500,1894,104
51598,2024,6,6,0,0,100,103512,1282,76
51599,2024,2,2,0,0,100,255500,2182,118
51602,2024,1,1,0,0,100,200000,1538,130
51603,2024,1,1,0,0,100,153000,1594,96
51604,2024,1,1,0,0,100,105000,1129,93
51605,2024,7,7,0,0,100,111643,1333,84
51607,2024,1,1,0,0,100,170000,1848,92
51608,2024,2,2,0,0,100,89250,1027,86
51609,2024,5,5,0,0,100,146540,1605,98
51610,2024,1,1,0,0,100,182000,1701,107
51611,2024,1,1,0,0,100,50000,521,96
51612,2024,28,28,0,0,100,143783,1550,100
51613,2024,10,10,0,0,100,203475,1978,108
51614,2024,9,9,0,0,100,180972,1894,106
51616,2024,1,1,0,0,100,110000,1134,97
51617,2024,10,10,0,0,100,192122,2000,94
51618,2024,3,3,0,0,100,128000,1729,73
51619,2024,1,1,0,0,100,129500,959,135
51620,2024,2,2,0,0,100,177000,977,180
51621,2024,3,3,0,0,100,102367,906,119
51622,2024,2,2,0,0,100,313700,2334,138
51624,2024,6,6,0,0,100,233083,1908,129
51625,2024,6,6,0,0,100,148600,1817,89
51627,2024,2,2,0,0,100,145000,1234,112
51628,2024,1,1,0,0,100,182500,1472,124
51629,2024,7,5,2,29,71,164500,1966,79
51630,2024,6,6,0,0,100,235667,1890,124
51631,2024,2,2,0,0,100,467500,3829,125
51632,2024,3,3,0,0,100,153300,1277,121
51633,2024,4,4,0,0,100,297336,2508,114
51634,2024,3,3,0,0,100,152583,1621,92
51635,2024,1,1,0,0,100,157000,1847,85
51636,2024,6,6,0,0,100,214600,2126,121
51638,2024,2,2,0,0,100,187500,2346,78
51640,2024,3,3,0,0,100,133767,2108,97
51643,2024,9,8,1,11,89,219482,2066,106
51644,2024,5,5,0,0,100,187570,1467,128
51646,2024,2,2,0,0,100,117750,1092,108
51647,2024,5,4,1,20,80,142000,1324,109
51648,2024,4,4,0,0,100,146710,1328,108
51649,2024,112,65,47,42,58,96486,1155,83
51652,2024,1,1,0,0,100,71000,1268,56
51654,2024,2,2,0,0,100,152250,1495,101
51655,2024,1,1,0,0,100,159000,1939,82
51656,2024,1,1,0,0,100,147000,2042,72
51657,2024,1,1,0,0,100,285000,3314,86
51658,2024,2,2,0,0,100,75500,883,86
51659,2024,1,1,0,0,100,82500,616,134
51660,2024,25,25,0,0,100,253981,2320,110
51662,2024,48,39,9,19,81,251667,2515,100
51663,2024,16,9,7,44,56,213039,2446,89
52002,2024,2,2,0,0,100,60720,1088,54
52003,2024,1,1,0,0,100,100753,916,110
52006,2024,4,4,0,0,100,123750,1405,89
52008,2024,7,7,0,0,100,87143,1000,88
52011,2024,1,1,0,0,100,95000,833,114
52013,2024,3,3,0,0,100,45333,678,71
52014,2024,2,2,0,0,100,127000,1030,132
52015,2024,1,1,0,0,100,55000,775,71
52016,2024,2,2,0,0,100,108500,748,148
52017,2024,11,11,0,0,100,160591,1223,115
52022,2024,3,3,0,0,100,130075,811,167
52023,2024,1,1,0,0,100,115000,1173,98
52025,2024,1,1,0,0,100,55000,466,118
52027,2024,1,1,0,0,100,45000,714,63
52029,2024,1,1,0,0,100,132000,1590,83
52031,2024,1,1,0,0,100,279939,1686,166
52033,2024,2,2,0,0,100,78500,638,125
52035,2024,2,2,0,0,100,130000,932,171
52037,2024,4,4,0,0,100,97050,1148,89
52039,2024,1,1,0,0,100,85000,708,120
52040,2024,2,2,0,0,100,69950,770,90
52043,2024,2,2,0,0,100,24450,679,36
52044,2024,6,5,1,17,83,73475,602,119
52045,2024,27,19,8,30,70,108478,1277,84
52047,2024,3,3,0,0,100,48167,869,62
52050,2024,14,14,0,0,100,119564,1070,108
52053,2024,1,1,0,0,100,89500,1209,74
52055,2024,1,1,0,0,100,54000,360,150
52056,2024,2,2,0,0,100,129500,943,124
52058,2024,15,15,0,0,100,125633,1238,102
52059,2024,1,1,0,0,100,39000,929,42
52060,2024,21,19,2,10,90,78175,820,95
52061,2024,2,2,0,0,100,41000,676,65
52062,2024,2,2,0,0,100,189000,1594,94
52064,2024,8,8,0,0,100,61638,674,91
52065,2024,2,2,0,0,100,29500,469,64
52066,2024,1,1,0,0,100,40000,400,100
52070,2024,1,1,0,0,100,334100,2242,149
52072,2024,4,4,0,0,100,123625,1470,86
52074,2024,4,4,0,0,100,69750,632,111
52075,2024,5,5,0,0,100,102460,879,109
52076,2024,4,4,0,0,100,133341,1010,139
52079,2024,11,11,0,0,100,70355,795,91
52083,2024,16,16,0,0,100,83259,902,100
52084,2024,1,1,0,0,100,60000,1000,60
52087,2024,1,1,0,0,100,215000,2389,90
52088,2024,8,8,0,0,100,106188,947,123
52089,2024,1,1,0,0,100,95000,617,154
52093,2024,14,13,1,7,93,99483,922,120
52094,2024,2,2,0,0,100,46250,410,113
52095,2024,1,1,0,0,100,60000,333,180
52099,2024,8,8,0,0,100,97956,1106,85
52102,2024,5,5,0,0,100,216600,1684,106
52103,2024,1,1,0,0,100,25000,595,42
52104,2024,5,5,0,0,100,146780,1293,111
52105,2024,10,10,0,0,100,115948,1862,72
52106,2024,2,2,0,0,100,79000,772,104
52107,2024,5,5,0,0,100,100300,880,114
52108,2024,3,3,0,0,100,119167,1012,112
52113,2024,1,1,0,0,100,263000,1801,146
52114,2024,22,20,2,9,91,121205,1123,120
52116,2024,1,1,0,0,100,190000,1293,147
52118,2024,1,1,0,0,100,199500,1425,140
52119,2024,5,4,1,20,80,130310,965,137
52120,2024,2,2,0,0,100,73500,494,152
52121,2024,201,133,68,34,66,124441,1432,89
52122,2024,3,3,0,0,100,69600,538,127
52123,2024,13,13,0,0,100,117000,1180,97
52124,2024,1,1,0,0,100,63000,685,92
52125,2024,4,4,0,0,100,163740,1732,102
52129,2024,2,2,0,0,100,124078,904,150
52130,2024,3,3,0,0,100,83333,686,128
52132,2024,3,3,0,0,100,70615,864,91
52134,2024,3,3,0,0,100,262333,2015,146
52135,2024,5,5,0,0,100,106716,738,131
52136,2024,5,5,0,0,100,87328,958,94
52137,2024,1,1,0,0,100,70000,875,80
52138,2024,1,1,0,0,100,50000,617,81
52140,2024,7,7,0,0,100,125500,1340,93
52141,2024,2,2,0,0,100,121000,1348,97
52142,2024,1,1,0,0,100,42000,568,74
52145,2024,1,1,0,0,100,112500,1023,110
52146,2024,3,3,0,0,100,120705,1505,102
52147,2024,2,2,0,0,100,132500,1934,76
52151,2024,3,3,0,0,100,73333,970,97
52155,2024,1,1,0,0,100,70000,660,106
52156,2024,4,4,0,0,100,136375,1008,136
52158,2024,3,3,0,0,100,171717,1591,102
52161,2024,1,1,0,0,100,50000,333,150
52162,2024,1,1,0,0,100,120000,1143,105
52163,2024,1,1,0,0,100,47000,560,84
52164,2024,2,2,0,0,100,45100,584,84
52165,2024,1,1,0,0,100,145000,906,160
52167,2024,2,2,0,0,100,91500,1332,68
52171,2024,5,5,0,0,100,71000,548,122
52172,2024,3,3,0,0,100,38000,476,78
52175,2024,2,2,0,0,100,39000,466,82
52177,2024,11,11,0,0,100,92955,898,107
52182,2024,16,15,1,6,94,89630,1157,76
52184,2024,1,1,0,0,100,29500,369,80
52185,2024,1,1,0,0,100,45000,600,75
52187,2024,2,2,0,0,100,88750,892,95
52189,2024,4,4,0,0,100,106750,778,126
52190,2024,2,2,0,0,100,185000,1482,125
52193,2024,4,4,0,0,100,187625,1799,108
52194,2024,29,29,0,0,100,105910,1237,94
52195,2024,1,1,0,0,100,25000,625,40
52197,2024,11,11,0,0,100,80282,942,101
52198,2024,2,2,0,0,100,98000,994,100
52201,2024,1,1,0,0,100,175000,1400,125
52203,2024,1,1,0,0,100,210000,1500,140
52205,2024,4,3,1,25,75,86500,843,86
52206,2024,1,1,0,0,100,110000,1467,75
52208,2024,1,1,0,0,100,46600,582,80
52211,2024,15,15,0,0,100,87312,1147,78
52212,2024,1,1,0,0,100,42037,532,79
52213,2024,4,4,0,0,100,73344,625,122
52214,2024,1,1,0,0,100,41000,477,86
52220,2024,1,1,0,0,100,74203,1016,73
52221,2024,1,1,0,0,100,166000,769,216
52223,2024,1,1,0,0,100,55000,478,115
52227,2024,2,2,0,0,100,107200,865,122
52228,2024,4,4,0,0,100,84125,835,106
52229,2024,1,1,0,0,100,150000,1351,111
52231,2024,2,2,0,0,100,103500,1077,95
52232,2024,1,1,0,0,100,66000,1015,65
52235,2024,5,5,0,0,100,83800,892,96
52237,2024,3,3,0,0,100,64667,702,89
52242,2024,14,14,0,0,100,83928,672,116
52243,2024,3,3,0,0,100,64667,675,104
52244,2024,7,7,0,0,100,124487,1366,94
52245,2024,1,1,0,0,100,50000,417,120
52246,2024,4,4,0,0,100,81750,960,88
52247,2024,1,1,0,0,100,63000,788,80
52248,2024,5,5,0,0,100,134200,1202,111
52249,2024,1,1,0,0,100,57000,792,72
52250,2024,27,23,4,15,85,86016,858,101
52251,2024,6,6,0,0,100,138333,1336,110
52253,2024,1,1,0,0,100,90450,545,166
52254,2024,1,1,0,0,100,159000,1026,155
52257,2024,3,3,0,0,100,111467,780,132
52258,2024,5,5,0,0,100,60200,675,85
52260,2024,1,1,0,0,100,120000,710,169
52264,2024,4,4,0,0,100,147884,1332,115
52265,2024,14,14,0,0,100,123562,1500,83
52267,2024,3,3,0,0,100,300200,1906,162
52269,2024,53,31,22,42,58,116723,1243,91
52271,2024,2,2,0,0,100,51750,498,106
52272,2024,2,2,0,0,100,45000,578,74
52274,2024,3,3,0,0,100,99135,756,132
52278,2024,2,2,0,0,100,88725,636,136
52280,2024,3,3,0,0,100,105667,1252,93
52282,2024,1,1,0,0,100,88000,704,125
52287,2024,2,2,0,0,100,70455,614,116
52289,2024,3,3,0,0,100,108833,1113,101
52290,2024,1,1,0,0,100,55000,753,73
52292,2024,3,3,0,0,100,77567,917,86
52294,2024,6,6,0,0,100,172167,1549,114
52297,2024,4,4,0,0,100,98875,739,132
52298,2024,1,1,0,0,100,88500,962,92
52302,2024,2,2,0,0,100,137250,1134,121
52303,2024,1,1,0,0,100,150000,1071,140
52305,2024,1,1,0,0,100,155000,1667,93
52306,2024,4,4,0,0,100,100140,912,108
52308,2024,1,1,0,0,100,112000,1179,95
52310,2024,1,1,0,0,100,69000,1533,45
52311,2024,3,3,0,0,100,115710,936,122
52313,2024,1,1,0,0,100,100000,1136,88
52315,2024,3,3,0,0,100,163833,1265,129
52318,2024,1,1,0,0,100,50000,667,75
52319,2024,1,1,0,0,100,83000,606,137
52320,2024,2,2,0,0,100,41000,396,104
52322,2024,1,1,0,0,100,48000,600,80
52325,2024,2,2,0,0,100,37250,400,94
52326,2024,2,2,0,0,100,55799,630,81
52327,2024,3,3,0,0,100,168667,1789,96
52328,2024,1,1,0,0,100,55000,647,85
52331,2024,20,20,0,0,100,111575,1244,91
52332,2024,14,12,2,14,86,98750,884,118
52335,2024,1,1,0,0,100,46000,434,106
52336,2024,1,1,0,0,100,62300,649,96
52341,2024,2,2,0,0,100,42250,396,108
52346,2024,2,2,0,0,100,92500,714,126
52347,2024,1,1,0,0,100,84000,1077,78
52348,2024,8,8,0,0,100,135044,1069,139
52349,2024,2,2,0,0,100,138500,1265,108
52350,2024,4,4,0,0,100,56787,671,91
52353,2024,56,51,5,9,91,90960,1062,88
52354,2024,1,1,0,0,100,190000,585,325
52355,2024,1,1,0,0,100,170000,1371,124
52356,2024,2,2,0,0,100,115750,962,92
52358,2024,1,1,0,0,100,169500,1130,150
52359,2024,1,1,0,0,100,143000,1300,110
52360,2024,3,3,0,0,100,124833,1007,138
52363,2024,1,1,0,0,100,50000,333,150
52365,2024,4,4,0,0,100,97375,684,144
52366,2024,1,1,0,0,100,69000,742,93
52369,2024,1,1,0,0,100,107000,1305,82
52370,2024,1,1,0,0,100,35000,479,73
52371,2024,1,1,0,0,100,161000,1917,84
52372,2024,1,1,0,0,100,270000,2077,130
52373,2024,3,3,0,0,100,74333,606,108
52374,2024,3,3,0,0,100,199833,1654,118
52375,2024,1,1,0,0,100,110000,791,139
52377,2024,3,3,0,0,100,103733,749,134
52380,2024,4,4,0,0,100,133125,1092,115
52383,2024,3,3,0,0,100,70017,777,90
52384,2024,3,3,0,0,100,95000,859,110
52386,2024,5,5,0,0,100,117530,1111,106
52388,2024,2,2,0,0,100,42500,964,50
52390,2024,1,1,0,0,100,105000,1250,84
52391,2024,4,4,0,0,100,179000,1873,106
52392,2024,1,1,0,0,100,157000,1006,156
52394,2024,4,4,0,0,100,53888,554,99
52396,2024,1,1,0,0,100,45000,750,60
52398,2024,3,3,0,0,100,63833,697,96
52400,2024,1,1,0,0,100,39875,350,114
52401,2024,5,5,0,0,100,73640,961,78
52403,2024,1,1,0,0,100,190000,1439,132
52405,2024,17,16,1,6,94,117919,1006,114
52406,2024,3,3,0,0,100,101940,655,157
52407,2024,7,7,0,0,100,93500,875,114
52411,2024,14,14,0,0,100,110978,1052,110
52413,2024,2,2,0,0,100,134000,920,141
52414,2024,3,3,0,0,100,111333,1458,76
52419,2024,1,1,0,0,100,101000,697,145
52420,2024,3,3,0,0,100,47333,694,70
52421,2024,4,4,0,0,100,193000,1694,116
52422,2024,2,2,0,0,100,131000,907,154
52423,2024,5,5,0,0,100,110500,1030,110
52424,2024,2,2,0,0,100,52250,862,60
52425,2024,4,4,0,0,100,65125,651,95
52426,2024,4,4,0,0,100,71000,665,114
52428,2024,2,2,0,0,100,127000,1362,98
52429,2024,6,6,0,0,100,119833,1606,74
52431,2024,1,1,0,0,100,85000,914,93
52432,2024,11,11,0,0,100,114546,1087,105
52433,2024,2,2,0,0,100,115518,665,165
52436,2024,1,1,0,0,100,85600,441,194
52438,2024,3,3,0,0,100,61475,803,80
52439,2024,2,2,0,0,100,53300,756,72
52440,2024,1,1,0,0,100,21000,420,50
52442,2024,3,3,0,0,100,218500,1468,155
52443,2024,1,1,0,0,100,90000,1154,78
52444,2024,2,2,0,0,100,75000,1027,72
52446,2024,1,1,0,0,100,50000,625,80
52447,2024,4,4,0,0,100,81750,1210,72
52448,2024,218,152,66,30,70,102865,1204,85
52449,2024,7,7,0,0,100,110214,1338,78
52455,2024,6,6,0,0,100,91500,790,117
52456,2024,7,7,0,0,100,90905,928,111
52457,2024,1,1,0,0,100,189525,1458,130
52461,2024,6,6,0,0,100,132790,1210,113
52464,2024,1,1,0,0,100,70000,579,121
52465,2024,1,1,0,0,100,87750,997,88
52469,2024,4,4,0,0,100,128150,1227,98
52470,2024,9,9,0,0,100,80056,813,96
52472,2024,2,2,0,0,100,100000,950,102
52473,2024,1,1,0,0,100,66000,688,96
52474,2024,1,1,0,0,100,70000,496,141
52475,2024,1,1,0,0,100,167070,1114,150
52479,2024,6,6,0,0,100,114222,1059,113
52480,2024,3,3,0,0,100,123333,1363,90
52483,2024,1,1,0,0,100,139760,799,175
52484,2024,3,3,0,0,100,196333,1562,127
52486,2024,1,1,0,0,100,70000,496,141
52487,2024,1,1,0,0,100,155000,1230,126
52488,2024,1,1,0,0,100,49000,980,50
52490,2024,10,9,1,10,90,106600,1085,104
52491,2024,1,1,0,0,100,54000,482,112
52492,2024,6,6,0,0,100,122888,1545,82
52493,2024,1,1,0,0,100,49600,709,70
52494,2024,2,2,0,0,100,139125,1207,114
52495,2024,1,1,0,0,100,120000,1395,86
52497,2024,1,1,0,0,100,140000,1573,89
52499,2024,1,1,0,0,100,113208,1415,80
52500,2024,7,6,1,14,86,118207,1475,81
52504,2024,2,2,0,0,100,113000,868,137
52506,2024,1,1,0,0,100,55000,331,166
52510,2024,3,3,0,0,100,115000,957,130
52512,2024,5,5,0,0,100,57140,742,78
52514,2024,3,3,0,0,100,147333,1277,131
52517,2024,1,1,0,0,100,92500,1028,90
52520,2024,4,4,0,0,100,88248,1052,84
52522,2024,3,3,0,0,100,117833,1411,81
52525,2024,1,1,0,0,100,65000,722,90
52526,2024,1,1,0,0,100,80000,667,120
52528,2024,3,3,0,0,100,43333,680,67
52529,2024,9,9,0,0,100,108833,1086,96
52534,2024,18,18,0,0,100,152753,1590,98
52535,2024,5,5,0,0,100,121980,1481,84
52536,2024,1,1,0,0,100,141500,852,166
52538,2024,3,3,0,0,100,59667,875,67
52539,2024,1,1,0,0,100,35000,522,67
52541,2024,1,1,0,0,100,223500,1802,124
52544,2024,5,5,0,0,100,109843,1278,92
52545,2024,1,1,0,0,100,100000,1176,85
52546,2024,1,1,0,0,100,39885,443,90
52547,2024,2,2,0,0,100,36000,532,69
52548,2024,1,1,0,0,100,45000,450,100
52550,2024,17,17,0,0,100,105118,1208,92
53001,2024,20,20,0,0,100,184137,1839,105
53002,2024,5,4,1,20,80,111800,1185,92
53003,2024,37,35,2,5,95,113088,1289,88
53005,2024,20,20,0,0,100,122610,1635,84
53007,2024,22,22,0,0,100,182782,1890,100
53008,2024,19,19,0,0,100,159711,1589,100
53009,2024,10,10,0,0,100,142518,1477,98
53010,2024,5,5,0,0,100,108180,1141,108
53011,2024,4,4,0,0,100,191250,1728,111
53012,2024,5,5,0,0,100,134000,1263,108
53013,2024,12,12,0,0,100,74325,887,84
53015,2024,29,29,0,0,100,170741,1577,105
53016,2024,14,14,0,0,100,84280,825,97
53017,2024,12,12,0,0,100,86617,912,91
53018,2024,16,16,0,0,100,185753,1437,134
53019,2024,3,3,0,0,100,99333,740,125
53021,2024,7,7,0,0,100,154035,1323,114
53022,2024,10,10,0,0,100,100850,1135,92
53023,2024,6,6,0,0,100,165503,1528,109
53025,2024,8,8,0,0,100,190702,1661,120
53026,2024,5,5,0,0,100,85880,1392,67
53027,2024,3,3,0,0,100,205000,1668,118
53028,2024,9,9,0,0,100,134711,1424,95
53029,2024,17,17,0,0,100,111351,1123,96
53030,2024,1,1,0,0,100,314400,1747,180
53031,2024,4,4,0,0,100,126460,1214,94
53034,2024,64,64,0,0,100,229782,2245,103
53035,2024,5,5,0,0,100,98871,1509,70
53036,2024,8,8,0,0,100,111450,1109,103
53037,2024,8,8,0,0,100,172000,1823,93
53038,2024,3,3,0,0,100,76000,1552,48
53039,2024,16,16,0,0,100,120788,1320,94
53040,2024,5,5,0,0,100,100623,1070,95
53041,2024,3,3,0,0,100,107667,1122,93
53042,2024,6,6,0,0,100,125088,1657,122
53043,2024,8,8,0,0,100,132700,1189,110
53045,2024,8,8,0,0,100,188100,1866,102
53046,2024,5,5,0,0,100,140200,1443,95
53047,2024,5,5,0,0,100,123260,1197,105
53048,2024,15,15,0,0,100,156200,1731,104
53049,2024,3,3,0,0,100,66000,1125,62
53051,2024,3,3,0,0,100,91667,838,111
53052,2024,4,4,0,0,100,156750,2157,85
53053,2024,8,8,0,0,100,100762,910,112
53054,2024,56,48,8,14,86,230828,2210,105
53055,2024,10,10,0,0,100,113520,1096,105
53056,2024,10,10,0,0,100,243150,1697,147
53057,2024,8,8,0,0,100,84875,1050,84
53058,2024,8,8,0,0,100,109433,1205,87
53059,2024,4,4,0,0,100,195035,1518,135
53061,2024,9,9,0,0,100,94567,1082,86
53062,2024,218,179,39,18,82,179028,1889,95
53063,2024,6,6,0,0,100,203550,1934,114
53064,2024,17,17,0,0,100,99471,1224,87
53066,2024,14,14,0,0,100,112151,1330,82
53067,2024,6,6,0,0,100,108000,1031,100
53068,2024,4,4,0,0,100,109025,888,118
53069,2024,10,10,0,0,100,88750,1135,83
53071,2024,6,6,0,0,100,95667,886,117
53072,2024,14,14,0,0,100,157664,1769,93
53073,2024,8,8,0,0,100,189302,2924,90
53074,2024,8,8,0,0,100,139266,1258,103
53075,2024,2,2,0,0,100,161000,1062,154
53076,2024,6,6,0,0,100,71667,885,76
53077,2024,33,33,0,0,100,138142,1348,108
53078,2024,9,9,0,0,100,179111,1508,118
53079,2024,9,9,0,0,100,99311,1094,102
53080,2024,2,2,0,0,100,54900,828,72
53082,2024,5,5,0,0,100,222780,2082,102
53083,2024,9,9,0,0,100,104444,1086,101
53084,2024,54,54,0,0,100,127129,1447,90
53085,2024,4,4,0,0,100,142000,1424,100
53086,2024,9,9,0,0,100,105738,1182,88
53087,2024,2,2,0,0,100,51500,594,86
53088,2024,8,8,0,0,100,148106,1626,100
53089,2024,8,8,0,0,100,191862,1673,108
53090,2024,2,2,0,0,100,90000,1406,66
53091,2024,10,10,0,0,100,89568,1184,91
53093,2024,6,6,0,0,100,82750,1007,83
53094,2024,13,13,0,0,100,171742,2142,94
53096,2024,78,76,2,3,97,115918,1314,90
53097,2024,93,86,7,8,92,133238,1549,90
53098,2024,4,4,0,0,100,183125,2353,74
53099,2024,12,12,0,0,100,168218,1828,102
53100,2024,21,20,1,5,95,119347,1262,99
53101,2024,8,8,0,0,100,159809,1317,121
53102,2024,2,2,0,0,100,90000,1004,90
53103,2024,24,23,1,4,96,168996,1632,105
53104,2024,11,11,0,0,100,196573,1969,97
53105,2024,2,2,0,0,100,167000,1682,100
53106,2024,6,6,0,0,100,101167,941,110
53107,2024,42,41,1,2,98,98614,1049,95
53108,2024,6,6,0,0,100,193698,1523,132
53109,2024,6,6,0,0,100,115458,1220,93
53110,2024,12,12,0,0,100,159010,2084,96
53111,2024,4,4,0,0,100,132450,1478,87
53112,2024,6,6,0,0,100,106167,1374,82
53113,2024,7,7,0,0,100,115571,1241,102
53114,2024,3,3,0,0,100,70333,746,102
53115,2024,6,6,0,0,100,145950,1374,100
53116,2024,7,7,0,0,100,115714,1106,111
53117,2024,3,3,0,0,100,168375,1333,117
53118,2024,2,2,0,0,100,172500,1943,89
53119,2024,47,41,6,13,87,233014,2146,109
53120,2024,12,12,0,0,100,66375,990,63
53121,2024,20,20,0,0,100,83723,1020,84
53122,2024,10,10,0,0,100,149512,1222,108
53123,2024,26,26,0,0,100,113562,1393,83
53124,2024,18,18,0,0,100,127263,1192,110
53125,2024,12,12,0,0,100,105700,1116,94
53126,2024,21,21,0,0,100,104714,1165,92
53127,2024,36,36,0,0,100,170373,1631,111
53128,2024,6,6,0,0,100,174058,1416,104
53129,2024,5,5,0,0,100,176800,1881,97
53130,2024,642,323,319,50,50,170284,2161,79
53131,2024,1,1,0,0,100,60000,682,88
53132,2024,7,7,0,0,100,108143,1014,104
53133,2024,14,14,0,0,100,91521,1047,89
53134,2024,1,1,0,0,100,168000,1768,95
53135,2024,5,5,0,0,100,163600,1501,120
53136,2024,11,10,1,9,91,212828,1857,115
53137,2024,25,25,0,0,100,185740,2017,99
53139,2024,6,6,0,0,100,125917,1313,102
53140,2024,33,30,3,9,91,163909,1867,89
53141,2024,15,15,0,0,100,157441,1677,97
53142,2024,10,10,0,0,100,106812,1702,78
53143,2024,2,2,0,0,100,201054,1973,103
53144,2024,8,8,0,0,100,110050,1070,99
53145,2024,7,7,0,0,100,162499,1414,105
53146,2024,18,18,0,0,100,137928,1387,98
53147,2024,148,116,32,22,78,139684,1628,88
53148,2024,1,1,0,0,100,70179,536,131
53150,2024,9,9,0,0,100,186278,1641,113
53151,2024,16,16,0,0,100,117000,1342,90
53152,2024,26,26,0,0,100,130867,1505,88
53153,2024,5,5,0,0,100,113600,1204,94
53154,2024,15,15,0,0,100,93390,1161,82
53155,2024,16,16,0,0,100,115294,1090,102
53156,2024,2,2,0,0,100,133250,1205,114
53157,2024,8,8,0,0,100,202252,1834,110
53158,2024,18,18,0,0,100,119803,1340,92
53160,2024,6,6,0,0,100,91105,828,100
53161,2024,36,36,0,0,100,119731,1399,88
53162,2024,13,10,3,23,77,168423,2202,80
53163,2024,7,7,0,0,100,78766,1065,72
53164,2024,6,6,0,0,100,112667,938,124
53168,2024,20,20,0,0,100,126090,1428,88
53169,2024,4,4,0,0,100,116500,1314,93
53170,2024,14,13,1,7,93,89537,1006,87
53172,2024,2,2,0,0,100,257200,2277,116
53173,2024,4,4,0,0,100,87550,932,98
53174,2024,6,6,0,0,100,209675,1824,117
53175,2024,15,15,0,0,100,178567,1696,106
53176,2024,9,9,0,0,100,83278,791,107
53178,2024,2,2,0,0,100,373750,2119,165
53179,2024,4,4,0,0,100,111925,1201,110
53180,2024,6,6,0,0,100,158750,1398,112
53181,2024,12,12,0,0,100,149333,1286,116
53182,2024,29,29,0,0,100,131449,1522,87
53184,2024,2,2,0,0,100,300000,1438,195
53185,2024,36,34,2,6,94,103685,1032,101
53186,2024,24,24,0,0,100,132358,1474,95
53187,2024,3,3,0,0,100,173017,1838,100
53188,2024,39,39,0,0,100,94557,1057,87
53189,2024,1,1,0,0,100,380000,9500,40
53190,2024,4,4,0,0,100,80250,1160,66
53191,2024,3,3,0,0,100,74500,1232,56
53192,2024,3,3,0,0,100,112667,1468,76
53193,2024,2,2,0,0,100,288310,2180,116
53195,2024,3,3,0,0,100,237333,1893,121
53196,2024,3,3,0,0,100,74000,668,109
53197,2024,9,9,0,0,100,116769,1202,97
53198,2024,3,3,0,0,100,113167,1076,100
53199,2024,3,3,0,0,100,43333,604,74
53200,2024,9,9,0,0,100,137544,1612,85
53201,2024,88,79,9,10,90,199829,2058,98
53202,2024,10,10,0,0,100,72941,733,92
53203,2024,8,8,0,0,100,91211,1351,71
53204,2024,5,5,0,0,100,74990,741,108
53206,2024,5,5,0,0,100,190600,1488,133
53208,2024,3,3,0,0,100,92000,1130,79
53209,2024,7,7,0,0,100,150986,1470,106
53210,2024,11,11,0,0,100,115605,1407,84
53211,2024,25,25,0,0,100,122823,1271,96
53212,2024,6,6,0,0,100,391283,4102,117
53213,2024,10,10,0,0,100,97430,1326,79
53214,2024,2,2,0,0,100,94725,1303,84
53216,2024,17,15,2,12,88,140973,1437,100
53218,2024,9,9,0,0,100,143390,1567,90
53219,2024,14,12,2,14,86,113593,1135,110
53220,2024,4,4,0,0,100,131300,1444,101
53221,2024,10,10,0,0,100,120647,1401,98
53222,2024,3,3,0,0,100,136167,1075,117
53223,2024,5,5,0,0,100,77747,713,106
53224,2024,11,11,0,0,100,183704,1952,93
53225,2024,5,5,0,0,100,153520,1468,95
53226,2024,10,10,0,0,100,127220,1144,107
53228,2024,13,13,0,0,100,134302,1506,95
53229,2024,13,12,1,8,92,196239,1994,101
53230,2024,5,5,0,0,100,78720,1081,71
53232,2024,3,3,0,0,100,138167,1656,85
53233,2024,5,5,0,0,100,93000,916,111
53234,2024,4,4,0,0,100,123864,1446,114
53235,2024,2,2,0,0,100,44500,794,56
53236,2024,5,5,0,0,100,106460,996,125
53237,2024,11,11,0,0,100,116736,1145,101
53238,2024,14,14,0,0,100,122412,1454,91
53240,2024,5,5,0,0,100,218700,1637,135
53242,2024,3,3,0,0,100,81877,800,100
53243,2024,13,13,0,0,100,164898,1586,105
53245,2024,14,14,0,0,100,168582,2090,91
53246,2024,17,17,0,0,100,123844,1305,92
53247,2024,33,33,0,0,100,160415,1835,88
53248,2024,2,2,0,0,100,168500,1644,102
53249,2024,16,16,0,0,100,124394,1195,103
53250,2024,7,7,0,0,100,98839,1330,78
53251,2024,7,7,0,0,100,111550,1010,113
53253,2024,5,5,0,0,100,143240,1401,106
53255,2024,12,12,0,0,100,135450,1350,105
53256,2024,2,2,0,0,100,32500,681,54
53257,2024,3,3,0,0,100,157333,1683,95
53258,2024,9,9,0,0,100,180333,1524,115
53259,2024,3,3,0,0,100,141667,1269,113
53260,2024,5,5,0,0,100,126600,1233,105
53261,2024,1,1,0,0,100,72700,765,95
53262,2024,12,12,0,0,100,147071,1296,114
53263,2024,3,3,0,0,100,105333,1117,92
53264,2024,2,2,0,0,100,114940,1342,90
53265,2024,13,13,0,0,100,106485,1150,94
53266,2024,5,5,0,0,100,108749,1235,82
53267,2024,9,9,0,0,100,136917,1391,100
53269,2024,10,10,0,0,100,116755,1833,72
53270,2024,1,1,0,0,100,28000,519,54
53271,2024,34,32,2,6,94,117786,1225,94
53272,2024,5,5,0,0,100,58400,797,83
53273,2024,10,10,0,0,100,200505,1411,133
53276,2024,13,13,0,0,100,124606,1289,92
54001,2024,5,5,0,0,100,174060,1223,138
54002,2024,4,4,0,0,100,189012,1953,97
54004,2024,2,2,0,0,100,138225,1109,122
54006,2024,5,5,0,0,100,273640,2049,134
54007,2024,4,4,0,0,100,217262,1941,114
54009,2024,1,1,0,0,100,122250,764,160
54010,2024,5,5,0,0,100,137440,1591,88
54011,2024,9,8,1,11,89,171422,1460,113
54012,2024,2,2,0,0,100,198325,2222,124
54014,2024,2,2,0,0,100,64000,846,74
54015,2024,4,4,0,0,100,159500,1412,124
54017,2024,1,1,0,0,100,43000,558,77
54018,2024,2,2,0,0,100,244021,2073,120
54020,2024,6,6,0,0,100,153090,1677,96
54021,2024,1,1,0,0,100,180000,857,210
54022,2024,5,5,0,0,100,233768,1939,121
54023,2024,1,1,0,0,100,131000,1092,120
54024,2024,6,5,1,17,83,168283,1461,115
54025,2024,18,16,2,11,89,242458,2188,116
54026,2024,2,2,0,0,100,128450,1490,98
54027,2024,7,7,0,0,100,215057,1958,117
54028,2024,25,12,13,52,48,93450,1167,79
54029,2024,19,16,3,16,84,210484,1962,108
54030,2024,2,2,0,0,100,81000,685,112
54031,2024,4,4,0,0,100,119125,1380,76
54032,2024,5,4,1,20,80,211645,1933,106
54033,2024,2,1,1,50,50,167675,1220,142
54034,2024,1,1,0,0,100,172900,782,221
54035,2024,3,3,0,0,100,65800,652,112
54036,2024,10,10,0,0,100,323149,2528,128
54037,2024,3,3,0,0,100,273833,2636,102
54038,2024,5,5,0,0,100,162530,1643,99
54039,2024,54,39,15,28,72,107704,1243,90
54040,2024,13,13,0,0,100,64928,812,84
54041,2024,1,1,0,0,100,240000,1739,138
54042,2024,3,3,0,0,100,161627,1569,105
54043,2024,11,8,3,27,73,211050,1891,118
54044,2024,1,1,0,0,100,87000,870,100
54045,2024,7,5,2,29,71,160812,1671,96
54046,2024,2,2,0,0,100,244000,1500,163
54048,2024,3,3,0,0,100,235030,2213,110
54049,2024,9,9,0,0,100,177772,2030,89
54051,2024,7,7,0,0,100,231443,2585,89
54052,2024,3,3,0,0,100,120978,1091,111
54053,2024,2,2,0,0,100,127000,1086,122
54054,2024,18,17,1,6,94,170394,1517,107
54055,2024,5,5,0,0,100,115884,1239,108
54059,2024,10,9,1,10,90,157432,1536,103
54060,2024,18,18,0,0,100,159314,1875,88
54061,2024,7,7,0,0,100,137529,1196,114
54062,2024,4,4,0,0,100,181295,3353,78
54063,2024,3,2,1,33,67,141067,1172,124
54064,2024,8,8,0,0,100,131688,1041,128
54065,2024,16,15,1,6,94,142038,1716,93
54066,2024,4,4,0,0,100,236139,2133,121
54067,2024,9,9,0,0,100,186333,2113,89
54068,2024,1,1,0,0,100,66000,857,77
54069,2024,7,5,2,29,71,225729,2669,81
54070,2024,2,2,0,0,100,215575,1712,126
54071,2024,1,1,0,0,100,50000,526,95
54072,2024,2,2,0,0,100,254075,2428,110
54073,2024,16,16,0,0,100,138179,1359,108
54075,2024,3,3,0,0,100,138800,1565,89
54076,2024,31,31,0,0,100,185141,1883,100
54077,2024,11,11,0,0,100,109309,1119,125
54078,2024,1,1,0,0,100,40000,364,110
54079,2024,31,25,6,19,81,186496,1835,104
54080,2024,16,16,0,0,100,118775,1270,99
54081,2024,3,3,0,0,100,202650,2025,103
54082,2024,1,1,0,0,100,75000,882,85
54083,2024,2,2,0,0,100,87000,1014,86
54084,2024,13,13,0,0,100,136997,1533,88
54085,2024,3,3,0,0,100,105667,1569,81
54086,2024,3,3,0,0,100,101000,1024,102
54089,2024,15,13,2,13,87,253157,2129,119
54090,2024,42,36,6,14,86,206436,2014,104
54091,2024,2,2,0,0,100,169000,1606,118
54092,2024,2,2,0,0,100,92750,1443,70
54093,2024,2,2,0,0,100,179975,1046,146
54094,2024,3,3,0,0,100,207954,1853,111
54096,2024,3,3,0,0,100,230000,2429,96
54098,2024,1,1,0,0,100,250000,1087,230
54099,2024,111,56,55,50,50,161900,1855,85
54100,2024,7,7,0,0,100,254629,1926,139
54102,2024,3,3,0,0,100,132333,1769,83
54103,2024,5,5,0,0,100,148740,1574,97
54104,2024,3,3,0,0,100,194192,1709,112
54105,2024,10,10,0,0,100,98900,919,108
54108,2024,1,1,0,0,100,408500,2742,149
54109,2024,13,13,0,0,100,166077,1909,97
54110,2024,2,2,0,0,100,184100,2246,82
54111,2024,29,23,6,21,79,124315,1791,71
54112,2024,9,9,0,0,100,168396,1739,95
54113,2024,20,20,0,0,100,262393,2237,120
54114,2024,7,5,2,29,71,117014,1228,100
54115,2024,57,34,23,40,60,148668,1802,81
54116,2024,17,16,1,6,94,178612,1680,109
54117,2024,1,1,0,0,100,120000,1081,111
54118,2024,10,9,1,10,90,146050,1736,102
54119,2024,1,1,0,0,100,471700,2204,214
54120,2024,1,1,0,0,100,66000,600,110
54121,2024,2,2,0,0,100,230950,1230,189
54122,2024,2,2,0,0,100,144200,1210,120
54123,2024,14,14,0,0,100,171350,1940,87
54124,2024,1,1,0,0,100,62000,517,120
54125,2024,5,5,0,0,100,149000,1371,109
54126,2024,2,2,0,0,100,253475,1888,133
54127,2024,6,6,0,0,100,231575,2020,118
54128,2024,10,10,0,0,100,129498,1556,81
54129,2024,10,10,0,0,100,75885,821,95
54130,2024,3,3,0,0,100,113073,936,119
54131,2024,1,1,0,0,100,316000,2528,125
54134,2024,3,3,0,0,100,127143,1108,105
54135,2024,11,8,3,27,73,153832,1443,115
54136,2024,35,30,5,14,86,132951,1494,92
54137,2024,5,5,0,0,100,246317,1782,129
54138,2024,31,24,7,23,77,246514,2391,102
54139,2024,1,1,0,0,100,218000,1239,176
54140,2024,2,2,0,0,100,92200,1090,85
54141,2024,2,2,0,0,100,261250,2116,114
54143,2024,3,3,0,0,100,112257,1393,79
54144,2024,1,1,0,0,100,142500,1583,90
54145,2024,4,4,0,0,100,147838,1648,96
54146,2024,2,2,0,0,100,103000,1265,81
54147,2024,1,1,0,0,100,59000,922,64
54148,2024,7,7,0,0,100,203429,1306,151
54149,2024,21,19,2,10,90,253251,2356,106
54150,2024,26,22,4,15,85,148207,1685,90
54151,2024,14,12,2,14,86,213780,2453,92
54152,2024,28,26,2,7,93,166369,1647,103
54154,2024,7,6,1,14,86,98743,948,103
54155,2024,3,3,0,0,100,105597,818,150
54156,2024,7,6,1,14,86,166371,1588,113
54157,2024,63,59,4,6,94,150981,1607,97
54158,2024,2,2,0,0,100,199745,1874,106
54159,2024,95,80,15,16,84,160303,1715,94
54160,2024,6,6,0,0,100,146692,1550,102
54161,2024,3,3,0,0,100,117000,835,127
54162,2024,14,12,2,14,86,130634,1350,108
54163,2024,2,2,0,0,100,208000,1336,154
54164,2024,1,1,0,0,100,126500,973,130
54165,2024,10,10,0,0,100,610666,3856,169
54167,2024,26,24,2,8,92,206270,1913,107
54168,2024,1,1,0,0,100,271000,2221,122
54169,2024,1,1,0,0,100,143000,1192,120
54171,2024,7,6,1,14,86,171886,1796,98
54172,2024,3,3,0,0,100,208483,1759,103
54173,2024,1,1,0,0,100,115000,833,138
54174,2024,39,26,13,33,67,144149,1658,88
54175,2024,3,3,0,0,100,217667,2031,109
54176,2024,12,10,2,17,83,172123,1383,122
54177,2024,2,2,0,0,100,120500,1446,84
54178,2024,1,1,0,0,100,130000,1204,108
54181,2024,8,8,0,0,100,200054,2543,82
54182,2024,5,5,0,0,100,102100,985,96
54184,2024,99,38,61,62,38,172998,2096,83
54185,2024,2,2,0,0,100,53703,536,102
54186,2024,11,10,1,9,91,292012,1818,155
54188,2024,17,16,1,6,94,242824,2062,119
54189,2024,7,7,0,0,100,105179,1080,92
54190,2024,2,2,0,0,100,84000,638,120
54191,2024,3,3,0,0,100,62647,786,64
54192,2024,3,3,0,0,100,151767,1275,112
54193,2024,1,1,0,0,100,190000,1005,189
54194,2024,4,4,0,0,100,194238,1615,119
54195,2024,2,2,0,0,100,310825,2354,125
54196,2024,8,8,0,0,100,197444,2283,92
54197,2024,17,16,1,6,94,270894,2275,121
54198,2024,5,5,0,0,100,216870,1617,138
54199,2024,6,6,0,0,100,169367,896,187
54201,2024,4,4,0,0,100,136088,1254,114
54202,2024,8,8,0,0,100,231170,2255,105
54203,2024,3,3,0,0,100,58333,623,96
54204,2024,1,1,0,0,100,158900,1727,92
54205,2024,32,30,2,6,94,128867,1440,90
54206,2024,3,3,0,0,100,107833,1146,93
54207,2024,1,1,0,0,100,50000,455,110
54208,2024,1,1,0,0,100,210000,1591,132
54210,2024,2,2,0,0,100,88975,1008,88
54211,2024,2,2,0,0,100,86000,784,109
54212,2024,5,5,0,0,100,241470,2152,116
54213,2024,2,2,0,0,100,178335,1124,160
54214,2024,5,4,1,20,80,233643,1756,144
54215,2024,74,48,26,35,65,142000,1689,87
54217,2024,1,1,0,0,100,163000,1304,125
54220,2024,1,1,0,0,100,80000,412,194
54221,2024,3,3,0,0,100,275350,1704,162
54222,2024,11,10,1,9,91,130193,1135,118
54223,2024,2,2,0,0,100,138000,1334,104
54225,2024,2,2,0,0,100,158900,1377,116
54226,2024,1,1,0,0,100,56000,602,93
54227,2024,21,20,1,5,95,124627,1548,83
54228,2024,3,3,0,0,100,100467,964,108
54229,2024,5,5,0,0,100,85900,722,112
54231,2024,1,1,0,0,100,195500,2300,85
54232,2024,21,19,2,10,90,218085,2034,112
54234,2024,23,19,4,17,83,231993,2666,86
54235,2024,6,6,0,0,100,99867,907,112
54236,2024,4,4,0,0,100,211310,1268,150
54237,2024,3,3,0,0,100,110083,1060,102
54238,2024,1,1,0,0,100,51000,567,90
54239,2024,2,2,0,0,100,145000,1261,116
54240,2024,3,3,0,0,100,153333,1543,104
54241,2024,1,1,0,0,100,235500,2479,95
54242,2024,3,3,0,0,100,169133,1441,122
54244,2024,1,1,0,0,100,188680,1258,150
54247,2024,3,3,0,0,100,103667,1017,130
54249,2024,2,2,0,0,100,168350,1870,90
54250,2024,1,1,0,0,100,157000,1013,155
54251,2024,4,4,0,0,100,80012,665,128
54252,2024,2,2,0,0,100,122275,914,154
54253,2024,13,12,1,8,92,157865,1619,100
54254,2024,29,26,3,10,90,253175,2570,96
54255,2024,2,2,0,0,100,129615,1190,110
54256,2024,3,3,0,0,100,180333,1325,135
54257,2024,31,26,5,16,84,248522,2729,92
54258,2024,1,1,0,0,100,67500,519,130
54259,2024,3,3,0,0,100,120833,1232,163
54260,2024,4,4,0,0,100,137000,1330,103
54261,2024,53,42,11,21,79,153258,2011,78
54263,2024,69,60,9,13,87,112286,1389,81
54264,2024,1,1,0,0,100,320000,2462,130
54265,2024,10,8,2,20,80,262404,2346,115
54266,2024,2,2,0,0,100,95000,1339,70
54268,2024,1,1,0,0,100,125000,1389,90
54270,2024,39,29,10,26,74,230658,2623,87
54271,2024,1,0,1,100,0,68000,800,85
54272,2024,2,2,0,0,100,188600,2002,89
54273,2024,97,74,23,24,76,139749,1628,87
54274,2024,104,43,61,59,41,143673,2006,71
54275,2024,4,4,0,0,100,123435,986,132
54276,2024,5,4,1,20,80,185600,2194,93
54277,2024,5,5,0,0,100,155490,1445,117
54278,2024,6,6,0,0,100,120527,1511,92
54279,2024,7,7,0,0,100,138429,1557,90
54280,2024,96,53,43,45,55,85448,1150,74
54281,2024,9,9,0,0,100,161708,1473,115
54283,2024,4,4,0,0,100,272575,1902,152
54284,2024,18,18,0,0,100,87549,1058,83
54285,2024,1,1,0,0,100,92220,1317,70
54286,2024,13,12,1,8,92,162165,1935,84
54287,2024,3,3,0,0,100,148100,1273,120
54288,2024,3,3,0,0,100,253450,1621,151
54289,2024,3,3,0,0,100,206848,1357,153
54290,2024,1,1,0,0,100,199500,1995,100
54291,2024,1,1,0,0,100,214000,1585,135
54293,2024,1,1,0,0,100,168000,1527,110
54295,2024,8,8,0,0,100,195226,2039,97
54296,2024,3,3,0,0,100,210300,1871,110
54297,2024,2,2,0,0,100,100000,1254,80
54298,2024,1,1,0,0,100,77000,1604,48
54299,2024,2,2,0,0,100,138250,1369,106
54300,2024,56,38,18,32,68,186958,2120,88
54302,2024,1,1,0,0,100,49000,860,57
54303,2024,2,2,0,0,100,214125,1736,124
54304,2024,144,54,90,62,38,195565,2256,85
54305,2024,24,22,2,8,92,313700,2520,122
54306,2024,5,5,0,0,100,151426,1426,105
54307,2024,3,2,1,33,67,200667,1303,164
54308,2024,2,2,0,0,100,61350,586,105
54309,2024,3,3,0,0,100,181633,2573,70
54311,2024,2,2,0,0,100,246000,1940,132
54312,2024,5,5,0,0,100,237740,2007,125
54313,2024,2,2,0,0,100,173100,1824,95
54314,2024,34,27,7,21,79,292844,3020,97
54315,2024,12,10,2,17,83,181862,1549,123
54316,2024,5,5,0,0,100,174400,1783,97
54318,2024,63,57,6,10,90,183432,1798,101
54320,2024,1,1,0,0,100,232800,2024,115
54321,2024,23,18,5,22,78,172641,2158,81
54322,2024,74,42,32,43,57,110868,1355,82
54323,2024,154,87,67,44,56,168368,1891,92
54324,2024,1,1,0,0,100,198400,1314,151
54325,2024,1,1,0,0,100,323800,2024,160
54326,2024,2,2,0,0,100,101500,1308,83
54327,2024,2,2,0,0,100,186485,2247,84
54328,2024,51,37,14,27,73,234826,2351,99
54329,2024,189,86,103,54,46,114282,1310,90
54330,2024,2,2,0,0,100,279000,1699,180
54331,2024,5,5,0,0,100,112880,1176,95
54332,2024,38,20,18,47,53,151971,1968,82
54333,2024,2,2,0,0,100,159100,1307,126
54334,2024,5,5,0,0,100,132210,1417,99
54335,2024,3,3,0,0,100,237617,1774,138
54336,2024,8,7,1,12,88,227296,1880,122
54337,2024,3,3,0,0,100,179200,2001,92
54338,2024,9,8,1,11,89,196690,1880,112
54339,2024,104,53,51,49,51,198936,2119,88
54340,2024,3,3,0,0,100,200053,1979,112
54343,2024,3,3,0,0,100,77667,808,116
54344,2024,1,0,1,100,0,83000,798,104
54345,2024,5,5,0,0,100,189512,1819,106
54346,2024,2,2,0,0,100,192737,1698,114
54348,2024,1,1,0,0,100,244750,1883,130
54349,2024,1,1,0,0,100,302000,1291,234
54350,2024,8,8,0,0,100,106055,789,138
54351,2024,26,22,4,15,85,148132,1642,98
54352,2024,9,9,0,0,100,188984,1555,127
54353,2024,10,9,1,10,90,187732,1980,97
54354,2024,1,1,0,0,100,195000,1806,108
54357,2024,60,27,33,55,45,148115,1833,78
54358,2024,2,2,0,0,100,208500,1736,119
54359,2024,2,2,0,0,100,171000,1683,102
54360,2024,3,3,0,0,100,178750,1419,119
54362,2024,29,26,3,10,90,149489,1884,84
54363,2024,3,3,0,0,100,271600,1333,203
54364,2024,12,12,0,0,100,211145,2410,92
54365,2024,2,1,1,50,50,129600,1500,88
54366,2024,14,13,1,7,93,262164,2345,107
54367,2024,32,26,6,19,81,228179,2216,103
54368,2024,4,4,0,0,100,122625,912,124
54369,2024,14,12,2,14,86,175099,1528,118
54370,2024,4,4,0,0,100,163175,1396,119
54371,2024,6,6,0,0,100,195000,1942,103
54372,2024,5,5,0,0,100,204590,1884,101
54373,2024,4,4,0,0,100,172562,1450,138
54374,2024,4,4,0,0,100,150375,1325,122
54375,2024,8,7,1,12,88,147878,1537,104
54376,2024,6,6,0,0,100,209783,1775,131
54377,2024,2,2,0,0,100,127500,1202,106
54378,2024,7,4,3,43,57,176421,1645,103
54379,2024,1,1,0,0,100,32000,356,90
54380,2024,3,3,0,0,100,197333,2051,96
54382,2024,44,33,11,25,75,197745,2401,82
54383,2024,6,6,0,0,100,166333,1671,104
54385,2024,7,7,0,0,100,308057,2353,133
54386,2024,1,1,0,0,100,50000,362,138
54387,2024,2,0,2,100,0,112500,1402,85
54389,2024,2,2,0,0,100,110500,1247,83
54390,2024,1,1,0,0,100,158000,1975,80
54391,2024,20,20,0,0,100,119501,1663,76
54392,2024,3,2,1,33,67,124200,1111,117
54393,2024,10,10,0,0,100,82770,1012,85
54394,2024,1,1,0,0,100,304000,3576,85
54395,2024,1637,176,1461,89,11,155914,2397,66
54397,2024,86,69,17,20,80,151949,1737,90
54399,2024,4,4,0,0,100,143958,1304,108
54400,2024,9,9,0,0,100,197296,1893,105
54402,2024,2,2,0,0,100,196750,1644,118
54403,2024,14,13,1,7,93,209814,1918,107
54404,2024,3,2,1,33,67,136517,1032,128
54405,2024,3,3,0,0,100,116733,1142,107
54406,2024,5,5,0,0,100,121740,1352,100
54407,2024,1,1,0,0,100,168000,1263,133
54408,2024,4,4,0,0,100,173384,1316,134
54409,2024,1,1,0,0,100,305000,2033,150
54410,2024,3,3,0,0,100,189683,1493,143
54411,2024,2,2,0,0,100,252500,1548,168
54413,2024,2,2,0,0,100,241020,2128,120
54414,2024,6,6,0,0,100,212138,1865,115
54415,2024,29,26,3,10,90,184088,1986,97
54416,2024,2,2,0,0,100,77500,990,78
54417,2024,1,1,0,0,100,200000,1613,124
54418,2024,1,1,0,0,100,80000,667,120
54419,2024,2,2,0,0,100,97950,725,135
54420,2024,1,1,0,0,100,474000,2788,170
54421,2024,5,5,0,0,100,91064,1019,94
54422,2024,2,2,0,0,100,167750,1606,111
54423,2024,3,3,0,0,100,102888,799,141
54425,2024,31,27,4,13,87,121819,1431,88
54426,2024,8,6,2,25,75,158885,1505,115
54427,2024,2,2,0,0,100,130250,1414,93
54428,2024,10,7,3,30,70,175650,1778,98
54429,2024,4,4,0,0,100,200655,1127,168
54430,2024,43,36,7,16,84,169258,1827,94
54431,2024,124,66,58,47,53,152027,1739,87
54432,2024,21,13,8,38,62,138110,1493,91
54434,2024,3,3,0,0,100,173570,1157,143
54435,2024,7,7,0,0,100,169274,1399,124
54436,2024,1,1,0,0,100,60000,408,147
54437,2024,8,8,0,0,100,169862,1923,83
54439,2024,49,39,10,20,80,212379,2230,93
54440,2024,1,1,0,0,100,55000,598,92
54441,2024,4,4,0,0,100,153950,1516,104
54443,2024,2,2,0,0,100,122500,626,205
54444,2024,4,4,0,0,100,171323,1476,121
54445,2024,1,1,0,0,100,140000,2000,70
54449,2024,3,3,0,0,100,118940,1121,105
54450,2024,1,1,0,0,100,171000,1140,150
54451,2024,51,32,19,37,63,157287,1944,82
54452,2024,1,1,0,0,100,225000,1406,160
54453,2024,2,2,0,0,100,132025,1990,66
54455,2024,2,2,0,0,100,95200,1300,74
54456,2024,3,3,0,0,100,241417,1672,153
54457,2024,1,1,0,0,100,40000,471,85
54458,2024,3,3,0,0,100,155000,994,157
54459,2024,18,16,2,11,89,218211,2152,101
54460,2024,2,2,0,0,100,45000,640,72
54462,2024,30,27,3,10,90,160671,1776,92
54463,2024,1,1,0,0,100,125000,2083,60
54465,2024,8,6,2,25,75,94425,1095,90
54466,2024,3,3,0,0,100,185633,1666,114
54467,2024,1,1,0,0,100,161000,1320,122
54469,2024,1,1,0,0,100,285500,2504,114
54470,2024,1,1,0,0,100,129000,1032,125
54472,2024,7,7,0,0,100,148171,1514,102
54474,2024,2,2,0,0,100,204000,1156,170
54475,2024,1,1,0,0,100,181000,804,225
54476,2024,4,4,0,0,100,139750,1443,92
54477,2024,5,5,0,0,100,144010,895,185
54478,2024,2,1,1,50,50,198000,1583,130
54479,2024,2,2,0,0,100,150950,1478,99
54481,2024,1,1,0,0,100,144000,2057,70
54482,2024,155,42,113,73,27,147820,1981,73
54483,2024,82,60,22,27,73,144427,1679,87
54484,2024,2,2,0,0,100,72500,880,98
54485,2024,1,1,0,0,100,160000,1739,92
54486,2024,5,5,0,0,100,183040,1652,124
54487,2024,1,1,0,0,100,51000,464,110
54489,2024,3,3,0,0,100,167433,1839,88
54490,2024,10,9,1,10,90,186365,1713,125
54491,2024,1,1,0,0,100,216500,1237,175
54492,2024,1,1,0,0,100,65000,430,151
54493,2024,34,28,6,18,82,157595,1984,81
54494,2024,2,2,0,0,100,123000,1106,128
54495,2024,42,39,3,7,93,228682,2374,97
54496,2024,3,2,1,33,67,115660,1098,106
54498,2024,53,50,3,6,94,209837,2219,95
54499,2024,1,1,0,0,100,130000,1368,95
54500,2024,1,1,0,0,100,61000,1017,60
54501,2024,1,1,0,0,100,125000,1078,116
54502,2024,2,2,0,0,100,186575,772,247
54504,2024,7,4,3,43,57,174441,2084,82
54505,2024,6,6,0,0,100,161867,1351,119
54507,2024,1,1,0,0,100,120000,1622,74
54508,2024,1,1,0,0,100,370000,1947,190
54509,2024,18,18,0,0,100,210614,1951,111
54510,2024,2,2,0,0,100,259688,1169,210
54511,2024,2,2,0,0,100,220898,1822,122
54513,2024,11,11,0,0,100,170691,1668,126
54514,2024,7,7,0,0,100,183900,1694,104
54517,2024,4,4,0,0,100,176475,1140,155
54518,2024,16,14,2,12,88,170010,1741,103
54519,2024,7,7,0,0,100,113071,1122,103
54520,2024,2,2,0,0,100,176500,1629,112
54521,2024,35,14,21,60,40,181821,2905,68
54522,2024,2,1,1,50,50,174800,2800,66
54523,2024,1,1,0,0,100,159000,2271,70
54524,2024,2,2,0,0,100,156250,1635,91
54525,2024,2,2,0,0,100,232000,1372,200
54526,2024,101,64,37,37,63,177009,2205,80
54527,2024,7,7,0,0,100,152500,1618,93
54528,2024,126,56,70,56,44,140674,1585,90
54529,2024,1,1,0,0,100,70000,1000,70
54530,2024,1,1,0,0,100,58000,829,70
54533,2024,34,31,3,9,91,198780,2070,94
54534,2024,6,6,0,0,100,80044,845,93
54535,2024,3,3,0,0,100,223395,1915,115
54536,2024,30,25,5,17,83,119681,1448,83
54537,2024,5,5,0,0,100,279462,2503,108
54538,2024,3,3,0,0,100,83033,925,96
54539,2024,1,1,0,0,100,44000,518,85
54540,2024,6,6,0,0,100,62850,776,82
54542,2024,27,24,3,11,89,137026,1607,83
54543,2024,1,1,0,0,100,138080,1030,134
54544,2024,3,3,0,0,100,218333,2016,108
54546,2024,10,5,5,50,50,128874,1407,89
54547,2024,314,62,252,80,20,121420,2010,62
54548,2024,5,5,0,0,100,67700,790,85
54549,2024,50,40,10,20,80,139133,1629,91
54550,2024,4,3,1,25,75,159000,1329,116
54551,2024,1,1,0,0,100,105000,729,144
54552,2024,3,3,0,0,100,154233,983,151
54553,2024,2,2,0,0,100,146965,2214,78
54554,2024,1,1,0,0,100,193000,2354,82
54555,2024,1,1,0,0,100,20000,357,56
54556,2024,2,2,0,0,100,195325,1556,126
54557,2024,17,17,0,0,100,240713,2141,112
54558,2024,2,2,0,0,100,147025,2218,62
54559,2024,4,4,0,0,100,236638,2034,124
54562,2024,2,2,0,0,100,141725,1130,131
54563,2024,10,8,2,20,80,200488,1862,112
54564,2024,4,4,0,0,100,152250,1284,124
54566,2024,1,1,0,0,100,92400,516,179
54567,2024,4,4,0,0,100,142000,1116,123
54568,2024,2,2,0,0,100,159500,1552,100
54569,2024,1,1,0,0,100,157500,1750,90
54570,2024,2,2,0,0,100,212500,2095,104
54571,2024,4,4,0,0,100,315838,2111,140
54572,2024,8,8,0,0,100,286462,2772,104
54573,2024,1,1,0,0,100,125000,1136,110
54574,2024,4,4,0,0,100,203625,2292,90
54575,2024,12,9,3,25,75,330362,2338,141
54577,2024,2,2,0,0,100,155000,1228,127
54578,2024,185,91,94,51,49,206812,2303,90
54579,2024,4,3,1,25,75,138775,1091,129
54580,2024,132,96,36,27,73,190189,2433,79
54581,2024,3,3,0,0,100,169467,1371,126
54582,2024,1,1,0,0,100,57000,576,99
54583,2024,9,9,0,0,100,241811,1619,150
54584,2024,11,9,2,18,82,192742,1727,112
54585,2024,7,6,1,14,86,128893,1311,107
54586,2024,10,9,1,10,90,162898,1513,111
54587,2024,2,2,0,0,100,128232,620,196
54588,2024,3,2,1,33,67,157000,1653,93
54590,2024,9,9,0,0,100,253429,2068,124
54591,2024,6,6,0,0,100,189512,1845,100
54592,2024,2,2,0,0,100,180200,2002,90
54593,2024,3,2,1,33,67,105337,1075,105
54595,2024,6,6,0,0,100,192875,1703,128
54596,2024,5,4,1,20,80,162723,1865,87
54597,2024,5,5,0,0,100,217150,1457,148
54598,2024,7,7,0,0,100,209957,1616,124
54599,2024,3,3,0,0,100,196703,1299,168
54600,2024,1,1,0,0,100,107500,1156,93
54601,2024,1,1,0,0,100,196350,1785,110
54602,2024,1,1,0,0,100,135000,1007,134
55001,2024,1,1,0,0,100,85300,1376,62
55002,2024,1,1,0,0,100,120000,1558,77
55004,2024,3,3,0,0,100,113333,1001,101
55007,2024,2,2,0,0,100,94500,1023,95
55008,2024,2,2,0,0,100,173500,1251,121
55009,2024,3,3,0,0,100,114333,1264,95
55010,2024,23,21,2,9,91,108346,1220,89
55011,2024,5,5,0,0,100,164900,1370,130
55012,2024,1,1,0,0,100,108000,1029,105
55013,2024,1,1,0,0,100,223000,1304,171
55014,2024,4,4,0,0,100,125000,915,123
55015,2024,1,1,0,0,100,60000,577,104
55017,2024,2,2,0,0,100,95000,886,108
55018,2024,1,1,0,0,100,40000,400,100
55023,2024,1,1,0,0,100,99000,9900,10
55024,2024,4,4,0,0,100,91425,1190,82
55025,2024,5,5,0,0,100,110908,946,129
55026,2024,1,1,0,0,100,50000,667,75
55027,2024,1,1,0,0,100,55000,367,150
55028,2024,3,3,0,0,100,120333,1074,112
55029,2024,139,80,59,42,58,110802,1395,87
55031,2024,6,6,0,0,100,187383,1835,96
55034,2024,1,1,0,0,100,75000,1172,64
55035,2024,2,2,0,0,100,51500,702,70
55036,2024,2,2,0,0,100,50000,414,122
55037,2024,1,1,0,0,100,49000,476,103
55038,2024,2,2,0,0,100,89500,1298,70
55040,2024,2,2,0,0,100,94500,664,150
55041,2024,6,6,0,0,100,112043,1076,110
55042,2024,7,7,0,0,100,189924,1743,113
55043,2024,29,20,9,31,69,129017,1376,94
55045,2024,6,5,1,17,83,201617,1972,112
55047,2024,4,4,0,0,100,105750,1018,102
55049,2024,5,5,0,0,100,92200,877,107
55053,2024,3,3,0,0,100,108333,1160,94
55058,2024,6,6,0,0,100,153417,1091,144
55059,2024,4,4,0,0,100,127100,1502,88
55060,2024,4,4,0,0,100,110334,1010,110
55061,2024,2,2,0,0,100,169950,1434,122
55063,2024,45,39,6,13,87,107488,1230,87
55064,2024,1,1,0,0,100,70000,753,93
55067,2024,1,1,0,0,100,138700,867,160
55069,2024,1,1,0,0,100,170000,1954,87
55071,2024,4,4,0,0,100,108325,958,110
55072,2024,1,1,0,0,100,46500,397,117
55073,2024,9,8,1,11,89,160180,1414,123
55075,2024,3,3,0,0,100,69667,629,107
55076,2024,4,4,0,0,100,92250,773,119
55077,2024,4,4,0,0,100,127750,1714,81
55078,2024,3,3,0,0,100,91667,1240,78
55079,2024,6,6,0,0,100,153417,1251,123
55080,2024,2,2,0,0,100,50750,598,85
55082,2024,1,1,0,0,100,77000,802,96
55083,2024,3,3,0,0,100,116667,1067,106
55084,2024,1,1,0,0,100,119712,1392,86
55085,2024,6,6,0,0,100,160684,1262,131
55088,2024,1,1,0,0,100,92000,1070,86
55089,2024,1,0,1,100,0,80000,889,90
55093,2024,5,5,0,0,100,122982,953,125
55094,2024,2,2,0,0,100,118016,1087,108
55095,2024,1,1,0,0,100,235000,1895,124
55097,2024,5,5,0,0,100,130480,1306,100
55099,2024,2,2,0,0,100,153500,1098,140
55100,2024,1,1,0,0,100,55000,529,104
55101,2024,2,2,0,0,100,75350,892,88
55102,2024,4,3,1,25,75,151800,1398,111
55103,2024,1,1,0,0,100,29000,453,64
55105,2024,3,3,0,0,100,226667,1185,176
55108,2024,1,1,0,0,100,63000,423,149
55109,2024,1,1,0,0,100,67500,450,150
55110,2024,4,4,0,0,100,116250,1470,98
55111,2024,3,3,0,0,100,194000,1837,103
55113,2024,2,2,0,0,100,91400,1208,84
55114,2024,1,1,0,0,100,118000,1639,72
55116,2024,1,1,0,0,100,68500,571,120
55117,2024,17,17,0,0,100,93938,933,101
55118,2024,1,1,0,0,100,80000,432,185
55119,2024,2,2,0,0,100,61714,788,88
55120,2024,8,8,0,0,100,147275,1515,96
55121,2024,3,3,0,0,100,131333,1812,68
55122,2024,45,31,14,31,69,104102,1063,95
55123,2024,3,3,0,0,100,140918,1081,124
55124,2024,8,8,0,0,100,125138,1019,114
55125,2024,5,5,0,0,100,151850,1353,112
55132,2024,9,7,2,22,78,84966,866,101
55133,2024,1,1,0,0,100,30000,333,90
55134,2024,1,1,0,0,100,90000,1304,69
55139,2024,1,1,0,0,100,100000,1724,58
55142,2024,2,2,0,0,100,144875,1338,105
55143,2024,1,1,0,0,100,76895,732,105
55144,2024,2,2,0,0,100,116975,684,180
55145,2024,6,5,1,17,83,173617,1480,114
55146,2024,1,1,0,0,100,84110,758,111
55148,2024,3,3,0,0,100,55100,697,95
55149,2024,1,1,0,0,100,76000,760,100
55150,2024,3,3,0,0,100,85650,670,127
55153,2024,3,3,0,0,100,147500,1191,125
55154,2024,14,14,0,0,100,152393,1554,96
55155,2024,3,3,0,0,100,114987,1055,109
55156,2024,2,2,0,0,100,110800,848,166
55158,2024,6,6,0,0,100,124620,1510,80
55159,2024,1,1,0,0,100,60000,682,88
55163,2024,3,3,0,0,100,98487,1139,89
55165,2024,6,6,0,0,100,115567,1175,101
55166,2024,11,11,0,0,100,127589,1488,87
55167,2024,7,7,0,0,100,89914,1219,77
55169,2024,1,1,0,0,100,42000,1000,42
55171,2024,2,2,0,0,100,210000,1628,136
55173,2024,1,1,0,0,100,80000,964,83
55174,2024,1,1,0,0,100,103000,427,241
55177,2024,2,2,0,0,100,137500,1114,126
55179,2024,1,1,0,0,100,80000,860,93
55180,2024,2,2,0,0,100,72450,792,88
55181,2024,38,37,1,3,97,118214,1206,103
55182,2024,3,3,0,0,100,103983,1101,91
55183,2024,2,2,0,0,100,52500,582,84
55184,2024,12,11,1,8,92,137118,1167,124
55185,2024,1,1,0,0,100,58000,464,125
55186,2024,14,13,1,7,93,163685,1482,112
55191,2024,3,3,0,0,100,182783,1530,125
55195,2024,3,3,0,0,100,112067,913,120
55196,2024,2,2,0,0,100,98750,1019,98
55197,2024,1,1,0,0,100,70000,1250,56
55198,2024,8,8,0,0,100,142688,1417,104
55200,2024,1,1,0,0,100,129000,1152,112
55202,2024,4,4,0,0,100,99775,1096,90
55204,2024,1,1,0,0,100,118750,1696,70
55206,2024,2,2,0,0,100,40000,479,92
55208,2024,1,1,0,0,100,55000,534,103
55211,2024,1,1,0,0,100,139000,897,155
55212,2024,1,1,0,0,100,138000,1663,83
55214,2024,1,1,0,0,100,140000,1795,78
55215,2024,5,5,0,0,100,61300,603,102
55217,2024,1,1,0,0,100,42000,400,105
55220,2024,1,1,0,0,100,30000,353,85
55221,2024,5,5,0,0,100,121160,1071,122
55224,2024,4,4,0,0,100,97150,908,110
55225,2024,1,1,0,0,100,189000,1703,111
55226,2024,1,1,0,0,100,25000,595,42
55228,2024,3,3,0,0,100,89650,1039,93
55229,2024,1,1,0,0,100,214650,1112,193
55232,2024,1,1,0,0,100,120000,1304,92
55236,2024,4,4,0,0,100,145600,1173,130
55242,2024,2,2,0,0,100,113300,1158,115
55243,2024,2,2,0,0,100,82000,1318,66
55244,2024,1,1,0,0,100,100000,1205,83
55245,2024,1,1,0,0,100,105000,580,181
55246,2024,2,2,0,0,100,130000,914,156
55248,2024,5,5,0,0,100,109200,995,117
55250,2024,4,4,0,0,100,78750,1180,78
55251,2024,2,2,0,0,100,69000,534,142
55253,2024,12,12,0,0,100,65564,781,85
55255,2024,7,7,0,0,100,96800,851,123
55256,2024,2,2,0,0,100,128608,1252,140
55257,2024,1,1,0,0,100,50000,455,110
55258,2024,9,9,0,0,100,145423,1081,145
55261,2024,1,1,0,0,100,23000,418,55
55262,2024,3,3,0,0,100,120667,722,139
55263,2024,1,1,0,0,100,77000,642,120
55264,2024,4,4,0,0,100,170425,1463,112
55265,2024,1,1,0,0,100,40000,388,103
55266,2024,2,2,0,0,100,97850,681,144
55267,2024,2,2,0,0,100,139640,1880,80
55268,2024,3,3,0,0,100,84667,1056,87
55271,2024,4,4,0,0,100,118625,822,155
55272,2024,2,2,0,0,100,106000,1420,72
55274,2024,2,2,0,0,100,84000,931,104
55275,2024,1,1,0,0,100,100000,617,162
55276,2024,2,2,0,0,100,186150,1295,134
55279,2024,3,3,0,0,100,76607,839,89
55281,2024,2,2,0,0,100,74254,678,110
55282,2024,1,1,0,0,100,70000,714,98
55284,2024,1,1,0,0,100,121000,1247,97
55285,2024,1,1,0,0,100,80000,606,132
55286,2024,1,1,0,0,100,215000,2216,97
55288,2024,13,13,0,0,100,125438,1227,110
55289,2024,1,1,0,0,100,126500,1100,115
55290,2024,2,2,0,0,100,242000,1351,185
55291,2024,27,20,7,26,74,86582,1253,74
55292,2024,1,1,0,0,100,60000,1224,49
55293,2024,4,4,0,0,100,76500,977,81
55295,2024,1,1,0,0,100,325000,2955,110
55296,2024,8,8,0,0,100,122131,1234,104
55297,2024,3,3,0,0,100,114833,1410,74
55298,2024,3,3,0,0,100,78500,773,95
55301,2024,4,4,0,0,100,145112,1366,105
55302,2024,9,9,0,0,100,96389,1154,81
55303,2024,1,1,0,0,100,167930,1527,110
55304,2024,1,1,0,0,100,81700,628,130
55306,2024,2,2,0,0,100,64500,608,108
55310,2024,1,1,0,0,100,80000,656,122
55316,2024,5,5,0,0,100,109160,1111,103
55317,2024,1,1,0,0,100,72000,774,93
55320,2024,1,1,0,0,100,115000,958,120
55321,2024,1,1,0,0,100,103000,539,191
55322,2024,1,1,0,0,100,125000,1250,100
55323,2024,2,2,0,0,100,172500,1494,117
55324,2024,7,7,0,0,100,94849,1112,84
55325,2024,1,1,0,0,100,150000,1579,95
55326,2024,2,2,0,0,100,53250,572,96
55327,2024,2,2,0,0,100,98738,1090,82
55328,2024,3,3,0,0,100,65000,726,95
55329,2024,1,1,0,0,100,65000,1066,61
55332,2024,2,2,0,0,100,87925,748,116
55334,2024,1,1,0,0,100,80000,696,115
55336,2024,4,4,0,0,100,81800,745,116
55338,2024,3,3,0,0,100,103900,803,110
55339,2024,1,1,0,0,100,134960,1377,98
55340,2024,2,2,0,0,100,134500,1220,88
55341,2024,2,2,0,0,100,96500,890,102
55343,2024,1,1,0,0,100,136200,636,214
55344,2024,1,1,0,0,100,20000,351,57
55345,2024,2,2,0,0,100,65000,892,82
55346,2024,7,7,0,0,100,125571,954,121
55347,2024,2,2,0,0,100,83625,1126,68
55348,2024,1,1,0,0,100,65000,520,125
55349,2024,3,3,0,0,100,81333,1006,83
55351,2024,20,17,3,15,85,185835,1661,131
55352,2024,1,1,0,0,100,360000,2667,135
55353,2024,1,1,0,0,100,175000,1306,134
55355,2024,3,3,0,0,100,90000,934,110
55357,2024,1,1,0,0,100,180000,1053,171
55358,2024,1,1,0,0,100,50000,495,101
55359,2024,4,4,0,0,100,191370,1248,160
55360,2024,1,1,0,0,100,131200,875,150
55361,2024,2,2,0,0,100,138500,1344,108
55364,2024,11,11,0,0,100,93000,940,94
55365,2024,4,4,0,0,100,104718,892,130
55366,2024,4,4,0,0,100,144978,1149,122
55367,2024,1,1,0,0,100,219725,1616,136
55369,2024,3,3,0,0,100,133462,1522,87
55370,2024,3,3,0,0,100,80733,891,91
55372,2024,4,4,0,0,100,145625,1348,110
55374,2024,2,2,0,0,100,89000,746,119
55375,2024,1,1,0,0,100,90000,900,100
55376,2024,1,1,0,0,100,135000,1174,115
55378,2024,4,4,0,0,100,80800,817,96
55379,2024,2,2,0,0,100,124950,1516,94
55380,2024,1,1,0,0,100,40000,370,108
55381,2024,1,1,0,0,100,142000,1406,101
55382,2024,3,3,0,0,100,161781,1457,123
55383,2024,2,2,0,0,100,94750,654,156
55384,2024,1,1,0,0,100,244000,2324,105
55385,2024,3,3,0,0,100,175833,1611,114
55386,2024,3,3,0,0,100,130400,1137,103
55387,2024,1,1,0,0,100,153550,1520,101
55389,2024,9,9,0,0,100,107418,962,116
55391,2024,3,3,0,0,100,71500,580,118
55396,2024,3,3,0,0,100,88667,998,95
55397,2024,7,7,0,0,100,89496,854,105
55398,2024,5,5,0,0,100,145300,1530,98
55400,2024,1,1,0,0,100,105500,659,160
55401,2024,4,4,0,0,100,83125,764,109
55404,2024,3,3,0,0,100,121833,1459,87
55405,2024,5,5,0,0,100,173202,1835,100
55406,2024,1,1,0,0,100,228700,1515,151
55407,2024,1,1,0,0,100,132200,1502,88
55408,2024,4,4,0,0,100,37049,592,61
55410,2024,4,4,0,0,100,95138,797,118
55412,2024,2,2,0,0,100,140000,1020,146
55414,2024,1,1,0,0,100,120650,943,128
55415,2024,1,1,0,0,100,109250,918,119
55416,2024,3,3,0,0,100,112267,1134,92
55419,2024,1,1,0,0,100,85000,895,95
55423,2024,2,2,0,0,100,39000,469,82
55424,2024,1,1,0,0,100,107000,1372,78
55425,2024,1,1,0,0,100,85000,746,114
55426,2024,5,5,0,0,100,95250,930,107
55427,2024,23,21,2,9,91,123168,1368,99
55430,2024,1,1,0,0,100,107500,632,170
55431,2024,1,1,0,0,100,191320,1664,115
55433,2024,1,1,0,0,100,224000,1514,148
55435,2024,5,5,0,0,100,133971,1364,101
55436,2024,2,2,0,0,100,55460,2524,58
55437,2024,1,1,0,0,100,49000,612,80
55439,2024,1,1,0,0,100,145500,1119,130
55442,2024,3,3,0,0,100,134117,935,154
55443,2024,2,2,0,0,100,141000,1068,140
55444,2024,2,2,0,0,100,182500,1460,130
55447,2024,4,4,0,0,100,134106,1313,102
55449,2024,3,3,0,0,100,97850,836,155
55450,2024,2,2,0,0,100,121000,955,130
55454,2024,3,3,0,0,100,102806,980,101
55456,2024,2,2,0,0,100,91000,1126,85
55458,2024,5,5,0,0,100,145454,1270,106
55459,2024,1,1,0,0,100,107000,764,140
55461,2024,3,3,0,0,100,176700,2119,103
55462,2024,3,3,0,0,100,126667,1517,102
55463,2024,31,27,4,13,87,90696,951,98
55464,2024,1,1,0,0,100,30000,333,90
55465,2024,1,1,0,0,100,70400,629,112
55466,2024,3,3,0,0,100,133300,1160,104
55467,2024,7,7,0,0,100,121214,1331,91
55468,2024,1,1,0,0,100,203500,2077,98
55469,2024,2,2,0,0,100,75000,746,100
55470,2024,3,3,0,0,100,67667,576,115
55471,2024,2,2,0,0,100,123500,834,148
55472,2024,2,2,0,0,100,69750,700,110
55474,2024,7,7,0,0,100,80243,1042,117
55475,2024,2,2,0,0,100,117250,1408,116
55476,2024,3,2,1,33,67,89667,848,109
55477,2024,3,3,0,0,100,136833,1041,133
55479,2024,1,1,0,0,100,124000,954,130
55481,2024,3,3,0,0,100,98217,709,145
55482,2024,5,5,0,0,100,162200,1096,152
55484,2024,1,1,0,0,100,225000,2083,108
55487,2024,1,1,0,0,100,55000,598,92
55488,2024,2,2,0,0,100,141750,1146,136
55489,2024,2,2,0,0,100,104700,1173,84
55490,2024,6,6,0,0,100,78000,998,86
55492,2024,5,5,0,0,100,98822,1137,87
55493,2024,1,1,0,0,100,90800,882,103
55494,2024,5,5,0,0,100,102614,1768,76
55496,2024,12,12,0,0,100,123308,1110,110
55497,2024,5,5,0,0,100,146580,1670,104
55498,2024,4,4,0,0,100,205700,1450,148
55500,2024,8,8,0,0,100,139828,1114,125
55501,2024,2,2,0,0,100,136025,1187,117
55502,2024,19,18,1,5,95,72697,784,97
55503,2024,1,1,0,0,100,107000,973,110
55504,2024,4,4,0,0,100,95572,1054,91
55505,2024,20,17,3,15,85,141560,1426,100
55506,2024,1,1,0,0,100,25000,556,45
55507,2024,5,5,0,0,100,168060,1446,109
55508,2024,1,1,0,0,100,305000,1981,154
55509,2024,5,4,1,20,80,125900,1254,102
55510,2024,1,1,0,0,100,100000,699,143
55511,2024,2,2,0,0,100,172325,1246,134
55512,2024,3,3,0,0,100,58000,580,101
55514,2024,2,2,0,0,100,122025,1108,116
55515,2024,1,1,0,0,100,60000,732,82
55516,2024,7,7,0,0,100,89957,926,93
55517,2024,5,5,0,0,100,86960,873,102
55518,2024,2,2,0,0,100,92500,725,118
55519,2024,14,14,0,0,100,104100,990,108
55520,2024,3,3,0,0,100,117567,911,118
55521,2024,3,3,0,0,100,80600,681,104
55522,2024,3,3,0,0,100,106333,1012,102
55523,2024,4,4,0,0,100,114500,1232,94
55526,2024,2,2,0,0,100,169850,1481,114
55527,2024,8,7,1,12,88,108635,1012,109
55530,2024,2,2,0,0,100,60000,694,86
55531,2024,4,4,0,0,100,184262,1421,130
55532,2024,3,3,0,0,100,98667,1337,107
55533,2024,15,13,2,13,87,100046,1002,95
55535,2024,2,2,0,0,100,134200,1368,100
55537,2024,1,1,0,0,100,148500,1727,86
55540,2024,2,2,0,0,100,108250,1672,76
55541,2024,8,8,0,0,100,145702,1376,120
55543,2024,8,8,0,0,100,138462,1430,96
55544,2024,2,2,0,0,100,146500,1206,106
55545,2024,213,100,113,53,47,124334,1427,87
55546,2024,3,3,0,0,100,134667,2208,64
55549,2024,1,1,0,0,100,39000,429,91
55551,2024,13,13,0,0,100,134177,1360,102
55552,2024,1,1,0,0,100,82000,1038,79
55553,2024,10,10,0,0,100,136250,1519,87
55554,2024,5,5,0,0,100,146900,1228,115
55556,2024,1,1,0,0,100,81500,970,84
55557,2024,3,3,0,0,100,103087,1010,103
55562,2024,2,2,0,0,100,150000,1135,104
55563,2024,2,2,0,0,100,191375,1532,125
55565,2024,1,1,0,0,100,216000,1119,193
55567,2024,1,1,0,0,100,153900,1282,120
55568,2024,1,1,0,0,100,72000,973,74
55571,2024,5,5,0,0,100,80740,734,112
55572,2024,1,1,0,0,100,50000,333,150
55573,2024,13,13,0,0,100,137835,1288,110
55578,2024,2,2,0,0,100,123325,1212,102
55579,2024,1,1,0,0,100,204250,1032,198
55580,2024,1,1,0,0,100,130000,942,138
55581,2024,1,1,0,0,100,51500,585,88
55583,2024,1,1,0,0,100,134000,957,140
55584,2024,2,2,0,0,100,126109,2450,86
55586,2024,2,2,0,0,100,158000,1028,136
56001,2024,29,28,1,3,97,178750,1959,93
56002,2024,30,27,3,10,90,232998,3123,77
56003,2024,62,44,18,29,71,605739,5125,113
56004,2024,23,21,2,9,91,192533,2897,66
56005,2024,107,51,56,52,48,408369,5539,71
56006,2024,15,15,0,0,100,109167,1466,78
56007,2024,220,85,135,61,39,271988,3567,78
56008,2024,52,45,7,13,87,645037,4720,132
56009,2024,23,23,0,0,100,445859,4345,102
56010,2024,76,61,15,20,80,186690,2196,91
56011,2024,25,25,0,0,100,173616,1785,100
56012,2024,21,21,0,0,100,205300,1867,112
56013,2024,65,57,8,12,88,332082,3788,93
56014,2024,16,16,0,0,100,171754,1865,96
56015,2024,20,20,0,0,100,246890,2641,95
56017,2024,25,25,0,0,100,193822,2286,90
56018,2024,17,17,0,0,100,251891,2707,96
56019,2024,9,9,0,0,100,156444,1493,99
56020,2024,7,7,0,0,100,179952,1561,115
56021,2024,8,7,1,12,88,282474,2360,118
56022,2024,13,13,0,0,100,214715,2229,96
56023,2024,71,60,11,15,85,301886,3073,101
56024,2024,20,20,0,0,100,160082,1775,97
56025,2024,2,2,0,0,100,45105,716,62
56026,2024,44,44,0,0,100,138051,1628,79
56027,2024,4,4,0,0,100,142302,1531,94
56028,2024,27,27,0,0,100,173471,1964,91
56029,2024,7,7,0,0,100,250671,2316,111
56030,2024,11,11,0,0,100,282953,2704,113
56031,2024,39,38,1,3,97,187964,2076,96
56032,2024,25,25,0,0,100,154519,1693,93
56033,2024,51,50,1,2,98,114433,1561,77
56034,2024,167,78,89,53,47,424194,5956,75
56035,2024,16,16,0,0,100,166210,1696,94
56036,2024,63,57,6,10,90,287524,2594,112
56039,2024,12,12,0,0,100,212128,2081,102
56040,2024,30,27,3,10,90,195911,2347,96
56041,2024,26,25,1,4,96,125171,1391,92
56042,2024,12,12,0,0,100,260729,2703,105
56043,2024,11,11,0,0,100,137861,1574,89
56044,2024,10,10,0,0,100,160595,2098,75
56045,2024,12,12,0,0,100,214016,2267,87
56046,2024,34,34,0,0,100,524696,4247,120
56047,2024,16,16,0,0,100,138807,1493,94
56048,2024,11,11,0,0,100,113665,1158,101
56050,2024,6,6,0,0,100,152200,1774,91
56051,2024,10,10,0,0,100,117690,1378,91
56052,2024,82,60,22,27,73,336685,4772,79
56053,2024,58,53,5,9,91,265507,2475,111
56054,2024,67,58,9,13,87,362651,4119,92
56055,2024,50,33,17,34,66,280135,4215,71
56056,2024,3,3,0,0,100,53000,659,78
56057,2024,34,32,2,6,94,129363,1476,90
56058,2024,42,42,0,0,100,243500,2453,101
56060,2024,9,9,0,0,100,142332,1509,100
56061,2024,47,47,0,0,100,144752,1596,91
56062,2024,18,17,1,6,94,322199,3549,92
56063,2024,20,19,1,5,95,290514,2674,111
56065,2024,8,8,0,0,100,194250,2260,88
56066,2024,61,60,1,2,98,113420,1321,86
56067,2024,54,53,1,2,98,253716,2539,103
56068,2024,6,6,0,0,100,161167,1562,104
56069,2024,31,30,1,3,97,341434,4403,85
56070,2024,31,31,0,0,100,133674,1482,91
56071,2024,15,15,0,0,100,129733,1892,80
56072,2024,6,6,0,0,100,92167,1262,68
56073,2024,27,26,1,4,96,96600,1191,85
56074,2024,16,16,0,0,100,187396,1949,98
56075,2024,69,62,7,10,90,178154,1979,90
56076,2024,14,14,0,0,100,133179,1497,87
56077,2024,13,13,0,0,100,241139,2301,103
56078,2024,122,77,45,37,63,314455,3717,87
56079,2024,16,16,0,0,100,186899,2030,96
56080,2024,30,30,0,0,100,113767,1404,81
56081,2024,35,35,0,0,100,117138,1371,89
56082,2024,5,5,0,0,100,152318,2135,71
56083,2024,216,137,79,37,63,198901,2548,81
56084,2024,10,10,0,0,100,358664,4042,89
56085,2024,3,3,0,0,100,330000,6610,57
56086,2024,2,2,0,0,100,300000,6100,49
56087,2024,13,13,0,0,100,631962,7542,88
56088,2024,5,5,0,0,100,581300,5955,93
56089,2024,22,22,0,0,100,176065,1855,96
56090,2024,68,64,4,6,94,208083,2177,98
56091,2024,32,27,5,16,84,145395,1942,82
56092,2024,10,10,0,0,100,168455,1806,98
56093,2024,7,7,0,0,100,200429,1543,136
56094,2024,47,42,5,11,89,322225,2895,111
56096,2024,17,17,0,0,100,288460,3010,100
56097,2024,36,29,7,19,81,250416,2735,94
56098,2024,239,158,81,34,66,204521,2510,83
56099,2024,7,7,0,0,100,118893,1136,89
56100,2024,35,35,0,0,100,143034,1613,97
56101,2024,68,56,12,18,82,201217,2415,88
56102,2024,27,27,0,0,100,131609,1558,87
56103,2024,7,7,0,0,100,125487,1473,85
56104,2024,7,7,0,0,100,176435,2080,84
56105,2024,27,27,0,0,100,101522,1094,97
56106,2024,17,16,1,6,94,616684,5983,97
56107,2024,107,67,40,37,63,447865,4738,97
56108,2024,9,9,0,0,100,207970,2078,103
56109,2024,7,7,0,0,100,256117,2603,101
56110,2024,16,16,0,0,100,128913,1359,96
56111,2024,27,26,1,4,96,175386,1873,97
56112,2024,10,10,0,0,100,152020,1779,88
56113,2024,17,17,0,0,100,133737,1263,109
56114,2024,13,13,0,0,100,457422,5446,91
56115,2024,16,16,0,0,100,250376,2579,99
56116,2024,40,32,8,20,80,503426,5567,93
56117,2024,50,41,9,18,82,181799,2124,87
56118,2024,54,49,5,9,91,288504,3345,89
56119,2024,21,20,1,5,95,397083,3481,119
56120,2024,15,15,0,0,100,246386,2283,110
56121,2024,812,264,548,67,33,194863,2759,73
56122,2024,26,26,0,0,100,147851,1764,90
56123,2024,24,24,0,0,100,179272,1850,96
56124,2024,35,31,4,11,89,193112,2112,95
56125,2024,19,18,1,5,95,147519,1502,101
56126,2024,33,33,0,0,100,203821,2113,103
56127,2024,53,51,2,4,96,119783,1406,89
56128,2024,35,35,0,0,100,116370,1363,90
56129,2024,27,27,0,0,100,110780,1291,88
56130,2024,23,23,0,0,100,266953,2655,101
56131,2024,14,14,0,0,100,161949,1853,93
56132,2024,11,11,0,0,100,330629,2953,116
56133,2024,13,13,0,0,100,198595,1967,97
56134,2024,15,15,0,0,100,104871,1161,88
56135,2024,19,19,0,0,100,191717,1955,97
56136,2024,12,12,0,0,100,144779,1900,85
56137,2024,26,25,1,4,96,287981,2605,117
56139,2024,1,1,0,0,100,212000,2078,102
56140,2024,33,33,0,0,100,158469,1791,91
56141,2024,28,27,1,4,96,187838,1917,106
56143,2024,60,53,7,12,88,259291,2785,94
56144,2024,47,46,1,2,98,152820,1809,87
56145,2024,15,15,0,0,100,136859,1531,86
56146,2024,16,16,0,0,100,181350,1682,112
56147,2024,60,59,1,2,98,224098,2369,97
56148,2024,13,13,0,0,100,288923,3051,97
56149,2024,33,32,1,3,97,224387,2332,96
56151,2024,30,30,0,0,100,151770,1609,97
56152,2024,41,30,11,27,73,413276,5054,83
56153,2024,38,37,1,3,97,191040,2071,99
56154,2024,26,26,0,0,100,160557,1985,82
56155,2024,70,60,10,14,86,262732,3614,77
56156,2024,6,6,0,0,100,127177,1694,77
56157,2024,30,30,0,0,100,212111,2176,96
56158,2024,80,44,36,45,55,280892,3322,88
56159,2024,18,18,0,0,100,181427,1700,108
56160,2024,9,9,0,0,100,107111,1224,93
56161,2024,32,21,11,34,66,311494,3678,84
56162,2024,222,170,52,23,77,361630,3775,99
56163,2024,26,26,0,0,100,137584,1425,90
56164,2024,68,56,12,18,82,350398,3326,106
56165,2024,134,94,40,30,70,194767,2206,89
56166,2024,40,35,5,12,88,228209,2301,101
56167,2024,30,30,0,0,100,397899,3574,113
56168,2024,26,26,0,0,100,457356,4714,102
56169,2024,49,45,4,8,92,316460,3413,95
56170,2024,16,16,0,0,100,99588,1152,89
56171,2024,18,18,0,0,100,191514,2371,88
56172,2024,24,24,0,0,100,157986,1961,83
56173,2024,43,42,1,2,98,161542,1924,89
56174,2024,28,28,0,0,100,203384,2012,103
56175,2024,37,34,3,8,92,279885,2607,110
56176,2024,72,55,17,24,76,283710,3291,93
56177,2024,94,88,6,6,94,235769,2512,99
56178,2024,194,114,80,41,59,137001,1742,82
56179,2024,28,25,3,11,89,263704,2724,101
56180,2024,11,11,0,0,100,89654,1513,59
56181,2024,40,18,22,55,45,280005,3758,77
56182,2024,16,16,0,0,100,132712,1428,97
56184,2024,77,62,15,19,81,226384,2392,98
56185,2024,75,58,17,23,77,258463,2725,96
56186,2024,178,87,91,51,49,366988,5432,71
56188,2024,14,14,0,0,100,125610,1720,73
56189,2024,11,11,0,0,100,143782,1370,104
56190,2024,31,31,0,0,100,137734,1433,99
56191,2024,10,10,0,0,100,149439,1562,95
56193,2024,41,39,2,5,95,249602,2951,86
56194,2024,26,26,0,0,100,188988,1711,112
56195,2024,19,11,8,42,58,190464,2868,79
56196,2024,10,9,1,10,90,209233,2354,88
56197,2024,21,19,2,10,90,180347,1857,99
56198,2024,19,19,0,0,100,125918,1447,88
56199,2024,5,4,1,20,80,149600,1662,91
56200,2024,17,17,0,0,100,135768,1392,97
56201,2024,14,14,0,0,100,96404,1129,95
56202,2024,5,5,0,0,100,172420,1470,115
56203,2024,11,11,0,0,100,135358,1439,92
56204,2024,7,7,0,0,100,119702,1622,72
56205,2024,6,6,0,0,100,323000,3690,91
56206,2024,101,69,32,32,68,333426,3331,103
56207,2024,15,15,0,0,100,201160,1824,116
56208,2024,5,5,0,0,100,175800,2555,94
56209,2024,4,4,0,0,100,175589,1734,97
56210,2024,16,16,0,0,100,156894,1365,119
56211,2024,7,7,0,0,100,165029,1533,105
56212,2024,32,32,0,0,100,157786,2004,85
56213,2024,6,6,0,0,100,119494,1573,77
56214,2024,71,61,10,14,86,484127,5167,100
56215,2024,8,8,0,0,100,143062,1560,93
56216,2024,4,4,0,0,100,91250,1421,76
56218,2024,17,17,0,0,100,153507,1826,89
56219,2024,17,17,0,0,100,243720,2276,100
56220,2024,10,10,0,0,100,465198,3484,133
56221,2024,24,24,0,0,100,131713,1530,95
56222,2024,32,28,4,12,88,190784,1938,103
56223,2024,17,17,0,0,100,183814,1786,100
56224,2024,5,5,0,0,100,118000,1475,80
56225,2024,4,4,0,0,100,156850,1605,87
56226,2024,6,6,0,0,100,175333,2301,76
56227,2024,7,7,0,0,100,88406,1445,64
56228,2024,5,5,0,0,100,163154,2030,79
56229,2024,21,21,0,0,100,98575,1406,78
56230,2024,9,9,0,0,100,91644,1279,67
56231,2024,31,30,1,3,97,293276,2843,107
56232,2024,13,13,0,0,100,129782,1929,72
56233,2024,27,18,9,33,67,598621,5406,101
56234,2024,61,46,15,25,75,444678,5168,91
56236,2024,24,24,0,0,100,119575,1413,90
56237,2024,16,16,0,0,100,180906,1700,107
56238,2024,11,11,0,0,100,97140,1342,83
56239,2024,18,18,0,0,100,155842,1811,89
56240,2024,195,163,32,16,84,407535,4476,95
56241,2024,15,15,0,0,100,407114,5350,82
56242,2024,15,15,0,0,100,104187,1419,83
56243,2024,113,71,42,37,63,359095,4156,84
56244,2024,41,41,0,0,100,190471,2148,91
56245,2024,13,13,0,0,100,151601,1476,114
56246,2024,16,16,0,0,100,155709,1638,98
56247,2024,32,32,0,0,100,263317,2614,104
56248,2024,43,41,2,5,95,319180,2968,108
56249,2024,31,31,0,0,100,169726,1787,94
56250,2024,6,6,0,0,100,96506,1470,68
56251,2024,68,55,13,19,81,339351,3374,104
56252,2024,24,23,1,4,96,413102,3679,117
56253,2024,12,12,0,0,100,136108,1968,87
56254,2024,11,11,0,0,100,247610,2255,114
56255,2024,20,19,1,5,95,266440,2517,107
56256,2024,1,1,0,0,100,80000,2222,36
56257,2024,7,7,0,0,100,85071,853,98
56258,2024,40,24,16,40,60,561605,6158,97
56259,2024,12,12,0,0,100,246074,2511,104
56260,2024,854,267,587,69,31,310485,4054,76
56261,2024,9,9,0,0,100,246657,2013,122
56262,2024,33,27,6,18,82,462456,4457,103
56263,2024,28,28,0,0,100,335686,2889,117
56264,2024,7,7,0,0,100,96286,1076,87
58001,2024,4,4,0,0,100,117944,1302,88
58002,2024,18,18,0,0,100,127811,1348,100
58003,2024,14,14,0,0,100,128668,1525,90
58004,2024,4,4,0,0,100,103125,1319,86
58005,2024,6,6,0,0,100,53500,790,69
58006,2024,4,4,0,0,100,86000,1078,83
58007,2024,7,7,0,0,100,104557,1238,91
58008,2024,4,4,0,0,100,73550,883,71
58009,2024,1,1,0,0,100,51000,593,86
58010,2024,12,12,0,0,100,83412,1096,82
58011,2024,3,3,0,0,100,43667,585,74
58012,2024,14,14,0,0,100,97214,1118,91
58013,2024,3,3,0,0,100,42000,464,95
58014,2024,2,2,0,0,100,45250,920,52
58015,2024,3,3,0,0,100,93673,958,110
58017,2024,8,8,0,0,100,78903,1284,66
58019,2024,1,1,0,0,100,21950,448,49
58020,2024,1,1,0,0,100,250000,2404,104
58021,2024,4,4,0,0,100,184750,1810,116
58024,2024,5,5,0,0,100,64120,951,73
58025,2024,2,2,0,0,100,71500,866,86
58026,2024,1,1,0,0,100,240000,889,270
58027,2024,2,2,0,0,100,109500,1055,104
58029,2024,3,3,0,0,100,52667,928,61
58030,2024,6,6,0,0,100,81150,1166,73
58031,2024,1,1,0,0,100,115000,1198,96
58032,2024,1,1,0,0,100,31000,360,86
58033,2024,8,8,0,0,100,107250,1482,75
58034,2024,3,3,0,0,100,95333,944,100
58035,2024,1,1,0,0,100,29000,1036,28
58036,2024,9,8,1,11,89,84111,934,90
58037,2024,14,14,0,0,100,114998,1489,79
58039,2024,3,3,0,0,100,136000,726,154
58040,2024,1,1,0,0,100,32000,516,62
58041,2024,4,4,0,0,100,65250,912,70
58042,2024,2,2,0,0,100,37500,412,90
58043,2024,1,1,0,0,100,82000,1171,70
58044,2024,15,15,0,0,100,109650,1451,77
58045,2024,2,2,0,0,100,47000,799,51
58046,2024,33,27,6,18,82,78252,971,80
58047,2024,10,10,0,0,100,93335,1381,74
58048,2024,3,3,0,0,100,49333,617,77
58049,2024,1,1,0,0,100,70000,769,91
58050,2024,1,1,0,0,100,151650,2757,55
58051,2024,10,10,0,0,100,119220,1350,88
58052,2024,1,1,0,0,100,50000,575,87
58053,2024,5,5,0,0,100,60100,997,69
58055,2024,4,4,0,0,100,74228,1004,72
58056,2024,1,1,0,0,100,148900,1128,132
58057,2024,20,20,0,0,100,78625,1002,81
58058,2024,3,3,0,0,100,171667,1489,107
58059,2024,60,53,7,12,88,97999,1172,85
58060,2024,8,8,0,0,100,137725,1458,98
58062,2024,12,12,0,0,100,55767,881,68
58063,2024,8,8,0,0,100,102425,1247,82
58064,2024,12,12,0,0,100,86338,802,113
58065,2024,11,10,1,9,91,72764,821,84
58066,2024,4,4,0,0,100,130252,1572,79
58067,2024,13,13,0,0,100,126048,1305,92
58068,2024,9,9,0,0,100,106439,1638,66
58069,2024,4,4,0,0,100,133000,1376,86
58070,2024,4,4,0,0,100,74750,966,86
58071,2024,3,2,1,33,67,31167,370,86
58072,2024,8,8,0,0,100,120000,1419,84
58073,2024,4,4,0,0,100,40000,700,56
58074,2024,7,7,0,0,100,65412,751,100
58075,2024,5,5,0,0,100,83900,953,87
58076,2024,1,1,0,0,100,175000,2917,60
58077,2024,4,4,0,0,100,46250,630,87
58079,2024,36,31,5,14,86,68582,899,81
58080,2024,4,4,0,0,100,112351,2176,81
58081,2024,11,11,0,0,100,91273,909,101
58082,2024,13,13,0,0,100,89846,1406,64
58083,2024,26,25,1,4,96,87923,1072,84
58084,2024,4,4,0,0,100,60375,653,95
58085,2024,13,13,0,0,100,64462,737,92
58086,2024,158,137,21,13,87,111584,1256,89
58087,2024,5,5,0,0,100,73620,1031,72
58088,2024,47,39,8,17,83,130698,1434,89
58089,2024,6,6,0,0,100,74650,872,91
58090,2024,4,4,0,0,100,116500,1031,100
58092,2024,7,7,0,0,100,73500,1086,75
58094,2024,5,5,0,0,100,141200,1542,122
58095,2024,77,43,34,44,56,70473,999,70
58096,2024,5,5,0,0,100,119000,1011,111
58097,2024,1,1,0,0,100,30000,652,46
58099,2024,1,1,0,0,100,60000,811,74
58101,2024,3,3,0,0,100,90333,569,169
58102,2024,21,19,2,10,90,132931,1800,80
58103,2024,4,4,0,0,100,73500,890,93
58104,2024,9,9,0,0,100,98831,930,103
58105,2024,2,2,0,0,100,25000,552,47
58106,2024,9,9,0,0,100,147734,1058,124
58107,2024,4,4,0,0,100,100781,1089,96
58108,2024,2,2,0,0,100,154900,1050,168
58109,2024,13,13,0,0,100,110346,899,106
58110,2024,1,1,0,0,100,35000,583,60
58111,2024,4,4,0,0,100,69375,938,65
58112,2024,10,10,0,0,100,153833,1395,100
58113,2024,3,3,0,0,100,123667,1628,73
58114,2024,4,4,0,0,100,86975,1006,83
58115,2024,4,4,0,0,100,64250,789,75
58116,2024,2,2,0,0,100,62000,1060,76
58117,2024,37,21,16,43,57,80231,1028,80
58118,2024,3,3,0,0,100,96000,1168,85
58120,2024,4,4,0,0,100,90888,1832,60
58121,2024,38,30,8,21,79,92620,1108,82
58122,2024,8,8,0,0,100,84406,1197,85
58123,2024,3,3,0,0,100,163283,1219,131
58124,2024,12,12,0,0,100,142408,1637,100
58125,2024,2,2,0,0,100,60000,840,72
58126,2024,3,3,0,0,100,82483,854,78
58127,2024,7,7,0,0,100,64786,870,77
58128,2024,3,3,0,0,100,156750,1634,115
58129,2024,3,3,0,0,100,90025,1039,86
58130,2024,2,2,0,0,100,65000,724,89
58131,2024,20,20,0,0,100,101248,1244,81
58132,2024,5,5,0,0,100,98930,863,109
58133,2024,1,1,0,0,100,75000,882,85
58134,2024,31,27,4,13,87,69319,893,80
58135,2024,3,3,0,0,100,76270,1511,59
58136,2024,1,1,0,0,100,285000,1425,200
58138,2024,4,4,0,0,100,122000,1066,120
58139,2024,3,3,0,0,100,189000,2467,72
58140,2024,10,10,0,0,100,79215,1082,76
58141,2024,3,3,0,0,100,65367,798,75
58142,2024,6,5,1,17,83,58333,668,90
58143,2024,2,2,0,0,100,46750,1236,42
58144,2024,11,11,0,0,100,89245,1041,87
58145,2024,17,16,1,6,94,94594,985,87
58146,2024,12,11,1,8,92,86090,1234,67
58147,2024,4,4,0,0,100,70625,540,130
58148,2024,10,10,0,0,100,106180,1149,94
58149,2024,25,25,0,0,100,100165,1161,86
58150,2024,3,3,0,0,100,105233,905,92
58151,2024,48,47,1,2,98,67277,929,69
58152,2024,18,18,0,0,100,128398,1644,91
58153,2024,1,1,0,0,100,42500,850,50
58154,2024,5,5,0,0,100,102600,1455,74
58155,2024,10,10,0,0,100,112270,1266,88
58156,2024,1,1,0,0,100,19000,760,25
58157,2024,5,5,0,0,100,138200,1256,110
58158,2024,3,3,0,0,100,141667,1764,78
58159,2024,1,1,0,0,100,25000,610,41
58160,2024,23,20,3,13,87,150996,1570,90
58161,2024,2,2,0,0,100,23500,444,56
58163,2024,6,6,0,0,100,78983,907,89
58164,2024,4,4,0,0,100,103000,1346,88
58165,2024,3,3,0,0,100,197000,1825,99
58166,2024,6,6,0,0,100,59833,870,77
58168,2024,5,5,0,0,100,168343,1550,107
58169,2024,1,1,0,0,100,343050,2560,134
58170,2024,2,2,0,0,100,93750,1914,51
58171,2024,4,4,0,0,100,198750,965,135
58172,2024,1,1,0,0,100,50000,909,55
58173,2024,7,7,0,0,100,84017,1068,78
58174,2024,3,3,0,0,100,109467,1400,71
58175,2024,2,2,0,0,100,207500,1468,123
58176,2024,9,9,0,0,100,166172,1306,122
58177,2024,3,3,0,0,100,135133,1674,78
58178,2024,3,3,0,0,100,67333,1186,66
58179,2024,12,12,0,0,100,71656,790,87
58180,2024,14,14,0,0,100,110835,1388,90
58181,2024,3,3,0,0,100,63000,849,73
58182,2024,23,23,0,0,100,85565,1061,82
58183,2024,2,2,0,0,100,82500,907,80
58184,2024,11,11,0,0,100,85275,1006,85
58185,2024,16,16,0,0,100,97029,1230,87
58186,2024,1,1,0,0,100,110000,909,121
58187,2024,11,11,0,0,100,92909,1138,83
58188,2024,2,2,0,0,100,102250,686,138
58189,2024,8,8,0,0,100,145050,1402,90
58190,2024,2,2,0,0,100,116000,1116,110
58191,2024,3,3,0,0,100,88333,1242,66
58193,2024,22,21,1,5,95,81316,952,89
58194,2024,476,172,304,64,36,95909,1233,76
58195,2024,4,4,0,0,100,75062,913,82
58196,2024,1,1,0,0,100,40000,889,45
58197,2024,2,2,0,0,100,30000,754,39
58198,2024,2,2,0,0,100,59914,590,100
58199,2024,5,5,0,0,100,121600,1101,132
58200,2024,4,4,0,0,100,45250,663,68
58201,2024,2,2,0,0,100,53000,558,85
58202,2024,1,1,0,0,100,24000,436,55
58204,2024,10,10,0,0,100,98250,1061,90
58205,2024,15,15,0,0,100,71121,941,77
58206,2024,2,2,0,0,100,138000,830,170
58207,2024,2,2,0,0,100,209000,1641,122
58208,2024,1,1,0,0,100,145000,1368,106
58209,2024,3,3,0,0,100,86667,806,105
58210,2024,12,12,0,0,100,91914,964,90
58211,2024,1,1,0,0,100,49000,521,94
58212,2024,3,3,0,0,100,225333,1939,113
58213,2024,6,6,0,0,100,79500,1077,80
58214,2024,30,27,3,10,90,127784,1356,93
58215,2024,28,28,0,0,100,87739,1059,83
58216,2024,3,3,0,0,100,91667,1375,68
58217,2024,2,2,0,0,100,46500,709,66
58218,2024,20,20,0,0,100,79961,860,88
58219,2024,5,5,0,0,100,115154,1071,101
58220,2024,4,4,0,0,100,102250,1544,71
58221,2024,4,4,0,0,100,133500,1514,90
58222,2024,3,3,0,0,100,91833,1410,61
58223,2024,8,8,0,0,100,175463,2310,95
58225,2024,3,2,1,33,67,82333,903,96
58226,2024,3,3,0,0,100,72210,873,80
58227,2024,15,14,1,7,93,145661,1655,85
58228,2024,5,5,0,0,100,96380,889,104
58229,2024,7,7,0,0,100,129943,1167,92
58230,2024,1,1,0,0,100,62000,721,86
58231,2024,5,5,0,0,100,106200,1026,95
58232,2024,13,13,0,0,100,74200,970,77
58233,2024,4,4,0,0,100,79600,1316,86
58234,2024,2,2,0,0,100,30000,648,46
58235,2024,8,8,0,0,100,79312,1162,67
58236,2024,4,4,0,0,100,136875,1095,112
58238,2024,25,25,0,0,100,146760,1588,93
58240,2024,5,5,0,0,100,107000,1269,80
58241,2024,6,6,0,0,100,77750,975,80
58245,2024,4,4,0,0,100,52500,679,80
58246,2024,19,19,0,0,100,77103,1127,65
58247,2024,4,4,0,0,100,121250,1224,94
58248,2024,2,2,0,0,100,79000,1234,80
58249,2024,4,4,0,0,100,69600,1250,61
58250,2024,20,20,0,0,100,88928,1116,79
58251,2024,3,3,0,0,100,99167,739,155
58252,2024,6,6,0,0,100,92867,740,131
58253,2024,2,2,0,0,100,154000,1872,84
58254,2024,8,8,0,0,100,127625,1184,108
58255,2024,5,5,0,0,100,106050,844,115
58258,2024,5,5,0,0,100,132480,1293,103
58259,2024,1,1,0,0,100,65000,890,73
58260,2024,15,15,0,0,100,96880,990,103
58261,2024,11,11,0,0,100,105127,1071,100
58262,2024,4,4,0,0,100,96625,671,160
58263,2024,2,2,0,0,100,54000,895,59
58264,2024,26,26,0,0,100,87381,1179,76
58265,2024,2,2,0,0,100,73850,1138,68
58266,2024,3,3,0,0,100,84167,727,120
58267,2024,10,9,1,10,90,73195,934,83
58268,2024,3,3,0,0,100,90000,1424,84
58269,2024,7,7,0,0,100,111171,1104,99
58270,2024,12,12,0,0,100,94538,1075,83
58271,2024,3,3,0,0,100,107000,983,88
58272,2024,3,3,0,0,100,61167,606,104
58273,2024,16,16,0,0,100,134781,1207,110
58274,2024,1,1,0,0,100,80000,930,86
58275,2024,2,2,0,0,100,97500,1047,92
58276,2024,6,6,0,0,100,112025,1166,90
58277,2024,3,3,0,0,100,104833,1811,62
58278,2024,11,10,1,9,91,135045,1356,102
58279,2024,1,1,0,0,100,25000,463,54
58280,2024,4,4,0,0,100,214000,1684,124
58281,2024,20,20,0,0,100,116778,1170,100
58282,2024,9,9,0,0,100,95167,1149,77
58283,2024,2,2,0,0,100,96000,1417,73
58285,2024,5,5,0,0,100,33000,640,52
58286,2024,10,10,0,0,100,56650,653,89
58287,2024,6,6,0,0,100,117798,1042,116
58289,2024,8,8,0,0,100,100649,953,98
58291,2024,2,2,0,0,100,86000,754,130
58292,2024,3,3,0,0,100,44333,595,76
58293,2024,8,8,0,0,100,119700,1263,106
58294,2024,2,2,0,0,100,104788,942,112
58295,2024,13,13,0,0,100,89446,956,93
58296,2024,2,2,0,0,100,75000,549,130
58297,2024,4,4,0,0,100,100375,940,102
58298,2024,1,1,0,0,100,108000,1091,99
58299,2024,1,1,0,0,100,60000,561,107
58300,2024,12,12,0,0,100,124542,1308,97
58301,2024,7,7,0,0,100,100106,942,99
58302,2024,10,10,0,0,100,100230,1184,88
58303,2024,90,71,19,21,79,139283,1647,84
58304,2024,15,14,1,7,93,72573,942,76
58305,2024,5,5,0,0,100,84240,847,90
58306,2024,6,6,0,0,100,58417,842,70
58307,2024,2,2,0,0,100,33000,593,57
58308,2024,1,1,0,0,100,155250,1805,86
58309,2024,16,16,0,0,100,101712,1296,80
58310,2024,2,2,0,0,100,54500,552,102
58311,2024,2,2,0,0,100,36125,394,92
58313,2024,4,4,0,0,100,87061,1030,84
59001,2024,4,4,0,0,100,164575,1372,126
59002,2024,32,32,0,0,100,98611,1136,90
59003,2024,2,2,0,0,100,167150,1190,132
59004,2024,9,9,0,0,100,364183,2401,154
59005,2024,25,25,0,0,100,231904,2299,101
59006,2024,2,2,0,0,100,319550,1902,146
59007,2024,6,6,0,0,100,95000,1273,71
59008,2024,84,84,0,0,100,115427,1270,93
59009,2024,557,382,175,31,69,266280,2978,89
59010,2024,5,5,0,0,100,197000,1651,150
59011,2024,83,76,7,8,92,206393,2193,94
59012,2024,21,21,0,0,100,149122,1491,103
59013,2024,11,10,1,9,91,392831,3095,130
59014,2024,121,101,20,17,83,97114,1256,83
59015,2024,43,43,0,0,100,153473,1617,96
59016,2024,18,18,0,0,100,219944,2115,104
59017,2024,299,217,82,27,73,149875,1965,81
59018,2024,13,13,0,0,100,204054,1957,107
59019,2024,9,9,0,0,100,243696,1882,125
59021,2024,10,10,0,0,100,148414,1603,96
59022,2024,23,23,0,0,100,255200,2562,101
59023,2024,10,10,0,0,100,197465,2084,99
59024,2024,54,54,0,0,100,129421,1332,98
59025,2024,19,18,1,5,95,298466,2931,108
59026,2024,10,10,0,0,100,153979,1482,98
59027,2024,16,16,0,0,100,172639,1831,95
59028,2024,54,54,0,0,100,122697,1466,84
59029,2024,22,22,0,0,100,322674,2552,127
59031,2024,5,5,0,0,100,253819,1797,133
59032,2024,73,56,17,23,77,130935,1884,78
59033,2024,76,73,3,4,96,106512,1192,92
59034,2024,23,19,4,17,83,355375,2977,124
59035,2024,27,27,0,0,100,139064,1273,104
59036,2024,36,36,0,0,100,93886,966,95
59037,2024,48,48,0,0,100,106337,1186,91
59038,2024,9,9,0,0,100,176434,1374,123
59039,2024,5,5,0,0,100,203170,1980,105
59041,2024,15,15,0,0,100,139447,1417,107
59042,2024,22,22,0,0,100,280599,2966,94
59043,2024,159,120,39,25,75,202533,2369,88
59044,2024,56,54,2,4,96,283191,2851,101
59045,2024,2,2,0,0,100,145500,1282,118
59046,2024,9,9,0,0,100,212606,1946,111
59047,2024,2,2,0,0,100,127660,1409,82
59048,2024,6,6,0,0,100,197964,1570,129
59049,2024,4,4,0,0,100,108225,773,124
59050,2024,4,4,0,0,100,195175,1092,178
59051,2024,83,77,6,7,93,162621,2050,89
59052,2024,40,40,0,0,100,177364,2009,91
59053,2024,30,29,1,3,97,147132,1432,102
59054,2024,17,17,0,0,100,200028,1850,112
59055,2024,10,10,0,0,100,129340,1345,101
59056,2024,6,6,0,0,100,329725,2099,166
59057,2024,4,4,0,0,100,151450,1300,123
59058,2024,13,13,0,0,100,160446,1623,101
59059,2024,3,3,0,0,100,115550,833,155
59060,2024,3,3,0,0,100,76667,781,93
59061,2024,1,1,0,0,100,78000,586,133
59063,2024,35,33,2,6,94,119198,1150,102
59064,2024,5,5,0,0,100,186800,2010,94
59065,2024,5,5,0,0,100,108582,1169,95
59066,2024,1,1,0,0,100,99350,1183,84
59067,2024,34,25,9,26,74,195894,2376,83
59068,2024,28,28,0,0,100,129790,1304,102
59069,2024,6,6,0,0,100,148449,1305,113
59070,2024,1,1,0,0,100,251500,1863,135
59071,2024,24,24,0,0,100,238988,2408,105
59072,2024,3,3,0,0,100,214017,2015,107
59073,2024,2,2,0,0,100,339300,2839,115
59074,2024,23,23,0,0,100,126372,1207,104
59075,2024,6,6,0,0,100,110017,1025,116
59076,2024,3,3,0,0,100,185473,1765,105
59078,2024,8,8,0,0,100,166995,1260,128
59079,2024,51,43,8,16,84,113046,1336,85
59080,2024,28,28,0,0,100,233108,2234,106
59081,2024,8,8,0,0,100,154496,1476,105
59082,2024,20,20,0,0,100,235296,2138,111
59083,2024,5,5,0,0,100,268370,2080,130
59084,2024,12,12,0,0,100,207837,1919,109
59085,2024,2,2,0,0,100,115050,1382,76
59086,2024,26,26,0,0,100,208326,2236,96
59087,2024,4,4,0,0,100,244950,1896,117
59088,2024,17,11,6,35,65,223447,2823,80
59089,2024,14,14,0,0,100,181696,1839,102
59090,2024,100,87,13,13,87,515800,4243,120
59091,2024,7,7,0,0,100,240836,2216,116
59092,2024,50,50,0,0,100,145778,1575,94
59093,2024,1,1,0,0,100,53000,535,99
59094,2024,86,74,12,14,86,146214,1695,92
59096,2024,17,17,0,0,100,360153,2856,127
59097,2024,3,3,0,0,100,112058,806,130
59098,2024,52,44,8,15,85,274098,2752,102
59099,2024,13,13,0,0,100,146597,1395,103
59100,2024,5,5,0,0,100,268280,2189,130
59101,2024,5,5,0,0,100,103729,1254,82
59102,2024,4,4,0,0,100,65000,758,87
59103,2024,7,7,0,0,100,196471,1738,119
59104,2024,34,34,0,0,100,111459,1251,91
59105,2024,17,17,0,0,100,278666,2004,140
59106,2024,4,4,0,0,100,328805,3212,100
59107,2024,131,52,79,60,40,189027,3146,68
59108,2024,5,5,0,0,100,101750,1117,97
59109,2024,9,9,0,0,100,222333,2179,100
59110,2024,14,14,0,0,100,212789,1948,108
59111,2024,1,1,0,0,100,180000,853,211
59112,2024,86,86,0,0,100,126432,1396,90
59113,2024,10,10,0,0,100,192672,1979,93
59114,2024,18,17,1,6,94,199023,1995,99
59115,2024,9,9,0,0,100,188667,1864,101
59116,2024,6,6,0,0,100,233842,1929,132
59117,2024,5,5,0,0,100,172000,1413,121
59118,2024,20,20,0,0,100,96037,1103,95
59119,2024,4,4,0,0,100,194250,1970,104
59120,2024,22,22,0,0,100,240130,1951,126
59121,2024,6,6,0,0,100,183900,1584,121
59122,2024,430,303,127,30,70,129038,1529,86
59123,2024,12,12,0,0,100,242382,2469,99
59124,2024,15,15,0,0,100,391028,3444,116
59125,2024,2,2,0,0,100,310000,2106,138
59126,2024,14,14,0,0,100,166300,1733,101
59127,2024,1,1,0,0,100,269000,1818,148
59128,2024,22,15,7,32,68,297759,3139,96
59129,2024,20,20,0,0,100,290837,2927,102
59130,2024,10,10,0,0,100,184985,1779,107
59131,2024,84,81,3,4,96,166423,1807,92
59132,2024,5,5,0,0,100,162473,1470,120
59133,2024,12,11,1,8,92,273167,2647,103
59134,2024,14,14,0,0,100,164214,1575,108
59135,2024,25,24,1,4,96,269864,2065,134
59136,2024,66,60,6,9,91,76680,878,91
59137,2024,7,7,0,0,100,66596,938,77
59138,2024,7,7,0,0,100,128051,1106,112
59139,2024,149,127,22,15,85,88890,1093,83
59140,2024,3,3,0,0,100,85667,916,95
59141,2024,6,6,0,0,100,142333,1410,97
59142,2024,8,8,0,0,100,168806,1801,92
59143,2024,93,76,17,18,82,253016,2508,100
59144,2024,5,5,0,0,100,218300,1762,125
59145,2024,2,2,0,0,100,280250,2357,119
59146,2024,36,33,3,8,92,335579,3384,99
59148,2024,2,2,0,0,100,211500,2344,91
59149,2024,13,13,0,0,100,98442,1060,99
59150,2024,9,9,0,0,100,378038,2907,135
59151,2024,14,14,0,0,100,133933,1257,106
59152,2024,117,97,20,17,83,213352,2329,92
59153,2024,72,59,13,18,82,122203,1400,86
59155,2024,239,204,35,15,85,146693,1824,82
59156,2024,29,23,6,21,79,127444,1647,82
59157,2024,17,17,0,0,100,102709,1098,105
59158,2024,35,35,0,0,100,287825,2604,113
59159,2024,6,6,0,0,100,286958,2168,147
59160,2024,47,47,0,0,100,111819,1269,87
59161,2024,12,12,0,0,100,162278,1480,104
59162,2024,3,3,0,0,100,209233,1437,190
59163,2024,288,189,99,34,66,260399,2838,86
59164,2024,2,2,0,0,100,112250,818,152
59165,2024,63,62,1,2,98,150038,1709,88
59166,2024,10,10,0,0,100,238780,2185,107
59167,2024,1,1,0,0,100,162500,1213,134
59168,2024,52,46,6,12,88,300575,3013,102
59169,2024,1,1,0,0,100,184000,1243,148
59170,2024,41,41,0,0,100,122473,1449,85
59172,2024,160,156,4,2,98,73468,926,82
59173,2024,10,10,0,0,100,355491,2908,121
59174,2024,1,1,0,0,100,150000,1500,100
59175,2024,2,2,0,0,100,323800,3751,88
59176,2024,5,5,0,0,100,178268,1567,115
59177,2024,8,8,0,0,100,102369,1101,92
59178,2024,402,214,188,47,53,130782,1619,84
59179,2024,75,75,0,0,100,130941,1349,97
59180,2024,14,14,0,0,100,260686,2122,119
59181,2024,7,7,0,0,100,173357,1278,127
59182,2024,3,3,0,0,100,236444,1779,133
59183,2024,1014,580,434,43,57,181532,2195,85
59184,2024,6,6,0,0,100,141128,1297,116
59185,2024,6,6,0,0,100,161012,1407,118
59186,2024,2,2,0,0,100,289000,2408,114
59187,2024,4,4,0,0,100,208325,1580,121
59188,2024,1,1,0,0,100,100000,1370,73
59189,2024,9,9,0,0,100,250722,2294,112
59190,2024,10,10,0,0,100,146435,1447,103
59191,2024,7,7,0,0,100,92434,1109,81
59192,2024,7,7,0,0,100,134673,1472,90
59193,2024,34,33,1,3,97,298526,2666,108
59194,2024,11,11,0,0,100,157983,1400,113
59195,2024,7,7,0,0,100,343137,3091,112
59196,2024,16,14,2,12,88,399098,3745,105
59197,2024,20,20,0,0,100,306558,2674,111
59198,2024,3,3,0,0,100,296000,2897,105
59199,2024,4,4,0,0,100,142395,1546,93
59200,2024,2,2,0,0,100,284250,1884,150
59201,2024,4,4,0,0,100,403432,2728,142
59202,2024,54,46,8,15,85,191841,2263,84
59203,2024,8,8,0,0,100,155671,2238,93
59204,2024,4,4,0,0,100,103125,991,102
59205,2024,67,67,0,0,100,117138,1323,88
59206,2024,42,42,0,0,100,109815,1249,90
59207,2024,30,30,0,0,100,97265,1194,80
59208,2024,1,1,0,0,100,150000,1364,110
59209,2024,9,9,0,0,100,119172,1335,95
59210,2024,28,27,1,4,96,202610,1976,104
59211,2024,5,5,0,0,100,223514,1789,132
59212,2024,67,64,3,4,96,194132,2059,95
59213,2024,7,7,0,0,100,186050,1540,121
59214,2024,6,6,0,0,100,208958,1888,105
59215,2024,14,14,0,0,100,209607,1714,111
59216,2024,3,3,0,0,100,151100,1561,104
59217,2024,4,4,0,0,100,273588,2053,148
59218,2024,9,9,0,0,100,113667,892,125
59219,2024,2,2,0,0,100,161515,1279,118
59220,2024,220,174,46,21,79,201301,2530,80
59221,2024,30,16,14,47,53,107587,1799,62
59222,2024,29,29,0,0,100,300150,2640,118
59223,2024,1,1,0,0,100,100000,637,157
59224,2024,15,15,0,0,100,98661,1124,87
59225,2024,73,73,0,0,100,126766,1265,103
59226,2024,17,17,0,0,100,114641,1032,108
59227,2024,43,42,1,2,98,149681,1617,97
59228,2024,16,16,0,0,100,177431,1800,102
59229,2024,3,3,0,0,100,215000,2079,105
59230,2024,54,45,9,17,83,113425,1546,90
59231,2024,9,9,0,0,100,120656,1154,104
59232,2024,5,5,0,0,100,197560,2455,87
59233,2024,7,7,0,0,100,171731,1519,114
59234,2024,40,39,1,2,98,144798,1563,90
59236,2024,4,4,0,0,100,158175,1055,157
59237,2024,10,10,0,0,100,294889,2172,136
59238,2024,16,16,0,0,100,167269,1493,112
59239,2024,61,60,1,2,98,199073,1958,104
59241,2024,5,5,0,0,100,152840,1163,124
59242,2024,4,4,0,0,100,131300,1607,80
59243,2024,12,10,2,17,83,113650,1535,90
59244,2024,11,11,0,0,100,177583,1604,105
59246,2024,4,4,0,0,100,170715,1413,128
59247,2024,18,18,0,0,100,261281,2963,92
59249,2024,99,93,6,6,94,112357,1158,94
59250,2024,25,25,0,0,100,306494,2719,111
59251,2024,1,1,0,0,100,180000,1800,100
59252,2024,32,32,0,0,100,328866,2896,119
59253,2024,63,61,2,3,97,104849,1222,85
59254,2024,15,15,0,0,100,172833,1746,99
59255,2024,3,3,0,0,100,167333,1614,103
59256,2024,51,50,1,2,98,257655,2772,94
59257,2024,8,8,0,0,100,338381,3461,108
59258,2024,21,19,2,10,90,277280,2648,111
59259,2024,2,2,0,0,100,271996,2269,121
59260,2024,46,45,1,2,98,221308,2279,104
59261,2024,17,17,0,0,100,116518,1165,102
59262,2024,22,22,0,0,100,229015,2007,119
59263,2024,15,15,0,0,100,258520,2185,121
59264,2024,12,12,0,0,100,141415,1433,101
59265,2024,24,24,0,0,100,160187,1589,103
59266,2024,43,41,2,5,95,227576,2425,96
59267,2024,2,2,0,0,100,86000,698,120
59268,2024,53,48,5,9,91,163681,1798,92
59269,2024,14,14,0,0,100,111450,1260,89
59270,2024,6,6,0,0,100,153000,1404,131
59271,2024,74,60,14,19,81,136930,1498,91
59272,2024,53,53,0,0,100,125228,1588,80
59273,2024,102,80,22,22,78,181021,1967,93
59275,2024,5,5,0,0,100,573580,3825,149
59276,2024,23,23,0,0,100,153685,1530,100
59277,2024,1,1,0,0,100,238000,2125,112
59278,2024,39,39,0,0,100,285361,2660,105
59279,2024,196,164,32,16,84,176737,2171,83
59280,2024,8,8,0,0,100,132760,1615,77
59281,2024,9,9,0,0,100,248943,2502,97
59282,2024,7,7,0,0,100,203939,1940,102
59283,2024,4,4,0,0,100,188306,1702,116
59284,2024,35,30,5,14,86,174857,1882,92
59285,2024,25,25,0,0,100,129151,1345,98
59286,2024,149,107,42,28,72,171684,2324,76
59287,2024,1,1,0,0,100,120000,1200,100
59288,2024,21,21,0,0,100,122818,1271,93
59289,2024,24,24,0,0,100,136052,1273,107
59290,2024,5,5,0,0,100,155680,1344,121
59291,2024,96,94,2,2,98,100531,1125,91
59292,2024,25,25,0,0,100,106990,1287,81
59293,2024,16,15,1,6,94,146022,1700,90
59295,2024,236,200,36,15,85,178105,1995,90
59296,2024,5,5,0,0,100,171728,1231,141
59297,2024,19,19,0,0,100,132042,1384,94
59299,2024,142,133,9,6,94,317105,2906,105
59300,2024,6,6,0,0,100,177746,1472,118
59301,2024,32,32,0,0,100,181727,1738,107
59302,2024,45,45,0,0,100,140044,1323,109
59303,2024,15,15,0,0,100,353257,2839,125
59304,2024,4,4,0,0,100,248538,2468,92
59305,2024,18,18,0,0,100,233071,2448,96
59306,2024,2,2,0,0,100,182808,1586,109
59307,2024,10,10,0,0,100,139700,1612,90
59308,2024,10,10,0,0,100,222346,1810,113
59309,2024,44,44,0,0,100,174149,1801,98
59310,2024,11,10,1,9,91,268364,2257,123
59311,2024,6,6,0,0,100,66450,771,90
59312,2024,10,10,0,0,100,98770,1021,107
59313,2024,14,14,0,0,100,148650,1413,101
59314,2024,21,21,0,0,100,172197,1623,105
59315,2024,12,12,0,0,100,158142,1597,112
59316,2024,30,30,0,0,100,226124,2451,93
59317,2024,84,82,2,2,98,202391,2299,86
59318,2024,9,9,0,0,100,210632,1975,114
59319,2024,21,21,0,0,100,245183,2164,117
59320,2024,16,16,0,0,100,215030,2072,99
59321,2024,4,4,0,0,100,160640,864,196
59322,2024,38,37,1,3,97,119084,1212,101
59323,2024,10,10,0,0,100,224342,2126,100
59324,2024,75,73,2,3,97,109098,1232,92
59325,2024,4,4,0,0,100,160575,1359,120
59326,2024,10,10,0,0,100,166900,1427,124
59327,2024,55,49,6,11,89,142247,1620,87
59328,2024,384,263,121,32,68,311012,3536,87
59329,2024,47,42,5,11,89,144340,1720,84
59330,2024,24,24,0,0,100,311125,2762,116
59331,2024,34,33,1,3,97,110141,1210,94
59332,2024,24,9,15,62,38,133114,1872,74
59333,2024,5,5,0,0,100,157300,1378,115
59334,2024,14,14,0,0,100,175811,1971,88
59335,2024,22,22,0,0,100,294665,2400,119
59336,2024,14,14,0,0,100,112242,1295,83
59337,2024,6,6,0,0,100,179108,2089,87
59338,2024,5,5,0,0,100,239860,2138,112
59339,2024,99,93,6,6,94,244439,2649,95
59340,2024,47,42,5,11,89,235685,2584,90
59341,2024,3,3,0,0,100,219850,1329,166
59342,2024,1,1,0,0,100,295000,1528,193
59343,2024,70,58,12,17,83,254564,2947,88
59344,2024,19,19,0,0,100,116689,1261,92
59345,2024,22,22,0,0,100,156303,1550,99
59346,2024,31,29,2,6,94,241897,2999,84
59347,2024,8,8,0,0,100,122875,1414,91
59348,2024,13,13,0,0,100,179801,1820,96
59349,2024,21,21,0,0,100,134495,1398,97
59350,2024,2906,821,2085,72,28,215065,3589,64
59351,2024,5,5,0,0,100,118275,1167,104
59352,2024,86,75,11,13,87,319586,3002,105
59353,2024,2,2,0,0,100,187400,2242,106
59354,2024,6,6,0,0,100,211218,2260,98
59356,2024,23,23,0,0,100,472036,3779,124
59357,2024,21,21,0,0,100,194707,1955,99
59358,2024,12,12,0,0,100,195600,1853,110
59359,2024,54,53,1,2,98,182872,1860,100
59360,2024,208,99,109,52,48,164224,2448,69
59361,2024,31,31,0,0,100,90680,1017,91
59363,2024,7,7,0,0,100,137643,1556,90
59364,2024,3,3,0,0,100,409767,4217,122
59365,2024,44,40,4,9,91,78342,994,81
59366,2024,7,7,0,0,100,243000,1938,125
59367,2024,159,120,39,25,75,189977,2323,84
59368,2024,327,119,208,64,36,256129,3406,77
59369,2024,43,41,2,5,95,157228,1440,110
59370,2024,10,9,1,10,90,205396,1937,102
59371,2024,5,5,0,0,100,386740,3047,129
59372,2024,3,3,0,0,100,154565,1289,118
59374,2024,4,4,0,0,100,125600,1272,102
59375,2024,47,45,2,4,96,176388,1914,91
59377,2024,25,25,0,0,100,161252,1480,108
59378,2024,494,300,194,39,61,381544,3986,91
59379,2024,5,5,0,0,100,138321,1283,106
59381,2024,6,6,0,0,100,152433,1829,81
59382,2024,16,16,0,0,100,124708,1002,124
59383,2024,120,109,11,9,91,127611,1542,84
59384,2024,11,10,1,9,91,125525,1142,120
59385,2024,26,26,0,0,100,101154,1237,83
59386,2024,120,102,18,15,85,261694,3291,82
59387,2024,15,15,0,0,100,121503,1356,90
59388,2024,18,18,0,0,100,267343,2471,112
59389,2024,32,32,0,0,100,132970,1297,100
59390,2024,33,32,1,3,97,129248,1362,93
59391,2024,10,10,0,0,100,108916,1274,91
59392,2024,266,182,84,32,68,98691,1196,84
59393,2024,6,6,0,0,100,140000,1955,68
59394,2024,5,5,0,0,100,81520,1239,68
59395,2024,5,5,0,0,100,147250,1344,111
59396,2024,13,13,0,0,100,215318,1915,122
59397,2024,8,8,0,0,100,176711,1643,109
59398,2024,36,35,1,3,97,575616,3610,156
59399,2024,11,11,0,0,100,266695,2089,127
59400,2024,87,85,2,2,98,168940,1789,94
59401,2024,15,15,0,0,100,238483,2142,114
59402,2024,5,5,0,0,100,209620,1993,108
59403,2024,8,8,0,0,100,212444,2155,99
59405,2024,3,3,0,0,100,158633,1052,144
59406,2024,8,8,0,0,100,86812,1061,82
59407,2024,9,9,0,0,100,148656,1563,89
59408,2024,10,10,0,0,100,211570,1885,113
59409,2024,26,26,0,0,100,128203,1309,99
59410,2024,212,119,93,44,56,196603,2507,74
59411,2024,16,16,0,0,100,269453,2231,112
59412,2024,3,3,0,0,100,85000,659,126
59413,2024,6,6,0,0,100,106317,1077,99
59414,2024,27,27,0,0,100,149145,1584,98
59416,2024,31,31,0,0,100,194545,1776,114
59418,2024,12,12,0,0,100,159025,1316,129
59419,2024,20,20,0,0,100,235989,2450,98
59421,2024,173,128,45,26,74,372794,3580,100
59422,2024,9,9,0,0,100,150139,1437,103
59423,2024,11,11,0,0,100,235853,2164,108
59424,2024,9,9,0,0,100,121111,1146,105
59425,2024,1,1,0,0,100,220000,1302,169
59426,2024,88,83,5,6,94,237865,2471,97
59427,2024,5,5,0,0,100,378240,3058,120
59428,2024,47,47,0,0,100,128732,1386,91
59429,2024,38,38,0,0,100,118628,1389,85
59430,2024,8,8,0,0,100,130375,1219,106
59431,2024,61,58,3,5,95,249692,2448,101
59432,2024,5,5,0,0,100,195300,1743,107
59433,2024,2,2,0,0,100,141000,1680,94
59434,2024,12,12,0,0,100,177355,1669,108
59435,2024,27,27,0,0,100,312155,2753,113
59436,2024,8,8,0,0,100,226200,2289,100
59437,2024,4,4,0,0,100,290000,2588,110
59438,2024,4,4,0,0,100,161275,1752,94
59439,2024,3,3,0,0,100,275587,2702,102
59440,2024,8,8,0,0,100,103262,1368,75
59441,2024,4,4,0,0,100,141750,1316,96
59442,2024,1,1,0,0,100,157500,1591,99
59443,2024,3,3,0,0,100,194367,1787,105
59444,2024,8,8,0,0,100,204075,2090,107
59445,2024,16,16,0,0,100,130112,1102,121
59446,2024,12,11,1,8,92,271833,1983,145
59447,2024,77,75,2,3,97,136696,1498,92
59448,2024,6,6,0,0,100,122383,1562,77
59449,2024,79,67,12,15,85,203928,2219,94
59450,2024,4,4,0,0,100,70000,758,96
59451,2024,5,5,0,0,100,146000,1248,119
59452,2024,43,43,0,0,100,181659,1934,96
59453,2024,10,10,0,0,100,198170,1969,96
59454,2024,5,4,1,20,80,189698,1804,105
59455,2024,12,12,0,0,100,141831,1598,95
59456,2024,39,35,4,10,90,131423,1576,85
59457,2024,98,81,17,17,83,225205,2616,86
59458,2024,12,12,0,0,100,364469,4047,94
59459,2024,30,29,1,3,97,135073,1510,89
59461,2024,2,2,0,0,100,146900,1203,124
59462,2024,62,41,21,34,66,234738,2642,90
59463,2024,9,9,0,0,100,266956,1948,132
59464,2024,35,34,1,3,97,134451,1230,106
59465,2024,5,5,0,0,100,148350,1265,114
59466,2024,23,20,3,13,87,296278,3025,96
59467,2024,30,30,0,0,100,122868,1142,114
59468,2024,3,3,0,0,100,193333,2348,84
59469,2024,4,4,0,0,100,265432,2306,122
59470,2024,23,22,1,4,96,302991,2899,105
59471,2024,20,20,0,0,100,190665,1757,106
59472,2024,13,13,0,0,100,108800,1131,99
59473,2024,1,1,0,0,100,332250,2200,151
59474,2024,11,11,0,0,100,113732,940,118
59475,2024,12,12,0,0,100,174400,1654,106
59476,2024,27,27,0,0,100,165876,1691,99
59477,2024,41,41,0,0,100,216479,2194,98
59478,2024,7,7,0,0,100,245541,1961,125
59479,2024,35,35,0,0,100,148397,1678,89
59480,2024,11,11,0,0,100,143832,1531,92
59481,2024,43,43,0,0,100,178418,1756,101
59482,2024,74,70,4,5,95,265485,2783,96
59483,2024,1,1,0,0,100,90000,1250,72
59484,2024,50,47,3,6,94,109229,1231,90
59485,2024,20,20,0,0,100,121508,1213,104
59486,2024,31,31,0,0,100,168564,1647,105
59487,2024,13,12,1,8,92,456308,3339,134
59488,2024,23,21,2,9,91,159412,1801,87
59489,2024,35,35,0,0,100,164509,1848,93
59491,2024,104,89,15,14,86,114898,1402,84
59492,2024,13,13,0,0,100,141538,1446,97
59493,2024,1,1,0,0,100,230000,1065,216
59494,2024,1,1,0,0,100,187000,1450,129
59495,2024,30,30,0,0,100,111582,1144,98
59496,2024,4,4,0,0,100,161125,1928,86
59497,2024,21,21,0,0,100,173820,1815,98
59498,2024,1,1,0,0,100,144800,1463,99
59499,2024,20,20,0,0,100,206298,1938,108
59500,2024,6,6,0,0,100,173833,1290,129
59501,2024,11,11,0,0,100,187425,1507,126
59502,2024,12,12,0,0,100,164029,1437,105
59503,2024,1,1,0,0,100,115000,1742,66
59504,2024,25,25,0,0,100,117104,1208,99
59505,2024,7,7,0,0,100,232743,2054,113
59506,2024,7,7,0,0,100,175950,1372,143
59507,2024,198,138,60,30,70,184560,2380,81
59508,2024,148,126,22,15,85,288411,2877,99
59509,2024,51,51,0,0,100,162471,1748,96
59511,2024,18,18,0,0,100,233560,2185,107
59512,2024,708,483,225,32,68,133652,1642,84
59513,2024,2,2,0,0,100,161150,1727,92
59514,2024,55,42,13,24,76,135057,1271,99
59515,2024,5,5,0,0,100,173520,1536,109
59516,2024,10,10,0,0,100,186364,1816,113
59517,2024,9,9,0,0,100,156844,1518,103
59518,2024,4,4,0,0,100,212375,1950,108
59519,2024,19,19,0,0,100,269427,2243,123
59520,2024,19,19,0,0,100,126783,1193,104
59521,2024,4,4,0,0,100,105825,1392,73
59522,2024,20,20,0,0,100,441178,3233,136
59523,2024,33,32,1,3,97,367607,3231,119
59524,2024,64,64,0,0,100,210428,2370,89
59525,2024,31,31,0,0,100,85934,924,94
59526,2024,134,128,6,4,96,159958,1758,93
59527,2024,161,98,63,39,61,249340,3325,75
59528,2024,13,13,0,0,100,118293,1278,93
59529,2024,1,1,0,0,100,45000,378,119
59530,2024,2,2,0,0,100,228900,1679,136
59531,2024,6,6,0,0,100,60917,773,64
59532,2024,2,2,0,0,100,174750,2628,68
59533,2024,18,18,0,0,100,122011,1359,91
59534,2024,7,7,0,0,100,158226,2310,86
59535,2024,9,9,0,0,100,347607,2738,127
59536,2024,8,8,0,0,100,357696,2374,152
59537,2024,5,5,0,0,100,170000,1670,97
59538,2024,1,1,0,0,100,120200,1279,94
59539,2024,9,9,0,0,100,193722,1884,102
59541,2024,10,10,0,0,100,139737,1262,106
59542,2024,6,6,0,0,100,209050,1494,150
59543,2024,5,5,0,0,100,129920,1183,114
59544,2024,100,73,27,27,73,162463,1934,86
59545,2024,16,16,0,0,100,108012,1092,102
59546,2024,8,8,0,0,100,231221,2191,106
59547,2024,7,7,0,0,100,122571,1271,97
59548,2024,5,5,0,0,100,214612,2064,125
59549,2024,3,3,0,0,100,258517,1867,139
59550,2024,36,36,0,0,100,170737,1888,91
59551,2024,11,11,0,0,100,358720,2998,118
59552,2024,1,1,0,0,100,65000,591,110
59553,2024,60,60,0,0,100,284126,2889,104
59554,2024,6,6,0,0,100,260250,2361,106
59555,2024,13,13,0,0,100,88579,963,93
59556,2024,2,2,0,0,100,114000,1058,108
59557,2024,22,17,5,23,77,156993,1750,90
59558,2024,25,25,0,0,100,157947,1606,95
59559,2024,19,19,0,0,100,299804,2470,117
59560,2024,115,97,18,16,84,202499,2372,88
59562,2024,5,5,0,0,100,137941,1296,110
59563,2024,1,1,0,0,100,150000,1351,111
59564,2024,20,18,2,10,90,134922,1518,87
59565,2024,7,7,0,0,100,247821,2001,122
59566,2024,49,43,6,12,88,220722,2643,84
59567,2024,2,2,0,0,100,192500,1591,121
59568,2024,3,3,0,0,100,193767,1286,185
59569,2024,154,130,24,16,84,117335,1341,85
59570,2024,8,8,0,0,100,286908,2259,131
59571,2024,64,63,1,2,98,111760,1203,97
59572,2024,25,24,1,4,96,123190,1329,90
59573,2024,2,2,0,0,100,253082,1944,136
59574,2024,107,99,8,7,93,126172,1466,88
59575,2024,1,1,0,0,100,370000,2202,168
59576,2024,12,12,0,0,100,212494,2206,96
59577,2024,10,10,0,0,100,166607,1807,93
59578,2024,18,18,0,0,100,155106,1434,104
59579,2024,17,17,0,0,100,208368,1937,108
59580,2024,47,47,0,0,100,218685,2149,101
59581,2024,34,33,1,3,97,205741,2169,94
59582,2024,10,10,0,0,100,214580,2501,90
59583,2024,6,6,0,0,100,150217,1472,117
59584,2024,12,12,0,0,100,199044,1660,136
59585,2024,34,29,5,15,85,254131,2657,99
59586,2024,83,75,8,10,90,271405,2852,96
59587,2024,2,2,0,0,100,192000,1792,112
59588,2024,76,70,6,8,92,265436,2469,110
59589,2024,24,24,0,0,100,132544,1404,89
59590,2024,4,4,0,0,100,180085,1806,104
59591,2024,4,4,0,0,100,128681,1367,90
59592,2024,48,46,2,4,96,222833,2120,102
59593,2024,9,9,0,0,100,214058,1414,160
59594,2024,14,14,0,0,100,223605,1787,130
59595,2024,7,7,0,0,100,174951,1652,116
59596,2024,3,3,0,0,100,263267,2207,119
59597,2024,4,4,0,0,100,92500,1199,82
59598,2024,36,33,3,8,92,245106,2633,96
59599,2024,1049,664,385,37,63,149741,1853,82
59600,2024,5,5,0,0,100,281514,2183,117
59601,2024,23,23,0,0,100,109691,1112,102
59602,2024,13,13,0,0,100,327427,3153,101
59603,2024,71,62,9,13,87,119599,1389,85
59604,2024,9,9,0,0,100,143268,1218,117
59605,2024,16,16,0,0,100,241954,2428,104
59606,2024,510,271,239,47,53,139578,1815,80
59607,2024,2,2,0,0,100,184500,1406,132
59608,2024,10,10,0,0,100,234800,2168,109
59609,2024,20,16,4,20,80,281584,2781,102
59610,2024,11,11,0,0,100,186794,1577,118
59611,2024,24,24,0,0,100,377398,3146,122
59612,2024,6,6,0,0,100,138583,1050,126
59613,2024,16,16,0,0,100,175612,1488,114
59614,2024,19,18,1,5,95,96891,1029,103
59615,2024,19,19,0,0,100,220101,1860,122
59616,2024,67,67,0,0,100,137328,1402,98
59617,2024,6,6,0,0,100,212500,1916,110
59618,2024,5,5,0,0,100,134220,1373,92
59619,2024,3,3,0,0,100,213091,1695,133
59620,2024,2,2,0,0,100,97500,910,117
59622,2024,13,13,0,0,100,147269,1550,91
59623,2024,8,8,0,0,100,135375,877,132
59624,2024,19,19,0,0,100,111271,975,121
59625,2024,5,5,0,0,100,69867,914,74
59626,2024,21,21,0,0,100,185032,1870,107
59627,2024,6,6,0,0,100,170600,1751,101
59628,2024,9,9,0,0,100,213988,1534,128
59629,2024,19,19,0,0,100,168046,1827,97
59630,2024,24,24,0,0,100,168842,2047,84
59631,2024,22,22,0,0,100,97601,990,100
59632,2024,36,35,1,3,97,157036,1555,101
59633,2024,4,4,0,0,100,116125,1466,92
59634,2024,6,6,0,0,100,232362,2084,118
59635,2024,7,7,0,0,100,155197,1094,140
59636,2024,120,77,43,36,64,308512,3321,93
59637,2024,17,17,0,0,100,213838,2091,102
59638,2024,8,8,0,0,100,297138,3133,107
59639,2024,17,17,0,0,100,185350,1766,109
59640,2024,5,5,0,0,100,188340,1517,120
59641,2024,23,23,0,0,100,211608,1832,117
59642,2024,4,4,0,0,100,269788,2138,132
59643,2024,2,2,0,0,100,109000,1438,76
59645,2024,6,6,0,0,100,142383,1331,110
59646,2024,229,176,53,23,77,314291,3332,91
59647,2024,27,27,0,0,100,124392,1387,92
59648,2024,149,92,57,38,62,197999,2210,87
59650,2024,358,322,36,10,90,157034,1893,84
59651,2024,10,10,0,0,100,98700,1254,78
59652,2024,3,3,0,0,100,114917,1270,88
59653,2024,61,58,3,5,95,208633,2556,82
59654,2024,45,45,0,0,100,131073,1388,94
59656,2024,51,37,14,27,73,286706,2820,100
59657,2024,11,11,0,0,100,191700,2223,93
59658,2024,4,4,0,0,100,208750,2215,100
59659,2024,37,37,0,0,100,99372,1086,97
59660,2024,40,39,1,2,98,328800,2837,114
59661,2024,2,2,0,0,100,122500,1260,92
59662,2024,10,10,0,0,100,187764,1656,114
59663,2024,53,51,2,4,96,204175,1987,103
59664,2024,4,4,0,0,100,186650,1634,114
59665,2024,1,1,0,0,100,172300,1485,116
59666,2024,19,19,0,0,100,198954,1789,117
59668,2024,20,14,6,30,70,233002,2803,85
59669,2024,2,2,0,0,100,293750,1492,172
59670,2024,15,14,1,7,93,197067,2105,94
60001,2024,7,7,0,0,100,101849,1412,72
60002,2024,11,10,1,9,91,269665,3155,100
60003,2024,4,4,0,0,100,164500,1599,104
60004,2024,2,2,0,0,100,103500,2384,45
60005,2024,8,8,0,0,100,250738,2251,121
60006,2024,11,10,1,9,91,209318,2525,90
60007,2024,23,22,1,4,96,215719,2061,111
60008,2024,7,7,0,0,100,168429,1570,114
60009,2024,10,10,0,0,100,261614,2394,110
60010,2024,21,20,1,5,95,281790,2821,106
60011,2024,5,5,0,0,100,164565,1374,123
60012,2024,28,26,2,7,93,209329,2475,87
60013,2024,16,16,0,0,100,255750,2567,103
60014,2024,3,3,0,0,100,209317,1970,124
60015,2024,13,11,2,15,85,208225,2189,94
60016,2024,2,2,0,0,100,366750,2058,180
60017,2024,16,15,1,6,94,157875,1569,100
60019,2024,4,4,0,0,100,264500,2354,109
60021,2024,5,5,0,0,100,136340,1021,137
60022,2024,15,15,0,0,100,455454,3643,131
60023,2024,2,2,0,0,100,312500,2704,134
60024,2024,7,7,0,0,100,191124,1904,103
60025,2024,21,19,2,10,90,151881,1985,78
60026,2024,3,3,0,0,100,155000,1997,76
60027,2024,7,7,0,0,100,307457,2852,114
60028,2024,4,4,0,0,100,614038,3720,158
60029,2024,19,19,0,0,100,201429,2071,107
60030,2024,6,6,0,0,100,210033,2089,101
60031,2024,2,2,0,0,100,270806,2168,126
60032,2024,8,8,0,0,100,142288,1585,90
60033,2024,11,10,1,9,91,404036,3847,105
60034,2024,8,8,0,0,100,191240,2456,81
60035,2024,1,1,0,0,100,173000,2084,83
60036,2024,7,7,0,0,100,218123,2136,111
60037,2024,7,7,0,0,100,130571,1186,108
60039,2024,3,3,0,0,100,102667,1737,59
60040,2024,7,7,0,0,100,145277,1537,92
60041,2024,13,13,0,0,100,208418,1939,110
60042,2024,12,11,1,8,92,179791,2367,82
60043,2024,7,7,0,0,100,183014,1600,117
60044,2024,12,11,1,8,92,184062,2021,96
60045,2024,3,3,0,0,100,247517,2833,141
60047,2024,5,5,0,0,100,286570,3381,89
60048,2024,3,3,0,0,100,236510,3470,73
60049,2024,2,2,0,0,100,102300,1574,65
60050,2024,5,5,0,0,100,233900,2751,87
60051,2024,1,1,0,0,100,120000,3000,40
60052,2024,3,3,0,0,100,119833,1929,76
60053,2024,8,8,0,0,100,133306,1139,114
60054,2024,4,4,0,0,100,242250,2259,115
60055,2024,7,7,0,0,100,147271,1506,103
60056,2024,1,1,0,0,100,78000,876,89
60057,2024,564,216,348,62,38,133951,1933,71
60059,2024,4,4,0,0,100,113100,1576,83
60060,2024,8,7,1,12,88,283140,2637,114
60061,2024,1,1,0,0,100,180000,1856,97
60063,2024,14,14,0,0,100,202999,2016,105
60064,2024,9,9,0,0,100,211089,1808,117
60065,2024,14,14,0,0,100,207329,2412,101
60066,2024,2,2,0,0,100,253400,2604,102
60067,2024,13,12,1,8,92,160846,2013,81
60068,2024,31,25,6,19,81,166454,2184,78
60069,2024,6,5,1,17,83,281500,3446,91
60070,2024,4,4,0,0,100,243900,2413,108
60072,2024,1,1,0,0,100,160750,2202,73
60073,2024,9,9,0,0,100,208594,2244,101
60074,2024,14,13,1,7,93,293881,3263,94
60075,2024,3,3,0,0,100,94150,1182,81
60076,2024,3,3,0,0,100,123333,1756,77
60077,2024,3,3,0,0,100,97750,1206,95
60078,2024,1,1,0,0,100,210000,2500,84
60079,2024,12,12,0,0,100,265583,2107,133
60081,2024,2,2,0,0,100,190500,1770,108
60082,2024,2,2,0,0,100,157500,1684,94
60083,2024,12,12,0,0,100,198675,1961,100
60084,2024,7,7,0,0,100,207071,1971,106
60085,2024,3,3,0,0,100,214667,2218,104
60086,2024,19,16,3,16,84,300355,3233,96
60088,2024,41,36,5,12,88,232370,2795,88
60089,2024,3,3,0,0,100,302500,2245,139
60090,2024,4,4,0,0,100,274750,2526,113
60091,2024,3,2,1,33,67,142000,1989,77
60092,2024,1,1,0,0,100,165000,1231,134
60093,2024,4,4,0,0,100,287916,2259,120
60094,2024,3,3,0,0,100,298000,2462,118
60095,2024,6,6,0,0,100,274508,2388,114
60098,2024,3,3,0,0,100,227977,1574,159
60099,2024,2,2,0,0,100,200500,3084,65
60101,2024,6,6,0,0,100,184667,2332,80
60102,2024,20,20,0,0,100,235380,2460,98
60103,2024,25,24,1,4,96,154054,1952,83
60104,2024,44,43,1,2,98,143630,1878,80
60105,2024,7,7,0,0,100,121907,1653,79
60106,2024,18,18,0,0,100,204722,2307,92
60107,2024,37,33,4,11,89,221003,2214,106
60109,2024,6,6,0,0,100,127667,1421,95
60110,2024,3,3,0,0,100,133317,1143,107
60111,2024,1,1,0,0,100,180000,984,183
60112,2024,6,6,0,0,100,189000,2279,90
60113,2024,2,2,0,0,100,68000,790,101
60114,2024,2,2,0,0,100,261050,1510,176
60115,2024,13,13,0,0,100,150181,1675,94
60116,2024,34,32,2,6,94,166331,1954,89
60117,2024,1,1,0,0,100,182000,1052,173
60118,2024,1,1,0,0,100,180000,1268,142
60119,2024,22,22,0,0,100,160452,1756,100
60120,2024,9,9,0,0,100,240889,2259,114
60121,2024,2,2,0,0,100,95000,1278,76
60122,2024,5,5,0,0,100,106474,1412,76
60123,2024,2,2,0,0,100,115000,1592,78
60124,2024,1,1,0,0,100,150000,1471,102
60125,2024,8,8,0,0,100,199250,1781,113
60126,2024,1,1,0,0,100,80000,1333,60
60127,2024,4,4,0,0,100,193275,2033,96
60128,2024,1,1,0,0,100,230000,2371,97
60129,2024,11,11,0,0,100,179632,1983,93
60130,2024,14,14,0,0,100,195523,2342,84
60131,2024,1,1,0,0,100,180000,1250,144
60132,2024,2,2,0,0,100,166500,1226,136
60133,2024,5,5,0,0,100,149190,1562,98
60134,2024,28,27,1,4,96,182547,1960,94
60135,2024,11,11,0,0,100,226688,2152,110
60136,2024,8,8,0,0,100,150119,1480,105
60137,2024,2,2,0,0,100,261525,1928,140
60138,2024,8,8,0,0,100,408145,4172,99
60139,2024,93,58,35,38,62,229400,3267,72
60140,2024,6,6,0,0,100,145417,2770,66
60141,2024,126,14,112,89,11,272623,3909,71
60142,2024,27,20,7,26,74,308330,3171,104
60143,2024,27,19,8,30,70,239124,2615,92
60144,2024,3,3,0,0,100,335567,2907,121
60145,2024,5,5,0,0,100,235600,2235,93
60146,2024,9,9,0,0,100,132656,1543,92
60147,2024,6,6,0,0,100,163667,1823,84
60148,2024,2,2,0,0,100,311500,2670,120
60149,2024,27,27,0,0,100,214349,2333,98
60150,2024,12,12,0,0,100,164936,1796,97
60151,2024,32,32,0,0,100,250761,2429,104
60152,2024,1,1,0,0,100,227600,1897,120
60153,2024,1,1,0,0,100,85000,1417,60
60154,2024,25,24,1,4,96,253793,2626,99
60155,2024,32,28,4,12,88,217797,2322,98
60156,2024,21,19,2,10,90,213950,2559,96
60157,2024,121,72,49,40,60,163833,2167,79
60158,2024,2,2,0,0,100,110000,2334,50
60159,2024,467,124,343,73,27,200965,2639,75
60160,2024,1,1,0,0,100,212000,1325,160
60161,2024,3,3,0,0,100,157333,1358,119
60162,2024,3,3,0,0,100,237757,2157,110
60163,2024,5,5,0,0,100,129800,1795,72
60164,2024,4,4,0,0,100,154250,1681,90
60165,2024,2,2,0,0,100,184500,2079,89
60166,2024,14,14,0,0,100,226750,2267,105
60167,2024,5,5,0,0,100,161680,2015,89
60168,2024,1,1,0,0,100,95000,1056,90
60169,2024,12,12,0,0,100,242204,2508,101
60170,2024,8,8,0,0,100,425125,3154,137
60171,2024,2,2,0,0,100,142675,1842,78
60172,2024,45,22,23,51,49,315174,3492,95
60173,2024,6,4,2,33,67,123417,2154,63
60174,2024,7,7,0,0,100,94859,1176,82
60175,2024,147,40,107,73,27,120026,1900,63
60176,2024,139,76,63,45,55,192403,2705,73
60177,2024,1,1,0,0,100,221600,2131,104
60178,2024,30,30,0,0,100,161431,1831,88
60179,2024,2,2,0,0,100,156500,1919,84
60180,2024,11,11,0,0,100,146964,1480,114
60181,2024,11,11,0,0,100,141509,1683,87
60183,2024,1,1,0,0,100,170000,1181,144
60184,2024,4,4,0,0,100,169000,1708,103
60185,2024,8,8,0,0,100,238625,2701,97
60186,2024,2,2,0,0,100,152000,1896,87
60187,2024,9,9,0,0,100,123287,1419,91
60188,2024,17,17,0,0,100,194344,1918,105
60189,2024,9,9,0,0,100,200283,2025,92
60190,2024,8,8,0,0,100,209550,2438,90
60191,2024,5,5,0,0,100,159500,1364,119
60192,2024,2,2,0,0,100,147500,1492,98
60194,2024,7,7,0,0,100,108607,1358,80
60195,2024,1,1,0,0,100,295000,1967,150
60196,2024,20,20,0,0,100,218097,2248,104
60197,2024,12,11,1,8,92,240965,2168,115
60198,2024,5,5,0,0,100,155500,1755,94
60199,2024,2,2,0,0,100,161500,2042,79
60200,2024,7,7,0,0,100,119486,1349,85
60201,2024,4,4,0,0,100,162190,2208,76
60203,2024,3,3,0,0,100,155833,2299,68
60204,2024,2,2,0,0,100,176000,1546,114
60205,2024,2,2,0,0,100,156000,1589,104
60206,2024,7,7,0,0,100,196493,2249,114
60207,2024,4,4,0,0,100,234625,2181,105
60208,2024,1,1,0,0,100,100000,4000,25
60209,2024,6,6,0,0,100,179848,2376,78
60211,2024,6,6,0,0,100,189208,2357,80
60212,2024,15,15,0,0,100,228879,2461,97
60213,2024,7,7,0,0,100,373429,2926,138
60214,2024,1,1,0,0,100,75000,852,88
60215,2024,4,4,0,0,100,273320,2314,117
60216,2024,2,2,0,0,100,197178,2072,96
60217,2024,2,2,0,0,100,153500,2128,84
60218,2024,8,7,1,12,88,275500,2364,125
60219,2024,3,3,0,0,100,96000,1106,86
60220,2024,3,3,0,0,100,125000,1382,87
60221,2024,5,5,0,0,100,116400,1282,88
60222,2024,6,6,0,0,100,203883,2275,95
60223,2024,33,33,0,0,100,207683,2062,106
60224,2024,1,1,0,0,100,529700,2848,186
60225,2024,9,9,0,0,100,182333,2050,94
60226,2024,2,2,0,0,100,313750,3108,100
60228,2024,4,4,0,0,100,264262,1764,150
60230,2024,5,5,0,0,100,162315,2031,79
60231,2024,3,3,0,0,100,282733,2495,114
60232,2024,3,3,0,0,100,116333,988,123
60233,2024,9,9,0,0,100,97722,1240,85
60234,2024,28,19,9,32,68,169377,2132,81
60235,2024,7,7,0,0,100,199410,2299,96
60236,2024,3,3,0,0,100,127333,1364,97
60238,2024,20,19,1,5,95,286495,2790,105
60239,2024,9,9,0,0,100,215333,2877,78
60240,2024,5,5,0,0,100,273440,4058,94
60241,2024,2,2,0,0,100,262250,2200,115
60242,2024,1,1,0,0,100,117000,1083,108
60243,2024,4,4,0,0,100,207000,1583,127
60244,2024,3,3,0,0,100,125000,1489,84
60245,2024,34,34,0,0,100,125319,1476,83
60247,2024,1,1,0,0,100,195000,2708,72
60248,2024,4,4,0,0,100,91375,850,104
60249,2024,2,2,0,0,100,285000,2314,132
60250,2024,3,3,0,0,100,176667,2857,65
60251,2024,2,2,0,0,100,190500,1960,98
60252,2024,3,3,0,0,100,199623,2049,98
60253,2024,5,5,0,0,100,167600,1625,103
60254,2024,2,2,0,0,100,131890,1884,72
60255,2024,4,4,0,0,100,140250,1931,82
60256,2024,12,12,0,0,100,205125,2317,99
60257,2024,8,8,0,0,100,217375,1834,113
60258,2024,1,1,0,0,100,157000,1847,85
60259,2024,10,9,1,10,90,294640,2749,116
60260,2024,7,7,0,0,100,255791,2285,118
60261,2024,9,8,1,11,89,201122,2197,98
60262,2024,2,2,0,0,100,277500,2369,106
60263,2024,1,1,0,0,100,140000,1346,104
60264,2024,6,6,0,0,100,201283,2294,90
60265,2024,4,4,0,0,100,163500,1782,89
60267,2024,3,3,0,0,100,127000,1686,72
60268,2024,3,3,0,0,100,159667,3077,52
60269,2024,6,6,0,0,100,115500,1570,76
60270,2024,2,2,0,0,100,156500,1504,104
60271,2024,1,1,0,0,100,395000,2842,139
60272,2024,3,3,0,0,100,175667,2503,67
60273,2024,2,2,0,0,100,217150,2423,94
60274,2024,2,2,0,0,100,154600,2350,70
60275,2024,1,1,0,0,100,212000,1828,116
60276,2024,3,3,0,0,100,141850,1621,92
60277,2024,7,7,0,0,100,193643,1964,102
60278,2024,5,5,0,0,100,131300,1671,87
60279,2024,1,1,0,0,100,293000,2382,123
60280,2024,2,2,0,0,100,104400,1176,103
60281,2024,7,7,0,0,100,162256,1849,100
60282,2024,93,58,35,38,62,343704,3635,97
60284,2024,12,12,0,0,100,211953,2192,96
60285,2024,2,2,0,0,100,161000,2403,67
60286,2024,27,26,1,4,96,158074,1712,99
60287,2024,2,2,0,0,100,160000,1918,84
60288,2024,5,5,0,0,100,156000,1754,91
60289,2024,3,3,0,0,100,167633,2285,74
60290,2024,4,4,0,0,100,202125,1806,106
60291,2024,12,12,0,0,100,113617,1564,76
60292,2024,1,1,0,0,100,159000,1656,96
60293,2024,4,4,0,0,100,270144,2511,116
60294,2024,1,1,0,0,100,185000,2011,92
60295,2024,2,2,0,0,100,187000,1494,128
60296,2024,1,1,0,0,100,30000,429,70
60297,2024,4,4,0,0,100,116875,1416,81
60298,2024,7,7,0,0,100,141314,1495,101
60299,2024,5,5,0,0,100,121200,1250,92
60301,2024,1,1,0,0,100,195000,1560,125
60302,2024,9,9,0,0,100,137533,1756,78
60304,2024,1,1,0,0,100,72000,1108,65
60305,2024,1,1,0,0,100,107520,575,187
60306,2024,1,1,0,0,100,74000,1574,47
60307,2024,11,11,0,0,100,265536,2788,114
60308,2024,3,3,0,0,100,175667,2724,63
60309,2024,10,9,1,10,90,209475,2932,77
60310,2024,7,7,0,0,100,183764,2069,99
60311,2024,5,5,0,0,100,95500,1283,76
60312,2024,1,1,0,0,100,63000,788,80
60313,2024,24,23,1,4,96,192567,2237,90
60314,2024,2,2,0,0,100,171000,1818,106
60315,2024,1,1,0,0,100,290000,2816,103
60316,2024,1,1,0,0,100,210000,3043,69
60317,2024,7,7,0,0,100,203143,2202,93
60318,2024,1,1,0,0,100,363000,1704,213
60319,2024,12,12,0,0,100,174438,2179,81
60320,2024,4,4,0,0,100,248860,2390,97
60321,2024,11,11,0,0,100,217918,2515,87
60322,2024,5,5,0,0,100,251800,2249,112
60323,2024,9,9,0,0,100,204303,2464,91
60324,2024,12,12,0,0,100,155772,1547,98
60325,2024,19,18,1,5,95,237490,2429,102
60326,2024,9,9,0,0,100,368960,5659,78
60327,2024,9,9,0,0,100,183428,1812,111
60328,2024,2,2,0,0,100,130000,1560,83
60329,2024,2,2,0,0,100,108500,1614,69
60330,2024,8,8,0,0,100,203400,2299,99
60331,2024,3,3,0,0,100,180667,1669,107
60332,2024,3,3,0,0,100,235000,2575,91
60333,2024,14,11,3,21,79,178084,2152,94
60334,2024,12,12,0,0,100,222313,2152,114
60335,2024,3,3,0,0,100,183115,2317,92
60336,2024,1,1,0,0,100,305000,2089,146
60337,2024,7,7,0,0,100,265222,2981,91
60338,2024,61,52,9,15,85,233889,2456,96
60339,2024,3,3,0,0,100,166000,2132,80
60340,2024,5,5,0,0,100,129500,1522,83
60341,2024,18,18,0,0,100,282753,2699,108
60342,2024,47,35,12,26,74,177840,2191,84
60343,2024,10,10,0,0,100,181100,2141,87
60344,2024,2,2,0,0,100,226400,2119,118
60346,2024,102,69,33,32,68,440599,3960,111
60347,2024,1,1,0,0,100,170000,1717,99
60348,2024,7,7,0,0,100,169782,1445,121
60350,2024,17,15,2,12,88,163360,1737,94
60351,2024,1,1,0,0,100,154300,1641,94
60352,2024,4,4,0,0,100,210000,2755,76
60355,2024,13,13,0,0,100,225746,1874,124
60356,2024,9,8,1,11,89,188467,3108,62
60357,2024,6,6,0,0,100,174300,1838,93
60358,2024,14,11,3,21,79,232707,2528,98
60359,2024,1,1,0,0,100,195000,1806,108
60360,2024,58,39,19,33,67,138310,1910,75
60361,2024,9,9,0,0,100,227056,2289,101
60362,2024,3,3,0,0,100,103167,1125,84
60363,2024,1,1,0,0,100,399100,2146,186
60364,2024,8,6,2,25,75,189593,2180,93
60365,2024,4,4,0,0,100,162750,1486,110
60366,2024,3,3,0,0,100,164667,1302,126
60367,2024,3,3,0,0,100,267000,2284,117
60368,2024,25,21,4,16,84,152056,1979,79
60369,2024,18,18,0,0,100,242954,2503,106
60370,2024,10,10,0,0,100,205964,2322,92
60372,2024,6,6,0,0,100,165903,1461,118
60373,2024,4,4,0,0,100,209750,2217,100
60374,2024,21,20,1,5,95,153912,1678,94
60375,2024,5,5,0,0,100,218900,2686,93
60376,2024,1,1,0,0,100,143500,1669,86
60378,2024,4,4,0,0,100,231050,1776,157
60379,2024,4,4,0,0,100,165750,1644,99
60380,2024,18,18,0,0,100,180267,2426,82
60381,2024,2,2,0,0,100,183250,1593,114
60382,2024,125,52,73,58,42,173544,2486,70
60383,2024,3,3,0,0,100,224333,2066,108
60385,2024,4,4,0,0,100,138125,1730,78
60386,2024,8,8,0,0,100,194750,2091,99
60387,2024,10,10,0,0,100,156880,2084,83
60388,2024,3,3,0,0,100,51833,727,70
60389,2024,1,1,0,0,100,137000,1054,130
60390,2024,1,1,0,0,100,225000,2647,85
60391,2024,1,1,0,0,100,283000,2748,103
60392,2024,4,4,0,0,100,173625,1747,98
60393,2024,1,1,0,0,100,101000,2020,50
60394,2024,1,1,0,0,100,201000,1467,137
60395,2024,106,82,24,23,77,189455,2446,80
60396,2024,3,3,0,0,100,194033,1722,113
60397,2024,1,1,0,0,100,200000,2000,100
60398,2024,34,30,4,12,88,260255,2706,100
60399,2024,4,4,0,0,100,95500,1173,76
60400,2024,3,3,0,0,100,169333,1385,124
60401,2024,9,9,0,0,100,219751,2411,91
60402,2024,21,19,2,10,90,292724,2824,104
60403,2024,24,24,0,0,100,101943,1627,68
60404,2024,13,13,0,0,100,189388,2096,91
60405,2024,9,9,0,0,100,136889,1751,79
60406,2024,5,5,0,0,100,310724,2855,108
60408,2024,7,7,0,0,100,234090,2394,97
60409,2024,22,21,1,5,95,206293,2576,85
60410,2024,5,5,0,0,100,147580,1380,112
60411,2024,9,9,0,0,100,275750,2299,121
60412,2024,7,7,0,0,100,259622,2597,103
60413,2024,6,5,1,17,83,264480,2810,99
60414,2024,73,55,18,25,75,166421,2010,83
60415,2024,1,1,0,0,100,575000,3686,156
60416,2024,2,2,0,0,100,144000,1507,94
60418,2024,3,3,0,0,100,144300,1519,111
60420,2024,7,7,0,0,100,269802,2691,97
60421,2024,8,8,0,0,100,235125,2314,107
60422,2024,2,2,0,0,100,897165,5656,155
60423,2024,10,10,0,0,100,190697,2364,82
60424,2024,2,2,0,0,100,221600,2610,85
60425,2024,3,3,0,0,100,169667,2530,86
60426,2024,3,3,0,0,100,202333,2272,91
60427,2024,2,2,0,0,100,210150,2960,73
60428,2024,6,6,0,0,100,326049,2161,148
60429,2024,3,3,0,0,100,383000,3150,122
60430,2024,11,11,0,0,100,226782,2045,112
60431,2024,3,3,0,0,100,168467,1488,113
60432,2024,6,6,0,0,100,404167,2983,136
60433,2024,11,11,0,0,100,229426,2169,110
60434,2024,3,3,0,0,100,177000,2285,84
60435,2024,4,4,0,0,100,208385,2850,78
60436,2024,1,1,0,0,100,118000,2360,50
60438,2024,4,3,1,25,75,144375,1710,89
60439,2024,53,41,12,23,77,148954,2147,77
60440,2024,6,6,0,0,100,183667,2441,75
60441,2024,7,7,0,0,100,250171,2710,93
60442,2024,1,1,0,0,100,80000,1356,59
60443,2024,5,5,0,0,100,118000,1533,80
60444,2024,1,1,0,0,100,98800,1162,85
60445,2024,3,3,0,0,100,144667,1364,104
60446,2024,45,26,19,42,58,209622,2749,80
60447,2024,1,1,0,0,100,295000,3352,88
60448,2024,6,6,0,0,100,221167,2133,112
60449,2024,2,2,0,0,100,255000,3091,84
60450,2024,54,44,10,19,81,228344,2782,85
60451,2024,15,14,1,7,93,207067,2201,104
60452,2024,5,5,0,0,100,220212,3204,69
60454,2024,7,7,0,0,100,146429,2106,75
60456,2024,8,8,0,0,100,168750,2256,78
60457,2024,3,3,0,0,100,184667,1814,103
60458,2024,3,3,0,0,100,185833,1900,103
60460,2024,2,2,0,0,100,145000,1591,88
60462,2024,15,14,1,7,93,189853,2358,83
60463,2024,135,67,68,50,50,143580,1897,77
60464,2024,7,7,0,0,100,186487,1884,97
60465,2024,1,1,0,0,100,195000,2074,94
60466,2024,1,1,0,0,100,120000,1463,82
60468,2024,4,4,0,0,100,156425,1966,79
60469,2024,3,3,0,0,100,261000,2396,126
60470,2024,5,5,0,0,100,129030,1532,86
60471,2024,121,90,31,26,74,121040,1527,82
60472,2024,3,3,0,0,100,193667,1559,118
60473,2024,1,1,0,0,100,343150,3538,97
60474,2024,2,2,0,0,100,97250,857,112
60477,2024,8,8,0,0,100,166902,1625,112
60478,2024,4,3,1,25,75,250375,2382,109
60479,2024,9,9,0,0,100,222956,2386,98
60480,2024,3,3,0,0,100,161617,1513,106
60481,2024,10,10,0,0,100,238096,2529,98
60482,2024,38,35,3,8,92,319589,3421,95
60483,2024,8,8,0,0,100,165925,1695,99
60484,2024,3,3,0,0,100,143000,1281,115
60485,2024,2,2,0,0,100,148000,1012,142
60486,2024,8,8,0,0,100,112875,1361,84
60487,2024,5,5,0,0,100,320250,2616,132
60488,2024,4,4,0,0,100,175432,1734,102
60489,2024,7,6,1,14,86,237114,2712,92
60490,2024,3,3,0,0,100,272500,2317,114
60491,2024,15,12,3,20,80,212567,2890,81
60492,2024,4,4,0,0,100,122000,1231,96
60493,2024,7,7,0,0,100,186786,1751,120
60494,2024,14,13,1,7,93,329420,3707,88
60495,2024,2,2,0,0,100,121000,2820,43
60496,2024,2,2,0,0,100,113225,1205,86
60497,2024,2,2,0,0,100,173250,1956,89
60498,2024,10,10,0,0,100,136300,1930,70
60499,2024,2,2,0,0,100,157800,1680,94
60500,2024,40,21,19,48,52,216899,3006,75
60501,2024,20,20,0,0,100,194692,2133,93
60503,2024,5,5,0,0,100,452708,3034,137
60504,2024,12,12,0,0,100,246778,2110,119
60505,2024,11,11,0,0,100,306517,3015,101
60506,2024,5,5,0,0,100,137600,1934,74
60507,2024,7,7,0,0,100,150414,1342,112
60508,2024,39,32,7,18,82,225279,2205,103
60509,2024,112,63,49,44,56,167464,2400,70
60510,2024,3,3,0,0,100,274833,3315,82
60511,2024,3,3,0,0,100,186497,2204,91
60512,2024,1,1,0,0,100,248000,2362,105
60513,2024,32,27,5,16,84,274837,2732,102
60514,2024,3,3,0,0,100,177333,1720,107
60515,2024,1,1,0,0,100,220000,2418,91
60516,2024,8,8,0,0,100,207350,1984,103
60517,2024,7,5,2,29,71,237390,3163,77
60518,2024,4,4,0,0,100,156250,1488,110
60519,2024,3,3,0,0,100,139967,1762,84
60520,2024,1,1,0,0,100,54500,1267,43
60521,2024,3,3,0,0,100,94617,1006,88
60523,2024,7,7,0,0,100,211893,1898,121
60524,2024,33,17,16,48,52,134388,2144,67
60525,2024,1,1,0,0,100,190000,1759,108
60526,2024,12,12,0,0,100,126700,1650,79
60527,2024,1,1,0,0,100,310000,3100,100
60530,2024,2,2,0,0,100,164500,1646,110
60531,2024,20,20,0,0,100,220819,2292,96
60533,2024,15,14,1,7,93,213047,1985,102
60534,2024,4,4,0,0,100,124750,2409,52
60535,2024,3,3,0,0,100,126667,1251,103
60536,2024,1,1,0,0,100,120800,2570,47
60537,2024,25,24,1,4,96,160167,1913,83
60538,2024,2,2,0,0,100,211850,1692,122
60539,2024,12,11,1,8,92,198860,2224,90
60540,2024,2,2,0,0,100,131250,1560,78
60541,2024,1,1,0,0,100,100000,1220,82
60542,2024,7,7,0,0,100,193014,1958,98
60544,2024,4,4,0,0,100,130188,1382,96
60545,2024,7,7,0,0,100,160429,1366,115
60546,2024,1,1,0,0,100,70000,1186,59
60547,2024,4,4,0,0,100,219112,2338,92
60548,2024,8,8,0,0,100,242200,2396,108
60549,2024,2,2,0,0,100,220750,2032,111
60550,2024,3,3,0,0,100,175333,1605,113
60552,2024,2,2,0,0,100,197500,2264,89
60554,2024,6,6,0,0,100,235267,2086,119
60556,2024,4,4,0,0,100,161138,1372,120
60557,2024,4,4,0,0,100,144750,1938,78
60558,2024,6,6,0,0,100,151500,1896,82
60559,2024,7,7,0,0,100,196600,2319,88
60560,2024,15,15,0,0,100,291570,3094,104
60561,2024,3,3,0,0,100,310860,2385,165
60562,2024,10,10,0,0,100,230300,2331,101
60563,2024,10,10,0,0,100,228078,2383,100
60564,2024,3,3,0,0,100,164007,1367,128
60565,2024,5,5,0,0,100,185000,2262,88
60566,2024,1,1,0,0,100,75000,833,90
60567,2024,11,11,0,0,100,181681,1822,107
60568,2024,2,2,0,0,100,220750,2454,90
60569,2024,4,4,0,0,100,222688,1606,146
60570,2024,18,18,0,0,100,319292,2730,112
60572,2024,4,4,0,0,100,159450,2850,57
60573,2024,1,1,0,0,100,196900,1550,127
60574,2024,9,9,0,0,100,208585,2193,97
60575,2024,24,21,3,12,88,238738,2304,109
60576,2024,7,7,0,0,100,135679,1907,97
60577,2024,16,16,0,0,100,167789,1914,93
60578,2024,7,6,1,14,86,146271,2092,73
60579,2024,7,7,0,0,100,408493,2326,156
60581,2024,54,42,12,22,78,141803,1723,82
60582,2024,10,8,2,20,80,195170,2388,82
60583,2024,1,1,0,0,100,247000,2628,94
60584,2024,40,24,16,40,60,212915,2646,86
60585,2024,1,1,0,0,100,167000,1380,121
60586,2024,11,11,0,0,100,204445,2500,83
60587,2024,8,8,0,0,100,197838,2178,96
60588,2024,1,1,0,0,100,114800,1351,85
60589,2024,23,17,6,26,74,194386,2908,70
60590,2024,7,7,0,0,100,152995,1723,91
60591,2024,13,13,0,0,100,262266,2426,110
60592,2024,4,4,0,0,100,173325,2086,86
60594,2024,4,4,0,0,100,198750,1881,110
60595,2024,6,6,0,0,100,155345,2212,90
60596,2024,4,4,0,0,100,134250,1774,84
60597,2024,10,10,0,0,100,226171,2330,96
60598,2024,7,7,0,0,100,289071,2488,118
60599,2024,2,2,0,0,100,79500,1210,62
60600,2024,4,4,0,0,100,248112,2315,106
60601,2024,9,6,3,33,67,163411,2114,88
60602,2024,1,1,0,0,100,158000,1756,90
60603,2024,7,7,0,0,100,97929,1078,93
60605,2024,1,1,0,0,100,130000,1250,104
60608,2024,1,1,0,0,100,95000,1118,85
60609,2024,8,8,0,0,100,215946,2600,94
60610,2024,5,5,0,0,100,110260,1395,80
60611,2024,6,6,0,0,100,150417,2160,72
60612,2024,185,71,114,62,38,279762,3451,81
60613,2024,3,3,0,0,100,196667,2988,67
60615,2024,2,2,0,0,100,191500,1586,120
60616,2024,37,34,3,8,92,165256,2050,85
60617,2024,3,3,0,0,100,166734,1352,118
60618,2024,1,1,0,0,100,187000,2033,92
60619,2024,9,7,2,22,78,277389,2806,99
60620,2024,6,6,0,0,100,261760,2528,134
60621,2024,1,0,1,100,0,95000,1118,85
60622,2024,6,6,0,0,100,133583,1382,105
60623,2024,14,14,0,0,100,143057,1525,94
60624,2024,6,6,0,0,100,261958,2064,110
60625,2024,2,2,0,0,100,130000,1768,75
60626,2024,9,9,0,0,100,189506,2356,84
60627,2024,3,3,0,0,100,141333,1680,92
60628,2024,16,13,3,19,81,187689,2206,89
60629,2024,1,1,0,0,100,137000,1877,73
60630,2024,2,2,0,0,100,156875,1476,112
60631,2024,9,8,1,11,89,259072,2924,88
60632,2024,7,7,0,0,100,160714,1489,109
60633,2024,7,7,0,0,100,165157,1614,109
60634,2024,2,2,0,0,100,171000,1736,99
60635,2024,9,6,3,33,67,181611,3797,66
60636,2024,25,21,4,16,84,154206,1737,93
60637,2024,4,4,0,0,100,192000,2758,68
60638,2024,3,3,0,0,100,220667,2141,105
60639,2024,7,4,3,43,57,155429,2246,74
60640,2024,1,1,0,0,100,340000,1977,172
60641,2024,20,18,2,10,90,166047,1809,90
60642,2024,11,11,0,0,100,224827,2069,108
60643,2024,15,15,0,0,100,125607,1509,91
60644,2024,19,19,0,0,100,243369,2348,112
60645,2024,4,4,0,0,100,141980,2112,74
60646,2024,13,13,0,0,100,264195,2288,122
60647,2024,15,15,0,0,100,172002,1780,98
60648,2024,3,3,0,0,100,140000,1823,80
60650,2024,5,5,0,0,100,333390,2592,134
60651,2024,30,30,0,0,100,232449,2410,100
60652,2024,13,13,0,0,100,199223,2404,89
60653,2024,6,6,0,0,100,140833,1834,79
60654,2024,1,1,0,0,100,207000,1917,108
60655,2024,5,5,0,0,100,132960,1824,78
60656,2024,6,6,0,0,100,207639,1952,114
60657,2024,2,2,0,0,100,106900,1385,70
60658,2024,9,9,0,0,100,197869,2435,83
60659,2024,4,4,0,0,100,284425,2535,120
60660,2024,3,3,0,0,100,256140,3097,81
60661,2024,15,11,4,27,73,186820,2022,95
60662,2024,5,5,0,0,100,185200,2653,86
60663,2024,1,1,0,0,100,170000,2464,69
60664,2024,6,6,0,0,100,121167,1380,87
60665,2024,26,17,9,35,65,181915,2319,81
60666,2024,8,8,0,0,100,420015,3236,129
60667,2024,37,24,13,35,65,182126,2513,76
60668,2024,3,3,0,0,100,158667,1893,81
60669,2024,5,5,0,0,100,311300,2699,117
60670,2024,51,46,5,10,90,236467,2868,89
60671,2024,3,3,0,0,100,246333,3165,86
60672,2024,2,2,0,0,100,278500,2470,114
60673,2024,1,1,0,0,100,147000,2100,70
60674,2024,4,4,0,0,100,283550,2162,122
60675,2024,4,4,0,0,100,246500,1942,128
60676,2024,6,6,0,0,100,132543,1535,81
60677,2024,5,5,0,0,100,197865,2229,84
60678,2024,12,10,2,17,83,221533,3078,77
60679,2024,3,3,0,0,100,217583,2217,98
60680,2024,6,6,0,0,100,279905,2367,110
60681,2024,5,5,0,0,100,218200,1765,121
60682,2024,9,8,1,11,89,424625,3277,123
60683,2024,6,6,0,0,100,249828,2251,117
60684,2024,47,31,16,34,66,162551,2207,80
60685,2024,11,11,0,0,100,213884,2372,92
60686,2024,22,16,6,27,73,289924,2675,109
60687,2024,4,4,0,0,100,166000,1993,85
60688,2024,3,3,0,0,100,188520,1626,120
60689,2024,18,18,0,0,100,315052,2427,130
60691,2024,1,1,0,0,100,68000,680,100
60693,2024,1,1,0,0,100,157000,1653,95
60694,2024,3,3,0,0,100,215333,2201,113
60695,2024,14,12,2,14,86,536156,4385,124
60697,2024,2,2,0,0,100,226500,2040,99
60698,2024,2,2,0,0,100,101500,1952,52
60700,2024,9,9,0,0,100,211936,2145,102
60701,2024,11,11,0,0,100,192306,1974,99
60702,2024,1,1,0,0,100,172500,1742,99
60703,2024,5,5,0,0,100,266560,2405,115
61001,2024,287,159,128,45,55,111856,1463,77
61002,2024,7,7,0,0,100,128343,1209,108
61005,2024,1,1,0,0,100,135000,1063,127
61006,2024,121,76,45,37,63,121534,1543,80
61007,2024,40,39,1,2,98,114014,1346,86
61008,2024,20,20,0,0,100,103210,1407,74
61010,2024,3,3,0,0,100,138667,1728,82
61011,2024,2,2,0,0,100,126500,1488,85
61012,2024,2,2,0,0,100,170000,1209,148
61013,2024,1,1,0,0,100,191000,1425,134
61014,2024,4,4,0,0,100,144625,1381,104
61015,2024,5,5,0,0,100,202520,1682,131
61018,2024,1,1,0,0,100,17240,345,50
61020,2024,1,1,0,0,100,190000,1173,162
61021,2024,1,1,0,0,100,55000,2619,21
61023,2024,6,6,0,0,100,105167,1429,75
61024,2024,3,3,0,0,100,147600,1400,113
61026,2024,3,3,0,0,100,158067,1364,110
61028,2024,6,6,0,0,100,129875,1284,104
61029,2024,7,7,0,0,100,112186,1162,97
61030,2024,2,2,0,0,100,129350,1078,110
61032,2024,2,2,0,0,100,120000,1446,82
61034,2024,4,4,0,0,100,139250,1360,132
61035,2024,1,1,0,0,100,145000,1510,96
61036,2024,6,6,0,0,100,142500,1450,99
61037,2024,2,2,0,0,100,103500,1076,89
61038,2024,23,21,2,9,91,263422,2108,114
61039,2024,1,1,0,0,100,225000,1692,133
61040,2024,8,8,0,0,100,173988,1505,102
61041,2024,2,2,0,0,100,200000,1348,144
61043,2024,9,9,0,0,100,138867,1528,91
61044,2024,6,6,0,0,100,144983,1722,85
61046,2024,2,2,0,0,100,135000,1692,87
61048,2024,1,1,0,0,100,137500,1528,90
61050,2024,17,17,0,0,100,159029,1664,98
61051,2024,2,2,0,0,100,76995,2562,39
61052,2024,2,2,0,0,100,104250,1550,68
61053,2024,4,4,0,0,100,202750,1851,102
61054,2024,4,4,0,0,100,70750,862,80
61055,2024,9,8,1,11,89,133961,1356,88
61060,2024,1,1,0,0,100,28000,700,40
61061,2024,18,18,0,0,100,128879,1410,92
61062,2024,2,2,0,0,100,168515,1612,113
61063,2024,22,21,1,5,95,110703,1432,79
61064,2024,1,1,0,0,100,85000,1889,45
61067,2024,3,3,0,0,100,251900,1667,149
61068,2024,1,1,0,0,100,137000,856,160
61069,2024,5,5,0,0,100,64920,955,64
61070,2024,14,14,0,0,100,114171,1328,83
61071,2024,2,2,0,0,100,229500,1640,135
61072,2024,2,2,0,0,100,126000,1210,97
61074,2024,6,6,0,0,100,95833,1401,81
61075,2024,14,14,0,0,100,90243,1220,71
61076,2024,2,2,0,0,100,93500,966,111
61077,2024,2,2,0,0,100,196892,1640,120
61078,2024,5,5,0,0,100,81520,1121,75
61079,2024,25,25,0,0,100,91640,1274,73
61080,2024,1,1,0,0,100,107000,1126,95
61081,2024,11,11,0,0,100,110664,908,123
61082,2024,1,1,0,0,100,75000,904,83
61084,2024,1,1,0,0,100,140000,633,221
61086,2024,1,1,0,0,100,42000,646,65
61087,2024,3,3,0,0,100,255000,2825,92
61088,2024,3,3,0,0,100,214833,2039,110
61089,2024,2,2,0,0,100,109600,1442,74
61091,2024,12,12,0,0,100,91072,1084,84
61092,2024,5,5,0,0,100,182800,2147,87
61093,2024,15,15,0,0,100,121040,1203,105
61094,2024,6,6,0,0,100,178133,1784,109
61095,2024,4,4,0,0,100,54262,815,64
61096,2024,32,31,1,3,97,101600,1161,93
61097,2024,3,3,0,0,100,113267,1227,88
61098,2024,2,2,0,0,100,196500,1601,132
61099,2024,5,5,0,0,100,165000,2037,82
61100,2024,3,3,0,0,100,100333,1062,101
61101,2024,1,1,0,0,100,70000,458,153
61102,2024,3,3,0,0,100,114133,1016,119
61103,2024,2,2,0,0,100,261022,2791,98
61104,2024,1,1,0,0,100,262000,1560,168
61105,2024,6,6,0,0,100,168333,1823,92
61107,2024,5,5,0,0,100,110440,1122,96
61108,2024,3,3,0,0,100,68067,910,68
61111,2024,2,2,0,0,100,110000,1076,96
61113,2024,1,1,0,0,100,157671,950,166
61114,2024,2,2,0,0,100,219500,1738,124
61116,2024,24,24,0,0,100,183454,1980,103
61117,2024,20,19,1,5,95,106219,1298,85
61118,2024,1,1,0,0,100,145000,1611,90
61121,2024,2,2,0,0,100,205000,2119,102
61123,2024,4,4,0,0,100,146700,1991,76
61124,2024,3,3,0,0,100,208000,1956,106
61126,2024,4,4,0,0,100,155000,1600,109
61129,2024,3,3,0,0,100,182469,1594,121
61130,2024,7,7,0,0,100,166150,1504,115
61133,2024,12,12,0,0,100,130675,1503,90
61137,2024,1,1,0,0,100,100000,1282,78
61138,2024,4,4,0,0,100,105270,1229,88
61139,2024,5,5,0,0,100,202809,1571,134
61140,2024,6,6,0,0,100,137000,1760,80
61141,2024,4,4,0,0,100,231875,2161,116
61142,2024,5,5,0,0,100,211960,1596,131
61143,2024,32,32,0,0,100,163086,1669,96
61145,2024,50,47,3,6,94,118425,1368,86
61146,2024,3,3,0,0,100,144583,1206,119
61148,2024,5,5,0,0,100,113380,1342,81
61149,2024,4,4,0,0,100,89662,1091,87
61150,2024,16,16,0,0,100,127969,1239,102
61151,2024,8,8,0,0,100,137875,1526,91
61153,2024,21,21,0,0,100,169212,1540,108
61156,2024,3,3,0,0,100,75000,724,93
61158,2024,3,3,0,0,100,83833,1130,63
61160,2024,3,3,0,0,100,195500,2258,87
61162,2024,6,6,0,0,100,104942,1361,82
61163,2024,18,17,1,6,94,77854,979,78
61164,2024,3,3,0,0,100,178000,1977,89
61165,2024,5,5,0,0,100,137000,1420,98
61166,2024,2,2,0,0,100,187160,1970,95
61167,2024,53,53,0,0,100,125356,1471,90
61168,2024,62,58,4,6,94,112004,1266,86
61169,2024,159,98,61,38,62,99696,1275,79
61171,2024,1,1,0,0,100,85000,773,110
61176,2024,2,2,0,0,100,218750,1676,132
61178,2024,1,1,0,0,100,290000,2522,115
61180,2024,4,4,0,0,100,149000,1744,89
61181,2024,30,30,0,0,100,90900,1098,87
61182,2024,4,4,0,0,100,131250,1120,106
61189,2024,2,2,0,0,100,234500,1794,138
61193,2024,4,4,0,0,100,260931,1614,151
61194,2024,10,10,0,0,100,161150,1671,105
61195,2024,2,2,0,0,100,115250,975,120
61196,2024,25,24,1,4,96,194729,1828,102
61197,2024,1,1,0,0,100,120000,923,130
61198,2024,2,2,0,0,100,235500,1308,188
61199,2024,2,2,0,0,100,235000,2290,84
61202,2024,5,5,0,0,100,186900,1676,117
61203,2024,14,14,0,0,100,187607,1667,111
61206,2024,3,3,0,0,100,157000,1795,96
61207,2024,9,9,0,0,100,330379,2069,118
61208,2024,8,8,0,0,100,169500,1441,124
61209,2024,2,2,0,0,100,54500,1060,48
61210,2024,2,2,0,0,100,221300,2302,88
61211,2024,20,20,0,0,100,98546,1228,81
61212,2024,1,1,0,0,100,176537,1820,97
61213,2024,3,3,0,0,100,92500,1409,65
61214,2024,94,78,16,17,83,126915,1561,84
61215,2024,8,8,0,0,100,227095,2029,115
61216,2024,1,1,0,0,100,169600,2389,71
61218,2024,18,18,0,0,100,106296,1275,85
61219,2024,1,1,0,0,100,67500,823,82
61221,2024,4,4,0,0,100,168055,1782,94
61222,2024,7,7,0,0,100,88457,1005,90
61224,2024,5,5,0,0,100,170400,1433,123
61225,2024,1,1,0,0,100,100000,1429,70
61227,2024,2,2,0,0,100,105000,1252,84
61228,2024,6,6,0,0,100,154267,1376,108
61229,2024,2,2,0,0,100,205683,1414,146
61230,2024,54,54,0,0,100,164997,1639,96
61232,2024,9,9,0,0,100,104311,1070,103
61233,2024,6,6,0,0,100,94925,1248,76
61234,2024,6,6,0,0,100,181083,1547,120
61237,2024,3,3,0,0,100,170000,1927,103
61238,2024,1,1,0,0,100,88000,647,136
61240,2024,6,6,0,0,100,108967,1260,86
61241,2024,4,4,0,0,100,179500,1632,107
61242,2024,9,9,0,0,100,151172,2493,79
61243,2024,13,13,0,0,100,156482,1563,104
61244,2024,4,4,0,0,100,309000,2913,94
61248,2024,8,8,0,0,100,106998,1320,78
61251,2024,1,1,0,0,100,220000,1333,165
61252,2024,3,3,0,0,100,81667,1598,58
61255,2024,15,15,0,0,100,146687,1324,109
61256,2024,1,1,0,0,100,116000,1160,100
61258,2024,10,10,0,0,100,112490,1212,102
61260,2024,8,8,0,0,100,119431,1351,90
61261,2024,2,2,0,0,100,87750,1074,100
61263,2024,2,2,0,0,100,190000,1522,124
61264,2024,1,1,0,0,100,115000,752,153
61265,2024,1,1,0,0,100,115000,793,145
61266,2024,3,3,0,0,100,85643,1037,91
61267,2024,9,9,0,0,100,71722,1010,73
61268,2024,3,3,0,0,100,102833,1544,63
61269,2024,8,8,0,0,100,139869,1206,126
61271,2024,2,2,0,0,100,51000,1868,32
61273,2024,2,2,0,0,100,171000,1570,108
61274,2024,1,1,0,0,100,126000,969,130
61275,2024,15,15,0,0,100,86306,1029,89
61277,2024,1,1,0,0,100,140500,1033,136
61278,2024,30,30,0,0,100,119877,1362,85
61281,2024,5,5,0,0,100,131030,1471,89
61283,2024,6,6,0,0,100,130650,1286,100
61284,2024,4,4,0,0,100,275525,2000,148
61286,2024,2,2,0,0,100,283229,2054,135
61287,2024,6,6,0,0,100,120746,1341,88
61288,2024,5,5,0,0,100,157800,1376,106
61289,2024,1,1,0,0,100,190000,4130,46
61290,2024,3,3,0,0,100,111425,1445,97
61292,2024,9,9,0,0,100,84589,1078,86
61293,2024,47,44,3,6,94,167563,1665,94
61294,2024,9,9,0,0,100,134278,1157,111
61295,2024,1,1,0,0,100,157000,1892,83
61297,2024,10,10,0,0,100,88250,1043,84
61298,2024,5,5,0,0,100,181400,1807,110
61300,2024,1,1,0,0,100,80000,1905,42
61301,2024,2,2,0,0,100,81950,1796,49
61302,2024,2,2,0,0,100,86000,992,83
61303,2024,7,7,0,0,100,317439,2701,108
61304,2024,3,3,0,0,100,91833,1082,85
61307,2024,2,2,0,0,100,89750,976,98
61309,2024,30,29,1,3,97,240204,1984,125
61310,2024,2,2,0,0,100,97500,1411,76
61314,2024,4,4,0,0,100,156375,1468,109
61316,2024,1,1,0,0,100,100000,909,110
61317,2024,3,3,0,0,100,108408,1538,71
61319,2024,3,3,0,0,100,260535,1986,130
61321,2024,4,4,0,0,100,246750,1456,131
61322,2024,1,1,0,0,100,349000,4309,81
61323,2024,3,3,0,0,100,146000,1461,116
61324,2024,19,19,0,0,100,95945,1009,95
61326,2024,5,5,0,0,100,91588,1088,84
61327,2024,9,9,0,0,100,115278,1428,82
61328,2024,5,5,0,0,100,154400,1651,93
61329,2024,10,10,0,0,100,71516,1569,59
61330,2024,2,2,0,0,100,154495,1680,92
61331,2024,3,3,0,0,100,297333,1717,127
61332,2024,3,3,0,0,100,138700,1461,98
61333,2024,2,2,0,0,100,59500,856,58
61336,2024,2,2,0,0,100,350000,1800,190
61339,2024,25,25,0,0,100,155881,1394,111
61341,2024,18,16,2,11,89,156712,1457,105
61342,2024,14,14,0,0,100,120335,1284,96
61344,2024,15,15,0,0,100,106840,1301,93
61345,2024,30,30,0,0,100,161447,1648,94
61346,2024,5,5,0,0,100,309630,3110,93
61347,2024,1,1,0,0,100,90000,1034,87
61348,2024,4,4,0,0,100,156075,1664,90
61349,2024,3,3,0,0,100,124667,1358,97
61350,2024,2,2,0,0,100,127500,1038,114
61351,2024,4,4,0,0,100,183528,2214,90
61352,2024,3,3,0,0,100,82200,1482,57
61357,2024,3,3,0,0,100,95253,1296,88
61358,2024,3,3,0,0,100,119193,1241,102
61361,2024,1,1,0,0,100,80000,870,92
61362,2024,2,2,0,0,100,101500,1096,92
61363,2024,2,2,0,0,100,206750,2052,108
61365,2024,8,8,0,0,100,169962,1670,106
61366,2024,4,4,0,0,100,87290,1225,70
61367,2024,2,2,0,0,100,176650,2339,74
61369,2024,10,10,0,0,100,120010,1236,90
61370,2024,2,2,0,0,100,97450,1058,95
61371,2024,4,4,0,0,100,114750,1430,84
61372,2024,1,1,0,0,100,135000,1144,118
61373,2024,2,2,0,0,100,164140,1238,130
61374,2024,4,4,0,0,100,96625,1149,88
61375,2024,7,7,0,0,100,161529,1515,111
61376,2024,15,15,0,0,100,100253,1133,92
61379,2024,4,4,0,0,100,176000,2039,88
61381,2024,2,2,0,0,100,378000,1854,186
61382,2024,9,9,0,0,100,87833,979,87
61384,2024,4,4,0,0,100,102371,998,106
61385,2024,4,4,0,0,100,75625,1183,67
61386,2024,3,3,0,0,100,187580,1328,117
61387,2024,11,11,0,0,100,100482,1034,98
61388,2024,1,1,0,0,100,310970,2591,120
61389,2024,24,23,1,4,96,104542,1165,88
61391,2024,41,31,10,24,76,100308,1273,81
61392,2024,6,6,0,0,100,117200,1377,85
61393,2024,1,1,0,0,100,920000,2884,319
61394,2024,14,14,0,0,100,178968,1781,99
61395,2024,3,3,0,0,100,182533,2249,77
61396,2024,3,3,0,0,100,205000,1460,121
61397,2024,35,33,2,6,94,144911,1626,91
61398,2024,1,1,0,0,100,145000,1355,107
61399,2024,3,3,0,0,100,216300,2414,92
61400,2024,6,6,0,0,100,118833,1289,92
61401,2024,1,1,0,0,100,120000,976,123
61402,2024,3,3,0,0,100,91153,1223,70
61404,2024,4,4,0,0,100,192450,2034,98
61405,2024,7,7,0,0,100,131766,1411,93
61406,2024,3,2,1,33,67,172508,1386,118
61407,2024,8,8,0,0,100,184871,1463,104
61408,2024,1,1,0,0,100,25000,694,36
61411,2024,3,3,0,0,100,143333,1338,102
61412,2024,9,9,0,0,100,118611,1297,91
61413,2024,2,2,0,0,100,194000,3085,92
61414,2024,8,8,0,0,100,189250,1723,107
61415,2024,4,4,0,0,100,303219,2302,126
61416,2024,2,2,0,0,100,202500,2294,84
61418,2024,7,7,0,0,100,262246,2404,95
61419,2024,6,6,0,0,100,105800,1122,87
61420,2024,1,1,0,0,100,123800,1456,85
61421,2024,16,16,0,0,100,109003,1134,94
61422,2024,8,8,0,0,100,130625,1290,105
61423,2024,5,5,0,0,100,229800,2259,105
61425,2024,1,1,0,0,100,50000,556,90
61426,2024,12,12,0,0,100,241281,1944,108
61427,2024,1,1,0,0,100,138000,1568,88
61429,2024,7,7,0,0,100,145000,1586,116
61432,2024,1,1,0,0,100,110000,1375,80
61433,2024,1,1,0,0,100,160000,2162,74
61435,2024,4,4,0,0,100,133500,1683,84
61438,2024,3,3,0,0,100,317730,2245,121
61439,2024,3,3,0,0,100,68333,633,110
61440,2024,9,9,0,0,100,155749,1696,97
61442,2024,5,5,0,0,100,152000,1499,105
61443,2024,6,6,0,0,100,73347,870,85
61444,2024,3,3,0,0,100,108500,1373,79
61445,2024,7,7,0,0,100,118184,1324,87
61446,2024,1,1,0,0,100,30000,500,60
61447,2024,16,16,0,0,100,173118,1664,100
61448,2024,2,2,0,0,100,116000,1460,72
61450,2024,1,1,0,0,100,418000,1990,210
61451,2024,4,4,0,0,100,147250,2066,76
61453,2024,4,4,0,0,100,78125,955,70
61454,2024,5,5,0,0,100,124624,1173,101
61456,2024,12,12,0,0,100,145167,1935,79
61457,2024,5,5,0,0,100,130000,1701,79
61459,2024,2,2,0,0,100,143238,1374,102
61460,2024,14,14,0,0,100,90821,1085,86
61461,2024,3,3,0,0,100,97667,1157,87
61462,2024,8,8,0,0,100,175042,1638,108
61463,2024,16,16,0,0,100,134584,1485,93
61464,2024,40,32,8,20,80,106772,1341,82
61466,2024,22,22,0,0,100,118932,1411,87
61467,2024,4,4,0,0,100,167500,1998,83
61472,2024,3,3,0,0,100,137933,1332,113
61473,2024,2,2,0,0,100,102875,1737,97
61474,2024,52,52,0,0,100,146204,1564,93
61475,2024,11,10,1,9,91,121545,1354,89
61476,2024,2,2,0,0,100,94000,1975,50
61479,2024,1,1,0,0,100,154000,2232,69
61480,2024,5,5,0,0,100,139500,1442,93
61482,2024,5,5,0,0,100,93860,1584,64
61483,2024,98,25,73,74,26,113806,2112,57
61484,2024,33,32,1,3,97,156647,1655,102
61485,2024,4,4,0,0,100,81722,878,95
61486,2024,65,63,2,3,97,95929,1119,88
61487,2024,10,10,0,0,100,109592,1055,92
61488,2024,1,1,0,0,100,118000,967,122
61490,2024,1,1,0,0,100,88953,774,115
61491,2024,51,51,0,0,100,135967,1493,92
61493,2024,2,2,0,0,100,131200,1273,102
61494,2024,19,19,0,0,100,121020,1146,107
61497,2024,13,13,0,0,100,163100,1737,96
61498,2024,2,2,0,0,100,266625,2299,118
61499,2024,4,4,0,0,100,132075,1400,97
61500,2024,4,4,0,0,100,79125,1246,76
61501,2024,7,7,0,0,100,244286,2522,106
61503,2024,8,8,0,0,100,112850,1112,115
61505,2024,3,3,0,0,100,212333,1519,138
61507,2024,3,3,0,0,100,168333,2201,90
61508,2024,45,40,5,11,89,103847,1219,88
61510,2024,2,2,0,0,100,417500,3278,136
62001,2024,12,12,0,0,100,170658,1758,99
62002,2024,1,1,0,0,100,275000,1042,264
62003,2024,8,6,2,25,75,193325,2117,89
62004,2024,89,74,15,17,83,166543,2039,84
62005,2024,6,6,0,0,100,177533,1682,113
62006,2024,5,5,0,0,100,149500,1260,118
62007,2024,9,9,0,0,100,222511,2059,114
62008,2024,5,5,0,0,100,146704,1697,88
62009,2024,3,3,0,0,100,116833,964,107
62010,2024,1,1,0,0,100,95000,1284,74
62011,2024,8,8,0,0,100,191051,2050,92
62012,2024,1,1,0,0,100,142000,1753,81
62013,2024,10,10,0,0,100,174292,1672,102
62014,2024,78,69,9,12,88,157287,1553,102
62015,2024,6,6,0,0,100,212367,2872,74
62016,2024,3,3,0,0,100,239167,2216,108
62017,2024,1,1,0,0,100,55000,632,87
62018,2024,2,2,0,0,100,130000,852,134
62019,2024,38,35,3,8,92,165504,1781,92
62020,2024,4,4,0,0,100,247212,2463,105
62021,2024,2,2,0,0,100,230500,2160,100
62022,2024,1,1,0,0,100,419995,2485,169
62023,2024,27,27,0,0,100,158963,1636,98
62024,2024,7,7,0,0,100,160884,1435,109
62025,2024,23,22,1,4,96,290423,3075,100
62026,2024,1,1,0,0,100,191000,1736,110
62027,2024,4,4,0,0,100,165775,1846,100
62028,2024,4,4,0,0,100,103000,962,112
62029,2024,6,6,0,0,100,129500,1556,98
62030,2024,4,4,0,0,100,161500,1736,95
62031,2024,9,9,0,0,100,176604,1953,99
62032,2024,31,31,0,0,100,152654,1742,91
62033,2024,43,43,0,0,100,159176,1762,91
62034,2024,18,18,0,0,100,149559,1713,88
62035,2024,68,68,0,0,100,162682,1705,96
62036,2024,8,8,0,0,100,118449,1453,84
62037,2024,28,23,5,18,82,320974,2751,114
62038,2024,36,35,1,3,97,215099,2093,105
62039,2024,10,10,0,0,100,266128,2062,126
62040,2024,76,70,6,8,92,145297,1662,90
62041,2024,467,213,254,54,46,171964,2358,77
62042,2024,5,5,0,0,100,118640,1640,73
62043,2024,14,14,0,0,100,180536,1956,94
62044,2024,9,9,0,0,100,210193,2296,91
62045,2024,11,10,1,9,91,188752,1824,107
62046,2024,7,7,0,0,100,132768,1534,93
62047,2024,2,2,0,0,100,164500,1978,92
62048,2024,102,94,8,8,92,96053,1136,87
62049,2024,9,9,0,0,100,111916,1070,105
62050,2024,10,10,0,0,100,85956,954,91
62051,2024,45,45,0,0,100,164037,1795,96
62052,2024,3,3,0,0,100,402333,3219,134
62053,2024,7,7,0,0,100,115214,1266,97
62054,2024,5,4,1,20,80,255460,3407,76
62055,2024,4,4,0,0,100,95500,1166,89
62056,2024,8,7,1,12,88,344129,4065,87
62057,2024,45,45,0,0,100,198579,1883,107
62058,2024,1,1,0,0,100,46000,455,101
62059,2024,2,2,0,0,100,388600,1770,226
62060,2024,27,27,0,0,100,97259,1141,88
62061,2024,3,3,0,0,100,156667,1489,100
62062,2024,1,1,0,0,100,97000,843,115
62063,2024,15,15,0,0,100,129125,1296,99
62064,2024,1,1,0,0,100,239000,1219,196
62065,2024,136,98,38,28,72,110780,1466,77
62066,2024,1,1,0,0,100,97000,1311,74
62067,2024,4,4,0,0,100,134186,1396,100
62068,2024,3,3,0,0,100,205433,1532,136
62069,2024,1,1,0,0,100,60000,674,89
62070,2024,1,1,0,0,100,225000,1442,156
62071,2024,1,1,0,0,100,50000,833,60
62072,2024,2,2,0,0,100,159250,1612,94
62073,2024,13,13,0,0,100,192750,1977,98
62074,2024,1,1,0,0,100,200000,2000,100
62075,2024,10,10,0,0,100,248550,2105,126
62076,2024,1,1,0,0,100,138955,1616,86
62077,2024,4,4,0,0,100,156362,1566,97
62078,2024,6,6,0,0,100,234883,1818,129
62079,2024,2,2,0,0,100,139000,1707,82
62080,2024,31,29,2,6,94,118160,1298,92
62081,2024,5,5,0,0,100,109245,1342,82
62083,2024,57,57,0,0,100,120401,1326,92
62084,2024,1,1,0,0,100,180000,1731,104
62085,2024,1,1,0,0,100,65000,1016,64
62086,2024,6,6,0,0,100,194492,1529,127
62087,2024,6,6,0,0,100,241475,1968,122
62088,2024,1,1,0,0,100,188550,1328,142
62089,2024,2,2,0,0,100,492695,3136,156
62090,2024,3,3,0,0,100,110500,1019,107
62092,2024,3,3,0,0,100,131733,1437,113
62093,2024,3,3,0,0,100,173702,1942,96
62094,2024,5,5,0,0,100,110000,1255,84
62095,2024,2,2,0,0,100,95500,1470,65
62096,2024,4,4,0,0,100,105900,932,117
62097,2024,21,21,0,0,100,165129,1912,89
62099,2024,37,32,5,14,86,184260,2039,91
62100,2024,10,10,0,0,100,145896,1712,92
62101,2024,1,1,0,0,100,128000,962,133
62104,2024,3,3,0,0,100,257807,2348,110
62105,2024,2,2,0,0,100,378500,2158,201
62106,2024,3,3,0,0,100,219500,2420,91
62107,2024,3,3,0,0,100,135333,1359,96
62108,2024,321,127,194,60,40,163414,2970,59
62109,2024,2,2,0,0,100,145325,1642,86
62111,2024,2,2,0,0,100,194375,1536,126
62112,2024,4,4,0,0,100,209188,1828,115
62113,2024,5,5,0,0,100,259980,2412,105
62114,2024,3,3,0,0,100,106988,1376,77
62115,2024,6,6,0,0,100,209483,1768,118
62116,2024,3,3,0,0,100,193333,2507,78
62117,2024,7,7,0,0,100,105021,1244,82
62119,2024,319,196,123,39,61,127214,1676,77
62120,2024,3,3,0,0,100,153050,1185,142
62121,2024,1,1,0,0,100,85000,934,91
62122,2024,1,1,0,0,100,196000,1815,108
62123,2024,4,4,0,0,100,236875,2066,127
62124,2024,3,3,0,0,100,158967,2045,89
62125,2024,5,5,0,0,100,353700,2757,126
62126,2024,83,71,12,14,86,143328,1646,89
62128,2024,42,42,0,0,100,137480,1590,88
62129,2024,1,1,0,0,100,70000,693,101
62130,2024,3,3,0,0,100,192244,2139,91
62131,2024,5,5,0,0,100,96000,1101,88
62132,2024,40,40,0,0,100,182551,1840,95
62133,2024,39,38,1,3,97,128789,1459,90
62135,2024,2,2,0,0,100,137500,1466,98
62138,2024,5,5,0,0,100,90000,867,111
62139,2024,49,49,0,0,100,136460,1544,91
62140,2024,5,5,0,0,100,156838,1297,126
62141,2024,8,8,0,0,100,153922,1357,110
62142,2024,4,4,0,0,100,172250,1949,88
62144,2024,1,1,0,0,100,350000,1667,210
62145,2024,4,4,0,0,100,182612,1317,155
62146,2024,6,6,0,0,100,129667,1483,92
62147,2024,5,5,0,0,100,132935,1551,85
62148,2024,9,9,0,0,100,229944,1902,122
62149,2024,4,4,0,0,100,168612,1878,90
62151,2024,2,2,0,0,100,191500,1534,127
62153,2024,5,5,0,0,100,165654,1508,107
62154,2024,3,3,0,0,100,109833,1069,103
62155,2024,4,4,0,0,100,234488,1933,120
62156,2024,3,3,0,0,100,426427,3128,123
62157,2024,1,1,0,0,100,40000,816,49
62158,2024,11,11,0,0,100,112727,1302,85
62160,2024,382,162,220,58,42,132119,1800,74
62161,2024,7,7,0,0,100,172476,1710,109
62162,2024,12,12,0,0,100,96579,1086,92
62163,2024,2,2,0,0,100,77500,904,95
62164,2024,9,8,1,11,89,127303,1158,113
62165,2024,2,2,0,0,100,240993,1834,134
62166,2024,5,5,0,0,100,166700,1943,97
62167,2024,2,2,0,0,100,150500,1265,100
62168,2024,6,6,0,0,100,141143,1212,115
62169,2024,3,3,0,0,100,169600,1838,91
62170,2024,15,15,0,0,100,222868,1842,123
62172,2024,4,4,0,0,100,134975,1398,92
62173,2024,41,41,0,0,100,159720,1826,87
62174,2024,8,8,0,0,100,197984,2244,90
62175,2024,2,2,0,0,100,157092,1638,92
62176,2024,6,6,0,0,100,305675,2503,124
62177,2024,9,9,0,0,100,135658,1550,83
62178,2024,161,144,17,11,89,119317,1379,88
62179,2024,3,3,0,0,100,222333,1980,120
62180,2024,1,1,0,0,100,295850,2386,124
62181,2024,24,24,0,0,100,135089,1373,101
62182,2024,3,3,0,0,100,130300,1373,93
62183,2024,3,3,0,0,100,142667,1968,73
62184,2024,1,1,0,0,100,30000,545,55
62185,2024,2,2,0,0,100,42500,742,60
62186,2024,75,71,4,5,95,143958,1585,91
62188,2024,35,35,0,0,100,108756,1343,83
62189,2024,2,2,0,0,100,178100,1662,110
62190,2024,16,16,0,0,100,201228,1518,140
62191,2024,3,3,0,0,100,157333,1319,126
62192,2024,2,2,0,0,100,159000,1386,114
62193,2024,736,532,204,28,72,134321,1723,82
62194,2024,38,38,0,0,100,120847,1329,95
62195,2024,12,12,0,0,100,200129,1928,104
62196,2024,3,3,0,0,100,135250,1709,83
62197,2024,21,21,0,0,100,116631,1299,88
62198,2024,3,3,0,0,100,197800,1742,113
62199,2024,9,9,0,0,100,160567,1567,108
62200,2024,6,6,0,0,100,179067,1734,108
62201,2024,109,58,51,47,53,167571,3508,52
62202,2024,5,5,0,0,100,133170,1500,86
62203,2024,3,3,0,0,100,114333,1588,71
62204,2024,10,10,0,0,100,154465,1709,89
62205,2024,2,2,0,0,100,260625,2339,113
62206,2024,2,2,0,0,100,237320,2484,98
62207,2024,4,4,0,0,100,272625,1976,142
62208,2024,1,1,0,0,100,66500,739,90
62209,2024,1,1,0,0,100,100000,1316,76
62211,2024,1,1,0,0,100,255500,1879,136
62212,2024,3,3,0,0,100,188000,1381,126
62213,2024,6,6,0,0,100,263900,1978,134
62214,2024,3,3,0,0,100,288400,2075,135
62215,2024,164,154,10,6,94,149545,1683,91
62216,2024,4,4,0,0,100,163188,1417,113
62217,2024,25,25,0,0,100,118465,1372,89
62218,2024,1,1,0,0,100,220000,1294,170
62219,2024,3,3,0,0,100,191967,1788,125
62220,2024,4,4,0,0,100,149500,1438,108
62222,2024,2,2,0,0,100,179250,1914,102
62223,2024,2,2,0,0,100,200500,2084,94
62224,2024,25,25,0,0,100,143174,1586,90
62225,2024,6,4,2,33,67,137945,2075,77
62227,2024,2,2,0,0,100,120000,1146,106
62229,2024,6,6,0,0,100,188085,1699,113
62230,2024,6,6,0,0,100,276733,2242,125
62231,2024,2,2,0,0,100,134500,1441,86
62232,2024,5,5,0,0,100,117750,1332,87
62233,2024,6,6,0,0,100,220533,1920,113
62234,2024,3,3,0,0,100,86903,1137,79
62235,2024,19,19,0,0,100,265644,2683,104
62236,2024,6,6,0,0,100,141222,1284,103
62237,2024,3,3,0,0,100,249343,2170,112
62238,2024,3,3,0,0,100,147050,1491,99
62239,2024,21,14,7,33,67,275726,2445,108
62240,2024,20,19,1,5,95,158160,1756,91
62241,2024,1,1,0,0,100,395000,1660,238
62242,2024,2,2,0,0,100,85750,1200,70
62244,2024,62,57,5,8,92,161352,1867,87
62245,2024,4,4,0,0,100,109888,1573,71
62246,2024,3,3,0,0,100,120875,1152,108
62247,2024,4,4,0,0,100,173000,1652,97
62248,2024,1,1,0,0,100,200000,1667,120
62249,2024,53,53,0,0,100,144686,1699,86
62250,2024,94,92,2,2,98,155743,1691,94
62251,2024,3,3,0,0,100,207933,1920,110
62252,2024,22,22,0,0,100,229970,2304,106
62254,2024,8,8,0,0,100,115436,1228,93
62255,2024,4,4,0,0,100,241332,1920,117
62256,2024,1,1,0,0,100,125500,1004,125
62257,2024,8,8,0,0,100,144894,1368,106
62258,2024,3,3,0,0,100,204667,1459,133
62259,2024,13,12,1,8,92,214759,1911,112
62260,2024,1,1,0,0,100,120000,1412,85
62261,2024,174,92,82,47,53,315426,4490,72
62262,2024,15,15,0,0,100,175658,1745,105
62263,2024,68,60,8,12,88,181433,1995,90
62264,2024,12,12,0,0,100,166567,1710,99
62265,2024,9,9,0,0,100,150289,1425,104
62266,2024,2,2,0,0,100,180000,2052,90
62267,2024,2,2,0,0,100,206875,1502,138
62268,2024,59,58,1,2,98,121510,1499,83
62269,2024,9,9,0,0,100,128456,1315,103
62270,2024,55,47,8,15,85,124840,1347,93
62271,2024,4,4,0,0,100,178375,1531,124
62272,2024,1,1,0,0,100,187000,1989,94
62273,2024,5,5,0,0,100,190530,1733,120
62274,2024,46,46,0,0,100,152025,1676,90
62275,2024,2,2,0,0,100,151800,950,144
62276,2024,56,55,1,2,98,173276,1821,96
62277,2024,27,26,1,4,96,161299,1648,98
62278,2024,6,6,0,0,100,237012,2193,102
62279,2024,4,4,0,0,100,272662,2137,126
62280,2024,1,1,0,0,100,88000,1073,82
62282,2024,3,3,0,0,100,120333,1491,113
62284,2024,31,31,0,0,100,151391,1397,105
62285,2024,10,10,0,0,100,182540,1522,121
62286,2024,6,6,0,0,100,139617,1302,110
62288,2024,10,10,0,0,100,225333,1937,123
62289,2024,3,3,0,0,100,205250,1967,102
62290,2024,1,1,0,0,100,181800,2244,81
62291,2024,40,35,5,12,88,119736,1509,80
62292,2024,11,11,0,0,100,181818,1667,103
62293,2024,4,4,0,0,100,96932,921,109
62295,2024,25,25,0,0,100,119274,1154,105
62296,2024,5,5,0,0,100,187560,1918,110
62297,2024,26,26,0,0,100,154745,1596,98
62298,2024,10,10,0,0,100,142410,1300,121
62299,2024,1,1,0,0,100,208000,1276,163
62300,2024,17,14,3,18,82,288916,3779,87
62301,2024,3,3,0,0,100,127000,1374,99
62302,2024,4,4,0,0,100,152000,1644,94
62304,2024,4,4,0,0,100,134875,1386,100
62306,2024,1,1,0,0,100,115000,1075,107
62307,2024,2,2,0,0,100,475000,3530,134
62308,2024,3,3,0,0,100,225333,2070,104
62309,2024,7,7,0,0,100,184861,1451,111
62310,2024,14,14,0,0,100,212655,1842,114
62311,2024,14,14,0,0,100,177304,1804,97
62312,2024,3,3,0,0,100,240333,2022,119
62313,2024,12,12,0,0,100,127946,1439,87
62314,2024,3,3,0,0,100,142397,1884,86
62315,2024,3,3,0,0,100,132433,1388,93
62316,2024,3,3,0,0,100,235000,1984,110
62317,2024,4,4,0,0,100,239500,1622,154
62318,2024,104,85,19,18,82,200888,2617,82
62319,2024,1,1,0,0,100,225000,1562,144
62320,2024,3,3,0,0,100,162091,1624,90
62321,2024,41,41,0,0,100,184501,1856,100
62322,2024,2,2,0,0,100,89000,965,119
62323,2024,10,10,0,0,100,180140,1947,96
62324,2024,9,9,0,0,100,172420,1780,101
62325,2024,14,13,1,7,93,96335,1043,94
62326,2024,2,2,0,0,100,200000,1902,108
62327,2024,4,4,0,0,100,119650,1470,92
62328,2024,9,9,0,0,100,80987,873,85
62329,2024,14,14,0,0,100,205568,1967,103
62330,2024,13,13,0,0,100,212546,1873,114
62331,2024,8,8,0,0,100,213375,1924,112
62332,2024,4,4,0,0,100,331625,1797,182
62333,2024,3,3,0,0,100,98433,981,98
62334,2024,6,6,0,0,100,192000,1365,148
62335,2024,4,4,0,0,100,134250,1300,98
62336,2024,1,1,0,0,100,85000,766,111
62337,2024,3,3,0,0,100,124500,1468,85
62338,2024,21,21,0,0,100,294159,2573,120
62339,2024,2,2,0,0,100,74250,638,112
62340,2024,8,8,0,0,100,119000,1110,108
62341,2024,7,7,0,0,100,144719,966,147
62343,2024,3,3,0,0,100,209347,1614,131
62344,2024,2,2,0,0,100,168900,1430,116
62345,2024,3,3,0,0,100,180333,1726,106
62346,2024,3,3,0,0,100,200267,2107,100
62347,2024,2,2,0,0,100,104135,1658,66
62349,2024,19,19,0,0,100,183297,1900,97
62350,2024,7,7,0,0,100,170286,1914,86
62351,2024,40,40,0,0,100,122220,1417,89
62352,2024,4,4,0,0,100,94750,974,96
62353,2024,1,1,0,0,100,80000,1176,68
62354,2024,4,4,0,0,100,183375,1935,96
62355,2024,7,7,0,0,100,183057,1590,116
62356,2024,5,5,0,0,100,104290,1442,77
62357,2024,1,1,0,0,100,170000,1753,97
62359,2024,8,8,0,0,100,138202,1463,102
62360,2024,8,7,1,12,88,180462,1762,104
62361,2024,26,26,0,0,100,87323,971,88
62363,2024,3,3,0,0,100,211650,1940,112
62364,2024,13,13,0,0,100,148424,1369,106
62365,2024,4,4,0,0,100,108500,1167,92
62366,2024,4,4,0,0,100,131711,1111,123
62367,2024,5,5,0,0,100,173130,1485,112
62369,2024,9,9,0,0,100,208631,2002,106
62370,2024,2,2,0,0,100,77500,830,93
62371,2024,18,18,0,0,100,183719,1860,101
62373,2024,7,7,0,0,100,152471,1528,100
62374,2024,3,3,0,0,100,165350,1537,101
62376,2024,23,23,0,0,100,232906,1987,118
62377,2024,8,8,0,0,100,178245,1405,120
62378,2024,1,1,0,0,100,375000,2358,159
62380,2024,2,2,0,0,100,182720,1412,130
62381,2024,2,2,0,0,100,164850,1081,154
62382,2024,4,4,0,0,100,184375,1228,166
62383,2024,12,12,0,0,100,187668,1883,100
62384,2024,5,5,0,0,100,131600,1373,98
62385,2024,2,2,0,0,100,57500,716,78
62386,2024,28,19,9,32,68,132260,1601,80
62387,2024,5,5,0,0,100,170680,2037,99
62388,2024,3,3,0,0,100,119500,1139,103
62390,2024,18,18,0,0,100,223101,2472,96
62391,2024,11,11,0,0,100,153495,1441,107
62392,2024,1,1,0,0,100,150000,915,164
62393,2024,9,9,0,0,100,241158,2199,111
62396,2024,1,1,0,0,100,199700,1832,109
62397,2024,46,45,1,2,98,143601,1829,82
62398,2024,1,1,0,0,100,226000,1404,161
62399,2024,5,5,0,0,100,233740,1890,139
62400,2024,34,34,0,0,100,132299,1397,97
62401,2024,46,46,0,0,100,160259,1735,92
62402,2024,4,4,0,0,100,103600,1284,85
62403,2024,11,11,0,0,100,165961,1565,103
62404,2024,3,3,0,0,100,140667,1731,84
62405,2024,4,4,0,0,100,185538,1474,124
62406,2024,3,3,0,0,100,165000,1312,118
62407,2024,6,6,0,0,100,208695,1646,125
62408,2024,8,8,0,0,100,192775,1805,102
62409,2024,3,3,0,0,100,149067,1500,101
62411,2024,1,1,0,0,100,130500,1374,95
62412,2024,9,9,0,0,100,196778,1367,154
62413,2024,98,95,3,3,97,122288,1435,86
62414,2024,5,5,0,0,100,186366,1897,110
62415,2024,5,5,0,0,100,182716,1744,106
62416,2024,2,2,0,0,100,135500,1104,125
62418,2024,3,3,0,0,100,190217,1465,126
62419,2024,1,1,0,0,100,118000,1326,89
62421,2024,4,4,0,0,100,116135,1055,102
62422,2024,6,6,0,0,100,133144,986,129
62423,2024,19,19,0,0,100,182591,1783,101
62424,2024,3,3,0,0,100,187000,1414,136
62426,2024,2,2,0,0,100,129500,1597,82
62427,2024,268,222,46,17,83,123426,1448,86
62428,2024,7,7,0,0,100,207797,2213,92
62429,2024,1,1,0,0,100,155000,2039,76
62430,2024,2,2,0,0,100,95000,780,124
62432,2024,4,4,0,0,100,237900,2045,120
62434,2024,1,1,0,0,100,71449,550,130
62435,2024,1,1,0,0,100,160000,1905,84
62436,2024,1,1,0,0,100,118000,720,164
62437,2024,4,4,0,0,100,114425,1275,96
62438,2024,3,3,0,0,100,231333,2162,109
62439,2024,8,8,0,0,100,186138,1795,110
62440,2024,4,4,0,0,100,84475,908,104
62441,2024,3,3,0,0,100,135330,1236,105
62442,2024,3,3,0,0,100,137476,1772,77
62443,2024,49,46,3,6,94,135795,1369,98
62444,2024,2,2,0,0,100,148250,3171,59
62445,2024,9,8,1,11,89,145253,1616,88
62446,2024,6,6,0,0,100,137783,1562,95
62447,2024,31,27,4,13,87,121381,1324,102
62448,2024,15,15,0,0,100,246347,1959,127
62449,2024,1,1,0,0,100,95000,969,98
62450,2024,3,3,0,0,100,163667,1384,119
62451,2024,3,3,0,0,100,77100,632,118
62452,2024,10,10,0,0,100,263097,2269,118
62454,2024,23,23,0,0,100,253476,2213,115
62456,2024,4,4,0,0,100,224225,2238,98
62457,2024,53,53,0,0,100,142088,1509,93
62458,2024,16,16,0,0,100,169939,1890,92
62459,2024,3,3,0,0,100,196214,1449,151
62460,2024,1,1,0,0,100,180000,1731,104
62461,2024,11,11,0,0,100,186791,1395,131
62462,2024,1,1,0,0,100,215000,1593,135
62463,2024,1,1,0,0,100,215000,1693,127
62464,2024,24,24,0,0,100,175633,1960,89
62465,2024,1,1,0,0,100,40000,588,68
62466,2024,2,2,0,0,100,324000,2272,131
62467,2024,2,2,0,0,100,109250,1032,109
62468,2024,2,2,0,0,100,160000,1620,101
62469,2024,9,9,0,0,100,119626,1386,99
62471,2024,4,4,0,0,100,237430,2191,112
62472,2024,3,3,0,0,100,145000,1280,124
62473,2024,123,119,4,3,97,112728,1284,87
62474,2024,6,6,0,0,100,174783,2025,85
62475,2024,4,4,0,0,100,115625,1144,100
62476,2024,2,2,0,0,100,126750,1279,94
62477,2024,3,3,0,0,100,268267,1692,159
62479,2024,16,16,0,0,100,138666,1374,99
62480,2024,29,29,0,0,100,157315,1726,91
62481,2024,4,4,0,0,100,142000,1332,108
62483,2024,1,1,0,0,100,313810,2510,125
62484,2024,1,1,0,0,100,183000,2614,70
62485,2024,5,5,0,0,100,117000,955,122
62486,2024,10,10,0,0,100,112250,1304,83
62487,2024,15,15,0,0,100,175027,1987,98
62488,2024,5,5,0,0,100,136200,1290,113
62489,2024,42,42,0,0,100,133007,1404,96
62491,2024,50,48,2,4,96,234921,2238,105
62492,2024,3,3,0,0,100,138667,1635,89
62493,2024,2,2,0,0,100,124500,1386,90
62494,2024,1,1,0,0,100,30000,462,65
62495,2024,3,3,0,0,100,164683,1439,117
62496,2024,2,2,0,0,100,253992,1820,142
62497,2024,66,65,1,2,98,172597,1853,93
62498,2024,224,141,83,37,63,115798,1678,75
62499,2024,3,3,0,0,100,174900,1572,112
62500,2024,4,4,0,0,100,102750,1329,76
62501,2024,1,1,0,0,100,237000,1705,139
62502,2024,39,39,0,0,100,220953,2179,110
62503,2024,1,1,0,0,100,272500,2571,106
62504,2024,2,2,0,0,100,267000,2212,118
62505,2024,1,1,0,0,100,204000,1872,109
62506,2024,9,7,2,22,78,178400,2252,94
62507,2024,3,3,0,0,100,141963,1237,106
62508,2024,7,7,0,0,100,80171,967,69
62509,2024,5,5,0,0,100,143120,1101,127
62510,2024,195,178,17,9,91,134326,1545,87
62511,2024,3,3,0,0,100,124000,1252,101
62512,2024,4,4,0,0,100,128300,1271,92
62513,2024,2,2,0,0,100,196500,1282,155
62514,2024,2,2,0,0,100,232565,2030,128
62515,2024,4,4,0,0,100,111800,1232,90
62516,2024,119,116,3,3,97,107689,1183,91
62519,2024,8,8,0,0,100,131550,1180,116
62520,2024,15,15,0,0,100,210883,2001,102
62521,2024,2,2,0,0,100,42500,486,94
62522,2024,4,4,0,0,100,141155,1631,84
62523,2024,57,57,0,0,100,124808,1493,84
62524,2024,13,13,0,0,100,161654,1695,92
62525,2024,71,63,8,11,89,161152,1810,90
62528,2024,64,62,2,3,97,152721,1687,92
62529,2024,10,10,0,0,100,275120,2508,108
62530,2024,3,3,0,0,100,102500,1049,99
62531,2024,4,4,0,0,100,175775,1946,104
62532,2024,13,13,0,0,100,97010,1128,87
62533,2024,2,2,0,0,100,118500,1088,106
62534,2024,39,37,2,5,95,123636,1435,89
62535,2024,1,1,0,0,100,100000,2000,50
62536,2024,4,4,0,0,100,233312,1878,134
62537,2024,2,2,0,0,100,112500,1161,98
62538,2024,3,3,0,0,100,133631,1761,74
62539,2024,2,2,0,0,100,140000,1184,120
62540,2024,7,7,0,0,100,192385,1843,102
62541,2024,3,3,0,0,100,163333,883,159
62542,2024,1,1,0,0,100,192000,2560,75
62543,2024,17,17,0,0,100,189552,1822,103
62545,2024,1,1,0,0,100,135100,1393,97
62547,2024,1,1,0,0,100,248000,1580,157
62548,2024,90,88,2,2,98,202803,2046,103
62549,2024,15,15,0,0,100,177900,1476,114
62550,2024,11,11,0,0,100,117137,1155,105
62551,2024,1,1,0,0,100,145000,863,168
62552,2024,8,8,0,0,100,147812,1566,94
62553,2024,2,2,0,0,100,116000,982,118
62554,2024,1,1,0,0,100,95000,1338,71
62555,2024,35,35,0,0,100,116751,1358,87
62556,2024,6,6,0,0,100,111168,1604,72
62557,2024,21,21,0,0,100,234558,2227,108
62559,2024,7,7,0,0,100,295114,3026,98
62560,2024,51,51,0,0,100,176813,1934,96
62561,2024,2,2,0,0,100,66500,810,74
62562,2024,2,2,0,0,100,104500,1282,94
62563,2024,80,68,12,15,85,134551,1547,88
62564,2024,6,6,0,0,100,180383,1732,107
62565,2024,2,2,0,0,100,107250,1034,110
62566,2024,2,2,0,0,100,233000,2043,112
62567,2024,9,9,0,0,100,194125,1734,113
62568,2024,6,6,0,0,100,205665,1800,115
62569,2024,5,5,0,0,100,130970,1811,76
62570,2024,71,70,1,1,99,134055,1610,87
62571,2024,107,69,38,36,64,245093,3954,66
62572,2024,11,11,0,0,100,89073,949,97
62573,2024,48,48,0,0,100,174804,1854,95
62574,2024,1,1,0,0,100,235000,2701,87
62576,2024,2,2,0,0,100,90000,759,118
62579,2024,2,2,0,0,100,104500,1197,92
62580,2024,10,10,0,0,100,149120,1476,107
62581,2024,2,2,0,0,100,85175,716,124
62582,2024,5,5,0,0,100,209136,2196,96
62583,2024,3,3,0,0,100,117333,1440,80
62584,2024,7,7,0,0,100,185457,1788,111
62585,2024,5,5,0,0,100,255507,1806,133
62586,2024,1,1,0,0,100,160000,2000,80
62587,2024,69,53,16,23,77,114890,1430,80
62588,2024,15,13,2,13,87,214047,2521,81
62589,2024,9,9,0,0,100,215987,2233,90
62591,2024,1,1,0,0,100,170000,1619,105
62592,2024,5,5,0,0,100,236400,2033,116
62593,2024,1,1,0,0,100,87000,1243,70
62594,2024,2,2,0,0,100,101500,1086,90
62595,2024,13,13,0,0,100,208335,1894,108
62596,2024,2,2,0,0,100,116000,2160,54
62597,2024,3,3,0,0,100,180052,1693,104
62598,2024,4,4,0,0,100,193805,1737,113
62599,2024,2,2,0,0,100,159000,2080,78
62601,2024,3,3,0,0,100,101333,1364,87
62602,2024,1,1,0,0,100,100000,735,136
62603,2024,8,8,0,0,100,186475,1926,100
62604,2024,133,68,65,49,51,396041,5150,83
62606,2024,10,10,0,0,100,255401,2409,107
62609,2024,13,13,0,0,100,328107,3179,117
62610,2024,6,6,0,0,100,148322,3339,90
62611,2024,3,3,0,0,100,204567,1516,143
62612,2024,1,1,0,0,100,264300,2360,112
62613,2024,4,4,0,0,100,167822,2964,68
62614,2024,5,5,0,0,100,211840,1849,115
62615,2024,2,2,0,0,100,487000,3308,142
62616,2024,2,2,0,0,100,92000,1253,92
62617,2024,110,96,14,13,87,119554,1437,85
62618,2024,8,8,0,0,100,168588,2055,82
62619,2024,1,1,0,0,100,105000,1050,100
62620,2024,9,9,0,0,100,119333,1305,89
62621,2024,7,7,0,0,100,180786,1829,99
62622,2024,3,3,0,0,100,145167,1566,100
62623,2024,2,2,0,0,100,201000,1536,142
62624,2024,35,35,0,0,100,165671,1884,91
62626,2024,8,8,0,0,100,166344,1578,104
62627,2024,6,6,0,0,100,187333,1879,96
62628,2024,54,49,5,9,91,120821,1583,79
62629,2024,1,1,0,0,100,224000,2699,83
62630,2024,2,2,0,0,100,205275,2672,86
62631,2024,1,1,0,0,100,105000,938,112
62632,2024,4,4,0,0,100,108750,1279,94
62633,2024,4,4,0,0,100,106850,1205,88
62634,2024,14,14,0,0,100,234344,2066,120
62635,2024,1,1,0,0,100,185450,1344,138
62636,2024,2,2,0,0,100,234000,2408,98
62637,2024,75,65,10,13,87,136620,1670,82
62638,2024,11,11,0,0,100,128390,1258,102
62639,2024,2,2,0,0,100,187100,1952,102
62640,2024,1,1,0,0,100,192500,1504,128
62642,2024,6,6,0,0,100,121342,1070,109
62643,2024,110,106,4,4,96,161387,1775,92
62644,2024,5,5,0,0,100,121560,1449,87
62645,2024,53,52,1,2,98,182990,1925,98
62646,2024,9,9,0,0,100,171754,1931,93
62647,2024,10,10,0,0,100,185166,1638,117
62648,2024,7,7,0,0,100,140172,1770,95
62649,2024,4,4,0,0,100,80500,1034,81
62650,2024,6,6,0,0,100,139259,1431,99
62651,2024,4,4,0,0,100,153728,1390,116
62652,2024,17,17,0,0,100,144794,1647,92
62653,2024,4,4,0,0,100,274238,2150,128
62654,2024,2,2,0,0,100,355000,3998,87
62655,2024,4,4,0,0,100,256250,2418,116
62656,2024,6,6,0,0,100,185233,1812,103
62657,2024,1,1,0,0,100,133500,1712,78
62658,2024,1,1,0,0,100,260000,2407,108
62660,2024,3,3,0,0,100,181333,1872,108
62661,2024,8,8,0,0,100,139330,1669,91
62662,2024,6,6,0,0,100,175546,1823,102
62663,2024,6,6,0,0,100,148739,1462,112
62664,2024,4,4,0,0,100,156625,1361,114
62665,2024,5,5,0,0,100,85500,876,104
62666,2024,34,34,0,0,100,130893,1407,96
62667,2024,92,59,33,36,64,142284,1964,79
62668,2024,2,2,0,0,100,169550,1422,120
62670,2024,6,6,0,0,100,171253,1266,134
62671,2024,2,2,0,0,100,60000,696,95
62672,2024,6,6,0,0,100,127704,1282,102
62673,2024,7,7,0,0,100,141403,1593,87
62674,2024,4,4,0,0,100,311850,1788,171
62675,2024,5,5,0,0,100,150000,1514,97
62676,2024,3,3,0,0,100,96017,1223,81
62677,2024,4,4,0,0,100,123378,1278,105
62678,2024,7,7,0,0,100,147642,1487,101
62679,2024,2,2,0,0,100,135820,1064,128
62680,2024,4,4,0,0,100,183842,2044,91
62681,2024,7,7,0,0,100,207429,1834,117
62682,2024,1,1,0,0,100,83000,1297,64
62683,2024,1,1,0,0,100,173000,1442,120
62684,2024,15,15,0,0,100,187219,1761,104
62685,2024,3,3,0,0,100,139043,1320,104
62686,2024,5,5,0,0,100,102400,1185,84
62688,2024,53,53,0,0,100,204385,2320,92
62689,2024,1,1,0,0,100,185400,1437,129
62690,2024,3,3,0,0,100,120608,1427,86
62691,2024,6,6,0,0,100,157672,1741,92
62692,2024,2,2,0,0,100,170250,2268,76
62693,2024,16,16,0,0,100,193265,1813,106
62694,2024,1,1,0,0,100,70000,660,106
62695,2024,3,3,0,0,100,66667,1122,62
62696,2024,1,1,0,0,100,36000,1385,26
62697,2024,6,6,0,0,100,167992,1862,94
62698,2024,2,2,0,0,100,194500,1896,102
62699,2024,9,9,0,0,100,159250,1913,87
62701,2024,4,4,0,0,100,162950,1527,102
62702,2024,4,4,0,0,100,87180,1357,90
62703,2024,2,2,0,0,100,170000,1605,97
62704,2024,3,3,0,0,100,157667,1726,93
62705,2024,12,12,0,0,100,129061,1622,86
62706,2024,19,19,0,0,100,255393,2205,116
62708,2024,1,1,0,0,100,92150,1059,87
62709,2024,5,5,0,0,100,149099,1409,105
62711,2024,31,28,3,10,90,169886,1939,91
62712,2024,15,15,0,0,100,206557,1906,121
62713,2024,13,13,0,0,100,220692,1835,120
62714,2024,11,11,0,0,100,220358,2081,105
62715,2024,7,7,0,0,100,98000,937,108
62716,2024,3,3,0,0,100,189650,1800,110
62717,2024,3,3,0,0,100,131967,1380,101
62718,2024,11,11,0,0,100,176250,1918,92
62719,2024,5,5,0,0,100,136100,1074,125
62721,2024,12,12,0,0,100,181924,2037,88
62722,2024,3,3,0,0,100,144667,1180,120
62723,2024,2,2,0,0,100,173225,1535,116
62724,2024,41,41,0,0,100,159523,1760,91
62725,2024,4,4,0,0,100,119475,1159,102
62726,2024,3,3,0,0,100,143500,1007,135
62727,2024,12,12,0,0,100,130779,1393,94
62728,2024,12,12,0,0,100,176133,1455,116
62729,2024,1,1,0,0,100,120000,1165,103
62730,2024,11,11,0,0,100,130481,1444,89
62731,2024,3,3,0,0,100,100633,1194,83
62732,2024,1,1,0,0,100,173000,1161,149
62733,2024,6,6,0,0,100,95167,1000,95
62734,2024,10,10,0,0,100,177645,1566,113
62735,2024,24,24,0,0,100,182638,1975,92
62736,2024,31,31,0,0,100,240026,2120,111
62737,2024,42,39,3,7,93,149142,1662,89
62739,2024,2,2,0,0,100,276500,1977,136
62740,2024,4,4,0,0,100,181106,1561,135
62743,2024,4,4,0,0,100,171000,1584,107
62744,2024,37,30,7,19,81,244269,2311,107
62746,2024,55,54,1,2,98,188676,1963,97
62747,2024,2,2,0,0,100,278000,1758,174
62748,2024,23,23,0,0,100,189658,2177,97
62749,2024,4,4,0,0,100,76750,1000,79
62750,2024,4,4,0,0,100,132062,1293,94
62751,2024,5,5,0,0,100,203007,1809,124
62752,2024,10,10,0,0,100,461700,2814,167
62753,2024,66,53,13,20,80,194623,2245,88
62754,2024,7,7,0,0,100,132741,1425,89
62755,2024,27,25,2,7,93,171631,1898,91
62756,2024,13,13,0,0,100,169972,1603,115
62757,2024,58,55,3,5,95,179607,1803,100
62758,2024,138,97,41,30,70,188602,2137,90
62759,2024,2,2,0,0,100,176750,1414,124
62760,2024,1,1,0,0,100,136000,1347,101
62761,2024,1,1,0,0,100,230000,1825,126
62762,2024,2,2,0,0,100,186500,1160,171
62763,2024,9,9,0,0,100,113000,1089,103
62764,2024,33,32,1,3,97,172411,1874,94
62765,2024,142,97,45,32,68,147757,1752,92
62766,2024,6,6,0,0,100,145367,1663,91
62767,2024,56,51,5,9,91,94392,1127,91
62768,2024,2,2,0,0,100,112500,1178,100
62769,2024,7,7,0,0,100,218879,2039,104
62770,2024,27,25,2,7,93,154891,1652,99
62771,2024,48,46,2,4,96,124313,1437,92
62772,2024,4,4,0,0,100,197674,1929,111
62773,2024,44,44,0,0,100,171702,1887,91
62774,2024,34,27,7,21,79,211760,2597,88
62776,2024,1,1,0,0,100,190700,1550,123
62779,2024,1,1,0,0,100,100000,500,200
62780,2024,2,2,0,0,100,178538,1839,98
62781,2024,5,5,0,0,100,134600,1160,116
62782,2024,5,5,0,0,100,125720,1061,115
62783,2024,3,3,0,0,100,157000,1497,116
62784,2024,3,3,0,0,100,195500,1694,121
62785,2024,6,6,0,0,100,175346,1836,95
62786,2024,1,1,0,0,100,120000,1043,115
62788,2024,5,5,0,0,100,160767,1844,87
62789,2024,1,1,0,0,100,220000,2000,110
62791,2024,1,1,0,0,100,147450,1378,107
62792,2024,10,10,0,0,100,134470,1883,73
62793,2024,3,3,0,0,100,187859,1614,122
62794,2024,9,9,0,0,100,157117,1885,85
62795,2024,2,2,0,0,100,127525,1834,66
62796,2024,7,7,0,0,100,214336,1919,113
62797,2024,2,2,0,0,100,183500,1575,116
62798,2024,1,1,0,0,100,143000,1744,82
62799,2024,3,3,0,0,100,135000,1116,143
62800,2024,2,2,0,0,100,130000,1200,107
62801,2024,30,29,1,3,97,162849,1744,95
62802,2024,5,5,0,0,100,110800,1088,101
62803,2024,4,4,0,0,100,154612,1766,89
62804,2024,6,6,0,0,100,135400,1678,89
62805,2024,3,3,0,0,100,118333,1328,95
62806,2024,1,1,0,0,100,493500,3500,141
62808,2024,6,6,0,0,100,145900,1326,109
62809,2024,1,1,0,0,100,150000,962,156
62810,2024,11,11,0,0,100,169899,1660,103
62811,2024,11,11,0,0,100,172813,1569,111
62812,2024,8,8,0,0,100,128838,1265,107
62813,2024,3,3,0,0,100,231733,1983,119
62814,2024,1,1,0,0,100,37000,381,97
62815,2024,3,3,0,0,100,262000,2839,100
62816,2024,1,1,0,0,100,209600,1008,208
62817,2024,11,8,3,27,73,181804,2084,90
62818,2024,2,2,0,0,100,106000,1405,83
62819,2024,6,6,0,0,100,209429,2206,95
62820,2024,2,2,0,0,100,172500,1828,94
62822,2024,1,1,0,0,100,190000,1473,129
62823,2024,3,3,0,0,100,108767,1157,84
62824,2024,1,1,0,0,100,100000,1613,62
62825,2024,3,3,0,0,100,198667,2324,86
62826,2024,318,91,227,71,29,581799,8879,66
62827,2024,12,11,1,8,92,160606,1783,95
62829,2024,2,2,0,0,100,67250,858,73
62830,2024,5,5,0,0,100,116562,1047,108
62831,2024,1,1,0,0,100,110000,1447,76
62832,2024,3,3,0,0,100,209867,2102,100
62833,2024,3,3,0,0,100,143000,1326,101
62834,2024,2,2,0,0,100,152500,1818,86
62835,2024,4,4,0,0,100,105050,1011,102
62836,2024,22,22,0,0,100,276778,2078,132
62837,2024,8,8,0,0,100,179542,1662,110
62839,2024,14,14,0,0,100,156901,1600,102
62841,2024,23,23,0,0,100,142954,1447,96
62842,2024,62,53,9,15,85,153152,1706,90
62843,2024,2,2,0,0,100,107500,646,168
62844,2024,5,5,0,0,100,77387,827,86
62845,2024,2,2,0,0,100,281200,2958,96
62846,2024,50,50,0,0,100,159888,1591,101
62847,2024,20,20,0,0,100,156906,1627,97
62848,2024,36,32,4,11,89,131438,1519,87
62849,2024,20,20,0,0,100,253518,2503,100
62850,2024,6,6,0,0,100,221295,1768,122
62851,2024,5,5,0,0,100,227520,1949,117
62852,2024,9,9,0,0,100,196422,1673,116
62853,2024,5,5,0,0,100,134739,1386,104
62854,2024,3,3,0,0,100,220833,1629,128
62855,2024,4,4,0,0,100,153925,1492,106
62857,2024,1,1,0,0,100,350000,2555,137
62858,2024,4,4,0,0,100,186162,1594,121
62859,2024,1,1,0,0,100,70000,814,86
62860,2024,2,2,0,0,100,195925,1243,155
62861,2024,45,45,0,0,100,205875,1998,104
62862,2024,1,1,0,0,100,81000,675,120
62863,2024,26,26,0,0,100,194875,1812,112
62864,2024,4,4,0,0,100,162472,1402,119
62865,2024,35,35,0,0,100,146661,1611,92
62866,2024,7,7,0,0,100,345799,2686,124
62867,2024,1,1,0,0,100,257350,2548,101
62868,2024,7,7,0,0,100,171009,1340,126
62869,2024,9,9,0,0,100,219281,1945,122
62870,2024,10,10,0,0,100,215870,2273,98
62871,2024,1,1,0,0,100,349390,1664,210
62872,2024,2,2,0,0,100,133500,1827,74
62873,2024,6,6,0,0,100,277687,2113,128
62874,2024,4,4,0,0,100,211079,1466,137
62875,2024,7,7,0,0,100,244686,2052,120
62876,2024,1,1,0,0,100,255800,2325,110
62877,2024,3,3,0,0,100,83900,1318,68
62878,2024,4,4,0,0,100,264850,1857,144
62879,2024,1,1,0,0,100,118000,771,153
62880,2024,5,5,0,0,100,178250,1565,104
62882,2024,14,14,0,0,100,148204,1417,110
62883,2024,4,4,0,0,100,128961,1469,94
62885,2024,1,1,0,0,100,196800,1789,110
62886,2024,3,3,0,0,100,126663,1451,105
62888,2024,2,2,0,0,100,165000,1830,88
62889,2024,3,3,0,0,100,235753,2278,101
62890,2024,3,3,0,0,100,84333,1122,80
62892,2024,7,6,1,14,86,199600,1970,101
62893,2024,115,65,50,43,57,366711,4734,83
62894,2024,49,43,6,12,88,238830,2465,98
62895,2024,68,62,6,9,91,148687,1694,87
62896,2024,7,7,0,0,100,199966,1898,107
62897,2024,7,7,0,0,100,176621,1543,130
62898,2024,4,4,0,0,100,216750,1916,114
62899,2024,28,20,8,29,71,407963,5314,85
62900,2024,9,9,0,0,100,134361,1830,86
62901,2024,8,8,0,0,100,178588,1762,97
62902,2024,23,23,0,0,100,174037,1823,95
62903,2024,1,1,0,0,100,158000,1436,110
62904,2024,4,4,0,0,100,186502,1618,126
62905,2024,4,4,0,0,100,282930,1906,142
62906,2024,19,19,0,0,100,194952,1885,102
62907,2024,56,55,1,2,98,161337,1705,94
62908,2024,9,9,0,0,100,331626,2403,139
62909,2024,3,3,0,0,100,102000,1290,80
63001,2024,26,21,5,19,81,143992,1707,93
63003,2024,73,62,11,15,85,131990,1451,94
63004,2024,21,21,0,0,100,136260,1409,98
63005,2024,8,8,0,0,100,164560,1540,115
63006,2024,3,3,0,0,100,66000,791,86
63007,2024,2,2,0,0,100,78850,1122,70
63008,2024,7,7,0,0,100,63813,1057,67
63009,2024,4,4,0,0,100,90600,1020,96
63010,2024,17,16,1,6,94,94133,933,113
63011,2024,1,1,0,0,100,58000,682,85
63012,2024,7,7,0,0,100,174464,1384,117
63013,2024,12,12,0,0,100,165469,1868,88
63014,2024,112,82,30,27,73,209988,2533,83
63015,2024,1,1,0,0,100,170000,2237,76
63016,2024,9,9,0,0,100,119867,1337,84
63017,2024,1,1,0,0,100,149670,1701,88
63019,2024,45,41,4,9,91,166721,2162,78
63020,2024,3,3,0,0,100,213373,2233,89
63021,2024,6,6,0,0,100,218067,1795,117
63022,2024,33,33,0,0,100,94051,1268,72
63023,2024,7,7,0,0,100,79500,800,96
63024,2024,4,4,0,0,100,153102,1831,86
63025,2024,3,3,0,0,100,194100,1791,103
63026,2024,23,23,0,0,100,242490,2701,94
63027,2024,1,1,0,0,100,64500,645,100
63028,2024,5,5,0,0,100,140106,2212,73
63029,2024,3,3,0,0,100,156672,1205,124
63030,2024,4,3,1,25,75,108850,1362,84
63031,2024,9,9,0,0,100,89828,1051,89
63032,2024,102,36,66,65,35,185625,2507,75
63033,2024,2,2,0,0,100,176000,2030,88
63034,2024,10,10,0,0,100,247794,2335,97
63035,2024,8,8,0,0,100,250148,2382,108
63036,2024,1,1,0,0,100,60000,500,120
63037,2024,5,5,0,0,100,81541,1051,84
63038,2024,91,18,73,80,20,140281,3177,43
63039,2024,5,5,0,0,100,84000,1302,79
63040,2024,50,48,2,4,96,156662,1629,95
63041,2024,3,3,0,0,100,229500,1862,111
63042,2024,19,18,1,5,95,221446,2281,97
63043,2024,4,4,0,0,100,152212,1664,93
63044,2024,1,1,0,0,100,267339,1831,146
63045,2024,8,8,0,0,100,155755,1590,94
63046,2024,2,2,0,0,100,57345,1150,54
63047,2024,88,20,68,77,23,90773,1843,52
63048,2024,8,8,0,0,100,79750,1042,76
63049,2024,8,8,0,0,100,234896,2426,98
63050,2024,40,39,1,2,98,114374,1216,96
63051,2024,4,4,0,0,100,165078,1666,96
63052,2024,7,6,1,14,86,92307,1253,76
63053,2024,3,3,0,0,100,29317,531,63
63054,2024,9,8,1,11,89,135447,1707,83
63055,2024,8,8,0,0,100,120712,1496,78
63056,2024,2,2,0,0,100,114810,1436,90
63057,2024,5,5,0,0,100,144812,1678,88
63058,2024,1,1,0,0,100,290500,1911,152
63059,2024,3,3,0,0,100,151167,1379,104
63060,2024,1,1,0,0,100,58000,483,120
63061,2024,6,6,0,0,100,114067,1176,86
63062,2024,4,4,0,0,100,171091,2050,88
63063,2024,80,67,13,16,84,214660,2401,91
63064,2024,2,2,0,0,100,38450,721,58
63066,2024,18,18,0,0,100,109812,1118,94
63067,2024,2,2,0,0,100,84050,1036,83
63069,2024,54,48,6,11,89,205123,2293,92
63070,2024,59,49,10,17,83,279815,2800,98
63071,2024,3,3,0,0,100,195333,1903,99
63072,2024,10,10,0,0,100,90989,1164,81
63073,2024,2,2,0,0,100,142128,1341,104
63074,2024,5,5,0,0,100,125910,1383,92
63075,2024,312,56,256,82,18,196993,2595,73
63076,2024,1,1,0,0,100,166345,1663,100
63077,2024,7,4,3,43,57,86599,1890,52
63079,2024,1,1,0,0,100,63080,701,90
63080,2024,11,9,2,18,82,150221,1590,91
63081,2024,2,2,0,0,100,47250,1512,38
63082,2024,6,6,0,0,100,80897,1024,73
63083,2024,5,5,0,0,100,249138,2436,94
63084,2024,11,10,1,9,91,344536,3236,110
63085,2024,9,9,0,0,100,179197,2138,89
63086,2024,6,6,0,0,100,69443,1206,62
63087,2024,1,1,0,0,100,50000,1000,50
63088,2024,2,2,0,0,100,99250,1176,86
63089,2024,15,15,0,0,100,230487,2309,103
63090,2024,2,2,0,0,100,164655,1300,130
63091,2024,12,11,1,8,92,154969,1609,91
63092,2024,20,20,0,0,100,205960,1991,104
63093,2024,4,4,0,0,100,93940,1490,90
63094,2024,4,4,0,0,100,74750,928,92
63095,2024,2,2,0,0,100,57500,588,99
63096,2024,3,3,0,0,100,201800,2152,112
63098,2024,10,8,2,20,80,108669,1930,63
63099,2024,34,27,7,21,79,195249,2148,94
63100,2024,7,7,0,0,100,106865,1230,86
63101,2024,1,1,0,0,100,51000,785,65
63102,2024,15,14,1,7,93,90547,1149,87
63103,2024,93,52,41,44,56,169448,2210,81
63104,2024,4,4,0,0,100,55568,1082,59
63105,2024,1,1,0,0,100,35000,500,70
63106,2024,21,20,1,5,95,166983,1900,85
63107,2024,7,7,0,0,100,201900,2011,101
63108,2024,10,10,0,0,100,248210,2254,111
63109,2024,3,3,0,0,100,172857,1712,103
63110,2024,7,7,0,0,100,89700,824,112
63111,2024,1,1,0,0,100,271600,2173,125
63112,2024,2,2,0,0,100,269500,1888,134
63113,2024,1941,321,1620,83,17,145877,2279,65
63114,2024,2,2,0,0,100,160500,1582,102
63115,2024,1,1,0,0,100,160550,1784,90
63116,2024,29,29,0,0,100,154403,1788,84
63117,2024,4,4,0,0,100,104515,1436,88
63118,2024,2,2,0,0,100,81500,532,159
63119,2024,2,2,0,0,100,102250,1244,80
63120,2024,7,7,0,0,100,275903,2013,138
63121,2024,14,14,0,0,100,178837,2048,88
63122,2024,1,1,0,0,100,55000,550,100
63123,2024,2,2,0,0,100,219800,1928,104
63124,2024,213,141,72,34,66,191125,2238,86
63125,2024,48,42,6,12,88,108039,1315,84
63126,2024,11,11,0,0,100,240137,2044,111
63128,2024,6,6,0,0,100,177653,2142,93
63129,2024,9,9,0,0,100,122056,1657,76
63130,2024,3,3,0,0,100,128787,1326,107
63131,2024,14,14,0,0,100,163120,1600,107
63132,2024,19,19,0,0,100,93589,1151,92
63134,2024,1,1,0,0,100,150900,1886,80
63135,2024,6,6,0,0,100,196330,1806,109
63136,2024,4,4,0,0,100,124750,1840,71
63137,2024,11,11,0,0,100,133811,1201,111
63138,2024,5,5,0,0,100,196560,1815,108
63139,2024,9,9,0,0,100,111378,1168,93
63140,2024,1,1,0,0,100,42800,839,51
63141,2024,16,15,1,6,94,294240,2850,104
63142,2024,5,5,0,0,100,84218,1055,76
63143,2024,11,10,1,9,91,177332,1923,93
63144,2024,8,8,0,0,100,72828,1262,62
63145,2024,2,2,0,0,100,90000,1494,76
63146,2024,8,8,0,0,100,229569,1907,122
63147,2024,4,4,0,0,100,171112,1916,92
63148,2024,18,17,1,6,94,288621,2938,103
63149,2024,7,7,0,0,100,215390,2210,102
63150,2024,14,14,0,0,100,232509,2476,93
63151,2024,4,4,0,0,100,99250,1141,85
63152,2024,1,1,0,0,100,30000,411,73
63153,2024,2,2,0,0,100,125500,1778,66
63154,2024,5,5,0,0,100,160192,1801,95
63155,2024,5,5,0,0,100,86346,1187,64
63156,2024,1,1,0,0,100,35800,796,45
63157,2024,5,5,0,0,100,106885,1374,75
63158,2024,6,6,0,0,100,88000,885,92
63159,2024,1,1,0,0,100,135000,1125,120
63160,2024,1,1,0,0,100,203000,2942,69
63161,2024,1,1,0,0,100,145510,2021,72
63162,2024,6,6,0,0,100,107225,1218,88
63163,2024,4,4,0,0,100,168688,1555,113
63164,2024,98,52,46,47,53,156257,2109,75
63165,2024,8,8,0,0,100,74938,668,117
63166,2024,2,2,0,0,100,131375,1466,82
63167,2024,3,3,0,0,100,202807,2246,87
63168,2024,5,5,0,0,100,160745,1524,110
63169,2024,1,1,0,0,100,237000,1580,150
63170,2024,4,4,0,0,100,216438,2068,113
63171,2024,3,3,0,0,100,111100,1242,93
63172,2024,2,2,0,0,100,54000,1094,50
63173,2024,5,5,0,0,100,136400,1830,78
63174,2024,3,3,0,0,100,93500,1348,69
63175,2024,1,1,0,0,100,87400,950,92
63176,2024,1,1,0,0,100,28500,356,80
63177,2024,6,6,0,0,100,136067,1331,101
63178,2024,200,94,106,53,47,157022,2021,78
63179,2024,9,9,0,0,100,112194,1234,96
63180,2024,9,8,1,11,89,211209,1875,97
63181,2024,9,9,0,0,100,190417,1804,100
63182,2024,9,9,0,0,100,94011,950,102
63183,2024,3,3,0,0,100,50000,762,67
63184,2024,2,2,0,0,100,92500,836,119
63185,2024,6,6,0,0,100,141833,1595,96
63187,2024,11,11,0,0,100,107812,1194,95
63188,2024,7,7,0,0,100,184079,1608,121
63189,2024,2,2,0,0,100,96000,691,137
63190,2024,5,4,1,20,80,63400,947,65
63191,2024,2,2,0,0,100,42175,528,79
63192,2024,12,12,0,0,100,100965,1411,72
63193,2024,70,54,16,23,77,208395,2481,85
63194,2024,1,1,0,0,100,40000,556,72
63195,2024,63,60,3,5,95,180852,1979,95
63196,2024,6,6,0,0,100,158042,1272,125
63197,2024,1,1,0,0,100,100000,1000,100
63198,2024,10,10,0,0,100,182840,2027,87
63199,2024,10,10,0,0,100,113480,1264,90
63200,2024,7,7,0,0,100,167366,2054,78
63201,2024,11,11,0,0,100,182227,1824,102
63202,2024,1,1,0,0,100,113000,592,191
63203,2024,8,8,0,0,100,440273,2852,152
63204,2024,13,13,0,0,100,204563,2148,96
63205,2024,6,6,0,0,100,125883,1544,86
63206,2024,11,11,0,0,100,199207,1482,129
63207,2024,8,8,0,0,100,70403,687,93
63208,2024,4,4,0,0,100,187312,1593,104
63209,2024,1,1,0,0,100,159700,1717,93
63210,2024,26,24,2,8,92,134243,1592,92
63211,2024,13,13,0,0,100,100431,1031,94
63212,2024,23,21,2,9,91,239791,2065,109
63213,2024,15,15,0,0,100,263784,2375,108
63214,2024,51,49,2,4,96,181404,1949,93
63215,2024,11,11,0,0,100,233044,2668,94
63216,2024,2,2,0,0,100,102125,1472,94
63218,2024,5,5,0,0,100,119859,1005,109
63219,2024,4,4,0,0,100,130330,1570,73
63220,2024,2,2,0,0,100,41375,1034,43
63221,2024,1,1,0,0,100,81400,1018,80
63222,2024,3,3,0,0,100,109070,1530,65
63223,2024,4,4,0,0,100,112173,1383,91
63224,2024,8,8,0,0,100,201759,2115,100
63225,2024,13,12,1,8,92,68823,1100,69
63226,2024,30,30,0,0,100,186576,1908,99
63227,2024,20,20,0,0,100,223523,2317,96
63228,2024,6,6,0,0,100,124293,1398,106
63229,2024,14,14,0,0,100,165543,1781,88
63230,2024,6,6,0,0,100,148217,1572,99
63231,2024,11,11,0,0,100,72988,911,80
63232,2024,7,7,0,0,100,161552,1714,105
63233,2024,12,11,1,8,92,77330,946,84
63234,2024,5,5,0,0,100,185742,1944,102
63235,2024,6,6,0,0,100,166746,1308,117
63236,2024,87,18,69,79,21,120664,2623,48
63237,2024,6,6,0,0,100,111015,1247,83
63239,2024,8,8,0,0,100,126831,1398,86
63240,2024,7,7,0,0,100,185526,1362,131
63241,2024,3,3,0,0,100,222750,2293,99
63242,2024,4,4,0,0,100,172195,1773,100
63243,2024,7,7,0,0,100,71336,840,86
63244,2024,8,8,0,0,100,245284,2231,110
63245,2024,34,32,2,6,94,246358,2372,106
63246,2024,11,5,6,55,45,154745,1803,80
63247,2024,11,7,4,36,64,138482,1697,78
63248,2024,5,5,0,0,100,203301,2527,109
63249,2024,2,2,0,0,100,191975,2070,96
63250,2024,8,8,0,0,100,169120,2057,94
63251,2024,8,8,0,0,100,121541,1096,118
63252,2024,4,4,0,0,100,246075,1947,128
63253,2024,2,2,0,0,100,160000,1558,102
63254,2024,19,19,0,0,100,253418,2486,100
63255,2024,5,5,0,0,100,188240,1748,118
63256,2024,3,3,0,0,100,48952,527,97
63257,2024,3,3,0,0,100,97033,1081,81
63258,2024,9,9,0,0,100,96672,1015,110
63259,2024,3,3,0,0,100,174933,2047,90
63260,2024,3,3,0,0,100,71500,883,81
63261,2024,8,8,0,0,100,164433,1842,91
63262,2024,40,38,2,5,95,242070,2244,109
63263,2024,31,31,0,0,100,269019,2665,107
63264,2024,3,2,1,33,67,180537,5143,73
63265,2024,17,17,0,0,100,267768,2338,117
63267,2024,7,7,0,0,100,130517,1508,81
63268,2024,2,2,0,0,100,193475,1458,138
63269,2024,14,14,0,0,100,203678,2002,105
63270,2024,5,4,1,20,80,404300,4750,119
63271,2024,12,12,0,0,100,124500,1324,96
63272,2024,27,25,2,7,93,295373,2515,117
63273,2024,10,10,0,0,100,226008,2411,97
63274,2024,3,3,0,0,100,140905,1405,89
63275,2024,16,15,1,6,94,191587,1928,106
63276,2024,22,20,2,9,91,135359,1546,88
63277,2024,1,1,0,0,100,96500,1177,82
63278,2024,3,3,0,0,100,255933,2265,113
63279,2024,12,12,0,0,100,156670,1976,79
63280,2024,1,1,0,0,100,208600,1724,121
63281,2024,12,12,0,0,100,85650,1202,69
63282,2024,10,10,0,0,100,162980,1835,89
63283,2024,3,3,0,0,100,71117,878,73
63284,2024,104,97,7,7,93,225850,2507,90
63285,2024,4,4,0,0,100,146475,1156,132
63286,2024,4,4,0,0,100,100825,1636,65
63287,2024,2,2,0,0,100,169550,1714,98
63288,2024,5,5,0,0,100,92954,1856,52
63289,2024,5,5,0,0,100,143436,1056,137
63290,2024,1,1,0,0,100,40000,381,105
63291,2024,23,22,1,4,96,126737,1267,98
63292,2024,1,1,0,0,100,59000,546,108
63293,2024,4,4,0,0,100,69550,790,96
63294,2024,2,2,0,0,100,98543,1630,60
63295,2024,20,20,0,0,100,113044,1155,96
63296,2024,4,4,0,0,100,123800,1678,74
63297,2024,4,4,0,0,100,144625,2156,71
63298,2024,3,3,0,0,100,112500,1210,98
63299,2024,3,3,0,0,100,212460,1706,125
63300,2024,201,124,77,38,62,183151,2149,87
63301,2024,6,6,0,0,100,78880,966,82
63302,2024,23,23,0,0,100,242650,2428,95
63303,2024,2,2,0,0,100,101375,1111,89
63304,2024,2,2,0,0,100,100615,936,117
63305,2024,4,4,0,0,100,158750,1083,147
63306,2024,13,12,1,8,92,313768,2508,121
63307,2024,72,50,22,31,69,206791,2363,87
63308,2024,84,28,56,67,33,158621,2267,64
63309,2024,7,6,1,14,86,134804,1530,98
63310,2024,2,2,0,0,100,66995,450,145
63311,2024,3,3,0,0,100,184967,1486,123
63312,2024,7,7,0,0,100,102161,969,106
63313,2024,5,5,0,0,100,43910,717,74
63314,2024,4,4,0,0,100,157300,1022,140
63315,2024,14,14,0,0,100,243032,2232,110
63317,2024,1,1,0,0,100,99200,1417,70
63318,2024,2,2,0,0,100,69000,900,85
63319,2024,9,9,0,0,100,136888,1859,77
63320,2024,2,2,0,0,100,122130,1090,110
63321,2024,3,3,0,0,100,116433,1202,92
63322,2024,17,16,1,6,94,198290,2301,92
63323,2024,3,3,0,0,100,74938,982,76
63324,2024,4,4,0,0,100,68008,1028,78
63325,2024,2,2,0,0,100,354800,2432,142
63326,2024,6,6,0,0,100,124167,1983,64
63327,2024,18,18,0,0,100,200213,2180,94
63328,2024,4,4,0,0,100,79612,958,87
63329,2024,1,1,0,0,100,232100,2551,91
63330,2024,4,4,0,0,100,166188,1910,116
63331,2024,3,3,0,0,100,53667,792,77
63332,2024,1,1,0,0,100,250915,1991,126
63333,2024,4,4,0,0,100,169905,1518,119
63334,2024,12,12,0,0,100,98637,1426,68
63335,2024,11,11,0,0,100,201866,1726,112
63336,2024,4,4,0,0,100,117500,1180,117
63337,2024,2,2,0,0,100,57500,704,85
63338,2024,31,25,6,19,81,81385,898,88
63339,2024,2,2,0,0,100,34250,422,80
63340,2024,3,3,0,0,100,119167,1060,111
63341,2024,2,2,0,0,100,97250,1278,93
63342,2024,5,5,0,0,100,111764,1239,90
63343,2024,1,1,0,0,100,178000,1695,105
63344,2024,5,5,0,0,100,69855,901,75
63345,2024,25,25,0,0,100,238384,2386,101
63346,2024,1,1,0,0,100,42000,347,121
63347,2024,3,3,0,0,100,156350,1473,103
63348,2024,4,4,0,0,100,118750,870,138
63349,2024,18,17,1,6,94,126438,1309,97
63350,2024,8,8,0,0,100,243771,2247,115
63351,2024,1,1,0,0,100,109900,1505,73
63352,2024,21,21,0,0,100,172716,1567,109
63353,2024,10,9,1,10,90,117898,1521,84
63354,2024,19,19,0,0,100,92120,941,94
63355,2024,4,4,0,0,100,147075,1194,116
63356,2024,4,4,0,0,100,159114,1808,105
63357,2024,1,1,0,0,100,27000,415,65
63358,2024,4,4,0,0,100,105952,1228,77
63360,2024,6,6,0,0,100,70619,794,90
63362,2024,9,9,0,0,100,191389,1869,109
63363,2024,3,3,0,0,100,89183,1005,78
63364,2024,5,5,0,0,100,200870,1851,104
63365,2024,4,4,0,0,100,119812,1285,97
63366,2024,3,3,0,0,100,173183,1870,93
63368,2024,6,6,0,0,100,129942,1510,96
63369,2024,1,1,0,0,100,60000,882,68
63370,2024,1,1,0,0,100,86500,983,88
63371,2024,4,4,0,0,100,82500,890,92
63372,2024,7,7,0,0,100,291003,2527,119
63373,2024,3,3,0,0,100,142667,1255,111
63374,2024,7,7,0,0,100,103057,1408,70
63375,2024,1,1,0,0,100,214500,2357,91
63376,2024,2,2,0,0,100,114528,1408,84
63377,2024,6,6,0,0,100,94116,993,105
63378,2024,7,7,0,0,100,147957,1782,76
63379,2024,4,4,0,0,100,208612,1938,110
63380,2024,16,9,7,44,56,100941,1415,72
63381,2024,13,11,2,15,85,127912,1716,78
63382,2024,2,2,0,0,100,152570,2048,80
63383,2024,1,1,0,0,100,90000,1324,68
63384,2024,5,5,0,0,100,121768,1392,88
63385,2024,2,2,0,0,100,129900,1282,80
63386,2024,4,4,0,0,100,177714,1632,109
63387,2024,8,8,0,0,100,208644,1496,140
63388,2024,7,7,0,0,100,120973,1224,98
63389,2024,2,2,0,0,100,120500,1048,110
63390,2024,2,2,0,0,100,85950,1018,92
63391,2024,2,2,0,0,100,153000,1658,88
63392,2024,4,4,0,0,100,175412,2234,90
63393,2024,27,27,0,0,100,90460,1426,79
63394,2024,4,4,0,0,100,165509,1637,117
63395,2024,3,3,0,0,100,83600,1074,75
63396,2024,11,11,0,0,100,237682,2468,95
63397,2024,11,10,1,9,91,103348,1480,75
63398,2024,3,2,1,33,67,150123,2332,82
63399,2024,3,3,0,0,100,99133,941,96
63400,2024,10,10,0,0,100,138168,1667,82
63401,2024,2,2,0,0,100,169050,1745,100
63402,2024,4,4,0,0,100,111250,1268,78
63403,2024,3,3,0,0,100,182967,1939,83
63404,2024,9,9,0,0,100,201629,2036,92
63405,2024,8,7,1,12,88,113236,1563,74
63406,2024,1,1,0,0,100,90000,1286,70
63407,2024,2,2,0,0,100,165000,1656,100
63408,2024,2,2,0,0,100,88000,1915,49
63409,2024,5,5,0,0,100,97260,1634,63
63410,2024,1,1,0,0,100,70000,778,90
63411,2024,5,5,0,0,100,139902,1240,123
63412,2024,3,3,0,0,100,97467,1151,80
63413,2024,5,5,0,0,100,183610,1924,96
63414,2024,4,4,0,0,100,107612,1202,90
63415,2024,17,17,0,0,100,106153,1208,88
63416,2024,1,1,0,0,100,88000,1571,56
63417,2024,18,17,1,6,94,279646,2468,111
63418,2024,2,2,0,0,100,137000,755,160
63419,2024,5,5,0,0,100,75450,777,99
63420,2024,8,8,0,0,100,155250,1731,90
63421,2024,1,1,0,0,100,137380,1308,105
63422,2024,3,3,0,0,100,150383,1558,105
63423,2024,11,11,0,0,100,132454,1474,98
63424,2024,2,2,0,0,100,279855,2548,110
63425,2024,13,13,0,0,100,229054,2435,98
63426,2024,7,6,1,14,86,112807,1041,105
63427,2024,3,3,0,0,100,175433,1648,107
63428,2024,3,3,0,0,100,66287,1000,65
63430,2024,127,94,33,26,74,101687,1111,88
63431,2024,1,1,0,0,100,62099,1035,60
63432,2024,12,12,0,0,100,169977,1758,98
63434,2024,8,7,1,12,88,76238,914,82
63435,2024,4,4,0,0,100,58112,1832,44
63437,2024,3,3,0,0,100,136667,801,162
63438,2024,3,3,0,0,100,129667,1353,87
63439,2024,1,1,0,0,100,368000,2329,158
63440,2024,3,3,0,0,100,90667,778,120
63441,2024,8,8,0,0,100,140959,1780,78
63442,2024,4,4,0,0,100,86738,988,88
63443,2024,8,8,0,0,100,247962,2460,103
63444,2024,2,2,0,0,100,165785,2276,74
63446,2024,4,4,0,0,100,253450,1819,146
63447,2024,1,1,0,0,100,76100,494,154
63448,2024,14,14,0,0,100,94021,933,85
63449,2024,4,4,0,0,100,139498,1964,70
63450,2024,4,4,0,0,100,77986,772,89
63451,2024,4,4,0,0,100,125250,1420,88
63452,2024,1,1,0,0,100,190000,1900,100
63453,2024,32,30,2,6,94,200806,2156,94
63454,2024,3,3,0,0,100,90137,971,109
63455,2024,30,30,0,0,100,241295,2698,99
63457,2024,49,45,4,8,92,204891,2162,98
63458,2024,2,2,0,0,100,112575,1529,68
63459,2024,5,5,0,0,100,165960,1793,93
63460,2024,9,8,1,11,89,83772,938,89
63461,2024,2,2,0,0,100,69500,1352,52
63462,2024,1,1,0,0,100,70000,778,90
63463,2024,7,7,0,0,100,81422,918,88
63464,2024,3,3,0,0,100,113300,1081,98
63465,2024,7,7,0,0,100,128577,1348,97
63467,2024,2,2,0,0,100,65750,602,112
63468,2024,2,2,0,0,100,66500,1019,70
63469,2024,9,9,0,0,100,127000,1078,105
63470,2024,34,34,0,0,100,183896,2038,91
63471,2024,13,11,2,15,85,70789,827,83
63472,2024,5,5,0,0,100,157930,1512,104
63473,2024,3,3,0,0,100,190050,1629,96
64001,2024,1,1,0,0,100,282000,1669,169
64003,2024,1,1,0,0,100,165000,1269,130
64004,2024,2,2,0,0,100,332500,2048,163
64005,2024,4,4,0,0,100,199098,2307,84
64006,2024,7,6,1,14,86,183357,1524,129
64007,2024,12,12,0,0,100,202754,2172,96
64008,2024,1,1,0,0,100,305000,2075,147
64009,2024,14,10,4,29,71,564127,5761,95
64010,2024,5,5,0,0,100,225777,2037,115
64014,2024,5,3,2,40,60,407558,3058,113
64015,2024,1,1,0,0,100,160000,1333,120
64017,2024,4,4,0,0,100,163250,1224,135
64018,2024,3,2,1,33,67,353553,1545,213
64021,2024,1,1,0,0,100,186000,2657,70
64022,2024,1,1,0,0,100,80000,800,100
64023,2024,10,9,1,10,90,247655,2129,114
64024,2024,701,189,512,73,27,446709,5782,74
64025,2024,2,2,0,0,100,88250,1188,84
64026,2024,2,2,0,0,100,275000,2386,114
64027,2024,4,4,0,0,100,274202,2534,110
64028,2024,2,2,0,0,100,177500,1536,112
64029,2024,3,3,0,0,100,219630,2569,97
64031,2024,1,1,0,0,100,78000,473,165
64032,2024,1,1,0,0,100,270000,1561,173
64035,2024,25,18,7,28,72,773547,6069,124
64036,2024,3,3,0,0,100,222237,1626,118
64037,2024,7,7,0,0,100,275468,2151,126
64038,2024,44,19,25,57,43,621709,6059,94
64039,2024,1,1,0,0,100,170000,2179,78
64040,2024,44,12,32,73,27,99913,2164,49
64041,2024,5,5,0,0,100,290270,2602,111
64042,2024,8,8,0,0,100,224928,2009,117
64044,2024,1,1,0,0,100,237500,1638,145
64046,2024,2,2,0,0,100,223500,1653,131
64047,2024,5,3,2,40,60,164100,2030,75
64048,2024,2,2,0,0,100,181675,1910,96
64049,2024,3,3,0,0,100,105667,1067,94
64050,2024,1,1,0,0,100,350000,1620,216
64051,2024,5,4,1,20,80,169080,1588,114
64053,2024,1,1,0,0,100,235000,1632,144
64054,2024,6,6,0,0,100,293016,2240,122
64057,2024,11,10,1,9,91,182000,1635,112
64058,2024,5,5,0,0,100,133260,1413,102
64059,2024,5,4,1,20,80,232102,2071,127
64060,2024,19,13,6,32,68,222468,2558,88
64061,2024,28,25,3,11,89,180712,1923,97
64062,2024,19,17,2,11,89,134948,1699,86
64063,2024,7,7,0,0,100,204189,1259,155
64064,2024,1,1,0,0,100,168000,1500,112
64065,2024,46,27,19,41,59,564281,4911,115
64066,2024,3,3,0,0,100,366537,3247,112
64067,2024,15,14,1,7,93,282637,2407,116
64068,2024,5,5,0,0,100,320096,2264,138
64069,2024,1,1,0,0,100,90883,699,130
64070,2024,2,2,0,0,100,216000,2370,91
64071,2024,1,1,0,0,100,188000,2238,84
64072,2024,7,7,0,0,100,293664,2850,122
64073,2024,3,3,0,0,100,127667,1162,110
64074,2024,2,2,0,0,100,100000,852,123
64075,2024,2,2,0,0,100,92500,605,158
64077,2024,2,2,0,0,100,238893,2110,113
64078,2024,3,3,0,0,100,198833,1846,112
64079,2024,1,1,0,0,100,175000,1316,133
64080,2024,6,6,0,0,100,274908,2537,110
64081,2024,1,1,0,0,100,238000,1352,176
64083,2024,3,3,0,0,100,187333,1881,101
64084,2024,4,4,0,0,100,117025,1094,122
64085,2024,2,2,0,0,100,242415,2012,120
64086,2024,4,4,0,0,100,575242,3334,170
64087,2024,5,5,0,0,100,240600,1995,115
64088,2024,1,1,0,0,100,115000,1691,68
64089,2024,1,1,0,0,100,135000,2288,59
64090,2024,3,3,0,0,100,136100,908,150
64091,2024,9,8,1,11,89,219220,2040,115
64092,2024,2,2,0,0,100,125500,1966,64
64093,2024,7,6,1,14,86,162193,1471,133
64094,2024,9,7,2,22,78,292117,2856,104
64095,2024,4,4,0,0,100,321497,2147,155
64096,2024,1,1,0,0,100,71250,1781,40
64097,2024,3,3,0,0,100,160263,1739,95
64099,2024,1,1,0,0,100,243000,2641,92
64100,2024,39,22,17,44,56,538127,4847,109
64101,2024,7,7,0,0,100,236121,1864,133
64102,2024,717,74,643,90,10,284731,4251,67
64104,2024,6,6,0,0,100,234117,1547,160
64106,2024,4,3,1,25,75,265500,2142,120
64108,2024,8,8,0,0,100,243312,1632,147
64109,2024,11,11,0,0,100,211186,2021,108
64110,2024,2,1,1,50,50,235000,8292,72
64111,2024,1,1,0,0,100,272000,2473,110
64112,2024,5,5,0,0,100,263500,2766,113
64114,2024,6,6,0,0,100,268396,2208,126
64115,2024,1,1,0,0,100,37200,930,40
64116,2024,3,3,0,0,100,110000,765,147
64117,2024,2,2,0,0,100,239325,2140,108
64120,2024,3,3,0,0,100,238609,1908,119
64121,2024,1,1,0,0,100,570000,3373,169
64122,2024,592,120,472,80,20,559888,7822,70
64123,2024,15,14,1,7,93,278373,2486,123
64124,2024,4,4,0,0,100,234585,2757,85
64125,2024,110,38,72,65,35,558945,6884,78
64126,2024,18,16,2,11,89,184982,1647,111
64127,2024,12,6,6,50,50,107619,1598,68
64128,2024,1,1,0,0,100,375000,1442,260
64129,2024,256,57,199,78,22,160324,2168,74
64130,2024,7,2,5,71,29,223786,2842,79
64131,2024,5,5,0,0,100,203654,1768,121
64132,2024,61,36,25,41,59,225015,2395,95
64133,2024,19,17,2,11,89,213302,2084,109
64134,2024,1,1,0,0,100,465000,3163,147
64135,2024,2,2,0,0,100,199500,1888,114
64137,2024,1,1,0,0,100,246000,4169,59
64138,2024,29,28,1,3,97,240400,2266,112
64139,2024,7,7,0,0,100,291900,2339,127
64140,2024,86,40,46,53,47,339569,4013,82
64141,2024,5,5,0,0,100,147729,1311,127
64142,2024,5,5,0,0,100,290622,2636,110
64143,2024,1,1,0,0,100,170000,1667,102
64144,2024,1,1,0,0,100,69246,888,78
64145,2024,5,5,0,0,100,236568,2124,108
64146,2024,1,1,0,0,100,241700,1831,132
64147,2024,20,10,10,50,50,317797,3592,92
64148,2024,7,7,0,0,100,145434,1366,108
64149,2024,3,3,0,0,100,224800,1333,153
64151,2024,2,2,0,0,100,345530,2455,142
64152,2024,12,12,0,0,100,457529,2642,178
64153,2024,1,1,0,0,100,20000,833,24
64154,2024,1,1,0,0,100,576000,3918,147
64155,2024,1,1,0,0,100,65000,823,79
64156,2024,4,4,0,0,100,179548,1502,113
64157,2024,10,10,0,0,100,201022,1924,108
64159,2024,2,2,0,0,100,167000,1558,115
64160,2024,80,27,53,66,34,254737,3817,71
64161,2024,4,4,0,0,100,258750,2516,100
64165,2024,1,1,0,0,100,189600,1308,145
64167,2024,2,2,0,0,100,293690,2570,114
64168,2024,6,6,0,0,100,195189,1840,110
64170,2024,2,2,0,0,100,89400,2040,56
64171,2024,2,2,0,0,100,152500,1395,110
64172,2024,3,3,0,0,100,222000,1723,130
64173,2024,3,3,0,0,100,107400,901,101
64174,2024,2,2,0,0,100,152500,1506,96
64176,2024,1,1,0,0,100,55000,846,65
64177,2024,5,5,0,0,100,176114,1252,141
64178,2024,9,9,0,0,100,198942,1605,123
64179,2024,2,2,0,0,100,285286,2266,118
64180,2024,5,5,0,0,100,207560,1504,139
64181,2024,2,2,0,0,100,132200,1142,118
64183,2024,9,9,0,0,100,282087,2406,121
64184,2024,3,3,0,0,100,235333,2033,115
64185,2024,1,1,0,0,100,85000,500,170
64186,2024,1,1,0,0,100,55000,764,72
64187,2024,1,1,0,0,100,300000,1667,180
64188,2024,9,8,1,11,89,160392,2002,111
64189,2024,139,16,123,88,12,410130,6010,67
64191,2024,16,15,1,6,94,232388,1928,124
64192,2024,1,1,0,0,100,102000,1457,70
64194,2024,2,2,0,0,100,207590,2327,92
64195,2024,1,1,0,0,100,88000,957,92
64197,2024,2,2,0,0,100,300350,2620,110
64198,2024,15,15,0,0,100,246728,2100,124
64199,2024,1,1,0,0,100,165000,1719,96
64201,2024,3,3,0,0,100,152167,1621,101
64202,2024,2,2,0,0,100,238000,1597,152
64203,2024,1,1,0,0,100,246000,1952,126
64204,2024,62,4,58,94,6,60496,1729,38
64205,2024,1,0,1,100,0,186000,1898,98
64207,2024,4,4,0,0,100,265350,2016,134
64208,2024,6,6,0,0,100,207895,1790,118
64209,2024,3,3,0,0,100,195433,1616,154
64210,2024,2,2,0,0,100,184508,1744,104
64211,2024,4,4,0,0,100,275123,2036,127
64212,2024,2,2,0,0,100,202685,1748,114
64213,2024,13,9,4,31,69,446398,3904,126
64214,2024,4,4,0,0,100,156000,1415,110
64215,2024,2,2,0,0,100,127000,1258,101
64216,2024,5,4,1,20,80,312604,2163,148
64217,2024,5,5,0,0,100,142325,1101,154
64218,2024,1,1,0,0,100,577068,2194,263
64219,2024,1,1,0,0,100,284800,1964,145
64220,2024,2,2,0,0,100,189500,1056,186
64221,2024,2,2,0,0,100,230000,1670,132
64223,2024,8,8,0,0,100,159324,1756,87
64224,2024,6,6,0,0,100,233473,1613,144
64225,2024,5,5,0,0,100,230414,2487,96
64226,2024,4,4,0,0,100,238350,2170,120
64227,2024,5,5,0,0,100,215100,2115,99
64230,2024,46,44,2,4,96,226336,2058,117
64231,2024,2,2,0,0,100,149292,1857,80
64233,2024,13,12,1,8,92,166062,1321,131
64234,2024,6,6,0,0,100,233917,1820,139
64235,2024,1,1,0,0,100,480000,1627,295
64236,2024,1,1,0,0,100,216500,1434,151
64237,2024,50,32,18,36,64,212405,2136,100
64238,2024,14,14,0,0,100,231811,1953,130
64239,2024,3,3,0,0,100,174633,1399,121
64241,2024,5,5,0,0,100,164400,1659,105
64243,2024,1,1,0,0,100,239320,1962,122
64244,2024,1,1,0,0,100,388000,2503,155
64245,2024,6,6,0,0,100,160155,1818,91
64247,2024,9,9,0,0,100,120197,1166,110
64249,2024,26,8,18,69,31,764371,8660,80
64250,2024,8,8,0,0,100,290620,2803,101
64252,2024,6,6,0,0,100,192626,1790,110
64253,2024,4,4,0,0,100,95875,1072,88
64254,2024,2,2,0,0,100,146132,1340,152
64255,2024,5,4,1,20,80,348055,3952,93
64256,2024,48,24,24,50,50,276732,3431,81
64257,2024,2,2,0,0,100,263360,2159,114
64258,2024,1,1,0,0,100,132000,863,153
64259,2024,2,2,0,0,100,275000,2694,102
64260,2024,319,39,280,88,12,273310,4772,59
64261,2024,5,5,0,0,100,115400,1124,122
64263,2024,2,2,0,0,100,82500,1286,73
64266,2024,1,1,0,0,100,799800,2666,300
64268,2024,4,4,0,0,100,186030,1282,154
64269,2024,50,33,17,34,66,317508,2969,111
64270,2024,6,6,0,0,100,234125,2042,111
64271,2024,2,2,0,0,100,464010,3052,166
64273,2024,5,5,0,0,100,301323,2169,145
64274,2024,4,4,0,0,100,277300,2754,101
64275,2024,3,3,0,0,100,293667,2276,130
64276,2024,1,1,0,0,100,179000,2983,60
64277,2024,3,3,0,0,100,294167,3234,91
64279,2024,16,12,4,25,75,377072,4488,96
64280,2024,2,2,0,0,100,137000,1580,126
64281,2024,2,2,0,0,100,306880,1604,186
64282,2024,5,4,1,20,80,471499,4193,117
64284,2024,75,38,37,49,51,203635,2047,99
64286,2024,12,8,4,33,67,197833,1954,102
64287,2024,1,1,0,0,100,280000,1026,273
64288,2024,4,4,0,0,100,180162,1874,116
64289,2024,8,8,0,0,100,465716,3915,118
64290,2024,2,2,0,0,100,339950,3138,148
64291,2024,6,6,0,0,100,141000,1308,118
64292,2024,2,2,0,0,100,230350,2118,110
64293,2024,1,1,0,0,100,157000,1121,140
64294,2024,2,2,0,0,100,187500,2422,76
64296,2024,1,1,0,0,100,222600,2182,102
64298,2024,3,3,0,0,100,276323,1819,162
64299,2024,3,3,0,0,100,120878,1313,97
64300,2024,7,6,1,14,86,101222,1273,85
64301,2024,18,18,0,0,100,183881,1624,114
64302,2024,6,6,0,0,100,211200,1975,110
64303,2024,1,1,0,0,100,175000,1483,118
64304,2024,35,19,16,46,54,331336,3967,87
64305,2024,9,9,0,0,100,188914,1911,101
64306,2024,6,6,0,0,100,252950,2174,121
64307,2024,1,1,0,0,100,170000,1133,150
64310,2024,5,5,0,0,100,131372,1056,123
64311,2024,2,2,0,0,100,159000,1782,93
64312,2024,2,2,0,0,100,291150,2186,136
64313,2024,1,1,0,0,100,450000,3571,126
64314,2024,2,2,0,0,100,454150,2844,155
64315,2024,3,3,0,0,100,280683,2284,131
64316,2024,3,3,0,0,100,136500,1483,97
64317,2024,19,8,11,58,42,326368,3845,88
64320,2024,25,13,12,48,52,132200,2107,70
64323,2024,1,1,0,0,100,70000,1228,57
64324,2024,14,14,0,0,100,227498,1915,124
64325,2024,3,3,0,0,100,101517,1185,101
64328,2024,12,12,0,0,100,179781,1981,92
64329,2024,5,5,0,0,100,486195,2811,164
64330,2024,3,3,0,0,100,118000,1590,75
64331,2024,3,3,0,0,100,103333,1252,84
64332,2024,6,6,0,0,100,186858,1252,159
64335,2024,85,63,22,26,74,260018,2537,104
64337,2024,3,3,0,0,100,181333,1719,118
64339,2024,9,7,2,22,78,143489,1640,119
64342,2024,1,1,0,0,100,161000,1220,132
64343,2024,3,3,0,0,100,241431,2194,106
64344,2024,4,4,0,0,100,220163,2030,132
64347,2024,3,3,0,0,100,147300,1423,117
64348,2024,166,82,84,51,49,205727,2479,85
64349,2024,2,2,0,0,100,167500,2002,118
64350,2024,2,1,1,50,50,270585,5882,60
64351,2024,2,2,0,0,100,169000,3397,54
64352,2024,1,1,0,0,100,105512,1055,100
64353,2024,8,7,1,12,88,178211,1757,104
64354,2024,1,1,0,0,100,179275,4268,42
64355,2024,1,1,0,0,100,225000,2344,96
64357,2024,2,2,0,0,100,218590,2070,106
64358,2024,1,1,0,0,100,234850,1835,128
64359,2024,8,8,0,0,100,251813,1838,143
64360,2024,6,6,0,0,100,80207,1258,61
64362,2024,3,3,0,0,100,271233,2866,102
64363,2024,1,1,0,0,100,70200,439,160
64365,2024,2,2,0,0,100,151000,1459,112
64366,2024,1,1,0,0,100,154000,1283,120
64367,2024,6,6,0,0,100,157523,1548,105
64368,2024,2,2,0,0,100,375232,2728,138
64369,2024,5,5,0,0,100,144460,1233,123
64370,2024,6,6,0,0,100,282696,2224,128
64371,2024,27,21,6,22,78,172792,1466,124
64373,2024,18,15,3,17,83,193226,2122,92
64374,2024,12,11,1,8,92,259504,2243,119
64376,2024,4,4,0,0,100,271415,2168,118
64377,2024,5,5,0,0,100,359496,2432,158
64378,2024,2,2,0,0,100,126500,1326,99
64379,2024,1,1,0,0,100,76000,1310,58
64380,2024,1,1,0,0,100,255950,1969,130
64381,2024,2,2,0,0,100,164131,1338,130
64382,2024,6,6,0,0,100,249682,1807,132
64386,2024,16,14,2,12,88,172389,1819,100
64387,2024,3,3,0,0,100,304333,2117,143
64389,2024,2,2,0,0,100,197745,1821,110
64390,2024,3,3,0,0,100,137900,1604,102
64391,2024,1,1,0,0,100,368180,2045,180
64393,2024,40,36,4,10,90,207421,2142,103
64395,2024,3,3,0,0,100,146400,1201,126
64396,2024,12,12,0,0,100,168666,1708,102
64397,2024,3,3,0,0,100,175857,1705,112
64398,2024,2,2,0,0,100,218250,1876,117
64399,2024,19,19,0,0,100,338714,2532,134
64400,2024,12,12,0,0,100,197714,1808,114
64403,2024,1,1,0,0,100,275000,1730,159
64404,2024,4,4,0,0,100,128500,1670,78
64405,2024,35,29,6,17,83,231831,2289,104
64406,2024,5,5,0,0,100,224600,2096,109
64407,2024,34,23,11,32,68,421869,4154,105
64409,2024,6,6,0,0,100,167917,1515,110
64410,2024,64,25,39,61,39,103662,1295,79
64413,2024,9,9,0,0,100,269752,2776,105
64414,2024,1,1,0,0,100,353050,2354,150
64415,2024,12,12,0,0,100,261441,2446,109
64416,2024,11,8,3,27,73,138283,1324,104
64417,2024,48,31,17,35,65,187320,2046,95
64418,2024,1,0,1,100,0,145000,1629,89
64419,2024,10,9,1,10,90,176413,2065,89
64420,2024,1,1,0,0,100,235350,2159,109
64421,2024,6,6,0,0,100,259264,1963,129
64422,2024,178,87,91,51,49,128586,1497,92
64423,2024,3,3,0,0,100,192033,2278,86
64424,2024,4,4,0,0,100,209750,1869,110
64425,2024,5,5,0,0,100,169406,1634,100
64427,2024,1,1,0,0,100,193450,2174,89
64430,2024,174,97,77,44,56,149627,1732,88
64432,2024,2,2,0,0,100,94250,1178,80
64433,2024,2,2,0,0,100,222500,1158,182
64435,2024,3,3,0,0,100,239733,1809,101
64438,2024,2,2,0,0,100,192075,2240,87
64439,2024,14,13,1,7,93,418641,3541,150
64441,2024,2,2,0,0,100,115500,916,128
64442,2024,1,1,0,0,100,211150,1836,115
64443,2024,8,8,0,0,100,258424,2076,130
64444,2024,4,4,0,0,100,227000,1727,118
64445,2024,1623,226,1397,86,14,151529,2260,67
64446,2024,1,1,0,0,100,142120,1341,106
64447,2024,1,1,0,0,100,140000,952,147
64448,2024,23,21,2,9,91,240368,2244,112
64449,2024,2,2,0,0,100,240000,1294,192
64450,2024,2,2,0,0,100,117055,1238,96
64451,2024,1,1,0,0,100,295000,1686,175
64452,2024,2,2,0,0,100,187443,1268,145
64453,2024,19,18,1,5,95,199439,1789,112
64454,2024,1,1,0,0,100,127000,1366,93
64455,2024,5,5,0,0,100,138840,1461,98
64457,2024,1,1,0,0,100,730200,1907,383
64458,2024,2,2,0,0,100,148500,1510,98
64459,2024,1,1,0,0,100,107000,955,112
64460,2024,5,5,0,0,100,181644,1619,121
64461,2024,14,14,0,0,100,161264,1845,91
64462,2024,3,3,0,0,100,146833,1515,98
64463,2024,7,7,0,0,100,162721,1447,121
64466,2024,2,2,0,0,100,254610,1837,148
64467,2024,7,4,3,43,57,220474,2037,113
64468,2024,2,2,0,0,100,169465,1268,134
64469,2024,2,2,0,0,100,444404,2118,198
64470,2024,4,4,0,0,100,300378,1876,164
64471,2024,4,4,0,0,100,196338,1962,101
64472,2024,7,7,0,0,100,281073,2165,132
64473,2024,1,1,0,0,100,306000,2068,148
64474,2024,3,3,0,0,100,112000,1491,89
64475,2024,1,1,0,0,100,120000,800,150
64476,2024,2,2,0,0,100,316880,4040,77
64477,2024,3,2,1,33,67,145667,1971,67
64478,2024,5,5,0,0,100,348700,2362,142
64479,2024,3,3,0,0,100,274967,2410,117
64480,2024,1,1,0,0,100,75000,417,180
64481,2024,1,1,0,0,100,565645,2126,266
64482,2024,2,2,0,0,100,141250,1762,79
64483,2024,292,45,247,85,15,447461,6325,69
64484,2024,2,2,0,0,100,292292,3882,72
64485,2024,10,8,2,20,80,304575,2528,124
64486,2024,5,5,0,0,100,170520,1911,84
64487,2024,2,2,0,0,100,70000,570,129
64488,2024,3,3,0,0,100,271133,2543,119
64489,2024,2,1,1,50,50,367500,4045,102
64490,2024,7,7,0,0,100,217183,2254,106
64492,2024,1,1,0,0,100,160000,1951,82
64493,2024,16,8,8,50,50,185325,2327,83
64494,2024,3,3,0,0,100,281600,2592,108
64495,2024,53,32,21,40,60,401310,4332,91
64496,2024,54,23,31,57,43,326897,3778,88
64498,2024,1,1,0,0,100,220000,1667,132
64499,2024,57,40,17,30,70,205653,2134,95
64500,2024,4,4,0,0,100,191339,1431,132
64501,2024,8,8,0,0,100,127336,1375,101
64502,2024,2,2,0,0,100,214570,1456,142
64503,2024,1,1,0,0,100,150000,1685,89
64504,2024,15,11,4,27,73,484570,3899,127
64505,2024,1,1,0,0,100,177000,1686,105
64506,2024,2,2,0,0,100,50000,651,78
64507,2024,3,3,0,0,100,348933,2363,149
64509,2024,3,3,0,0,100,120267,1419,91
64510,2024,11,10,1,9,91,279018,2193,124
64511,2024,29,28,1,3,97,293813,2524,117
64512,2024,2,2,0,0,100,189050,1906,100
64513,2024,14,13,1,7,93,190436,1742,118
64515,2024,1,1,0,0,100,270170,2127,127
64516,2024,3,3,0,0,100,250995,1795,140
64517,2024,5,5,0,0,100,142580,1743,84
64518,2024,5,5,0,0,100,276608,2462,111
64519,2024,42,38,4,10,90,299919,2565,114
64520,2024,5,5,0,0,100,479976,2866,169
64521,2024,7,7,0,0,100,288676,2224,135
64522,2024,3,3,0,0,100,191667,1478,128
64523,2024,9,9,0,0,100,206021,1804,113
64524,2024,7,7,0,0,100,182059,1740,106
64525,2024,2,2,0,0,100,213325,2198,96
64526,2024,15,13,2,13,87,244725,2480,102
64527,2024,2,2,0,0,100,415000,3840,99
64528,2024,1,0,1,100,0,77620,1725,45
64529,2024,4,4,0,0,100,178148,1771,104
64530,2024,2,2,0,0,100,180000,1386,140
64533,2024,6,4,2,33,67,118667,937,140
64534,2024,2,2,0,0,100,142625,1148,124
64535,2024,4,4,0,0,100,190312,2016,96
64536,2024,7,7,0,0,100,244864,2245,109
64537,2024,2,2,0,0,100,142500,2060,70
64538,2024,13,3,10,77,23,134373,2582,58
64540,2024,27,21,6,22,78,347831,3424,102
64542,2024,1,1,0,0,100,165855,1580,105
64543,2024,1,1,0,0,100,55000,1146,48
64544,2024,1,1,0,0,100,250000,1852,135
64545,2024,98,43,55,56,44,462499,5012,88
64546,2024,19,12,7,37,63,300223,3318,92
64547,2024,68,30,38,56,44,310696,3971,79
64548,2024,2,2,0,0,100,123500,1235,97
64549,2024,4,4,0,0,100,332594,2575,128
64550,2024,7,7,0,0,100,301904,2530,121
64551,2024,3,3,0,0,100,149333,1274,118
64555,2024,1,1,0,0,100,100000,909,110
64556,2024,6,5,1,17,83,136040,1463,103
64557,2024,3,3,0,0,100,248502,1771,143
64558,2024,29,24,5,17,83,536051,4564,118
64559,2024,10,10,0,0,100,176190,1710,104
65002,2024,10,8,2,20,80,180942,1717,108
65003,2024,7,0,7,100,0,65929,2292,29
65004,2024,2,2,0,0,100,175000,1198,139
65005,2024,1,1,0,0,100,280000,1867,150
65006,2024,3,2,1,33,67,148893,1859,78
65007,2024,13,13,0,0,100,198763,1694,120
65011,2024,3,3,0,0,100,180267,1442,133
65012,2024,2,2,0,0,100,117500,1383,97
65016,2024,1,1,0,0,100,140425,2464,57
65017,2024,32,5,27,84,16,98783,2568,40
65018,2024,5,5,0,0,100,137860,1775,100
65019,2024,5,5,0,0,100,252036,2034,121
65021,2024,1,1,0,0,100,325000,3066,106
65022,2024,2,2,0,0,100,172950,2228,84
65023,2024,1,1,0,0,100,170000,1382,123
65025,2024,55,22,33,60,40,171665,2354,76
65026,2024,1,1,0,0,100,115000,1085,106
65028,2024,2,2,0,0,100,171600,1550,110
65029,2024,5,5,0,0,100,262320,2423,134
65031,2024,32,12,20,62,38,140673,2428,61
65032,2024,12,10,2,17,83,202028,2321,89
65033,2024,1,1,0,0,100,205000,1464,140
65035,2024,2,2,0,0,100,181500,1815,99
65036,2024,2,1,1,50,50,205000,3711,51
65039,2024,1,1,0,0,100,362420,4420,82
65040,2024,9,0,9,100,0,32587,1050,32
65041,2024,5,5,0,0,100,105300,1091,84
65042,2024,8,8,0,0,100,159414,1474,104
65043,2024,1,1,0,0,100,320000,7273,44
65044,2024,3,3,0,0,100,202363,1820,113
65045,2024,3,3,0,0,100,166667,1411,112
65046,2024,2,2,0,0,100,335000,4136,92
65047,2024,84,64,20,24,76,159121,1718,93
65048,2024,4,4,0,0,100,183676,2059,90
65049,2024,5,5,0,0,100,144800,1378,105
65051,2024,2,2,0,0,100,211750,2044,98
65054,2024,1,1,0,0,100,247500,2526,98
65055,2024,3,2,1,33,67,182410,2380,80
65056,2024,3,2,1,33,67,252000,2246,109
65057,2024,1,1,0,0,100,236920,1974,120
65058,2024,4,4,0,0,100,128875,2140,66
65059,2024,52,18,34,65,35,123473,2179,62
65060,2024,4,4,0,0,100,235325,1850,121
65062,2024,31,30,1,3,97,194029,1865,106
65064,2024,2,2,0,0,100,119400,1805,70
65065,2024,1,1,0,0,100,140000,1167,120
65068,2024,1,1,0,0,100,169000,1207,140
65069,2024,11,11,0,0,100,176260,1676,111
65070,2024,3,3,0,0,100,197967,2450,81
65072,2024,15,15,0,0,100,159632,1811,90
65073,2024,1,1,0,0,100,139000,1580,88
65074,2024,1,1,0,0,100,70000,972,72
65075,2024,3,3,0,0,100,288000,2693,122
65077,2024,2,2,0,0,100,329250,2470,158
65078,2024,3,3,0,0,100,140167,1866,76
65079,2024,1,1,0,0,100,223000,1742,128
65080,2024,1,1,0,0,100,96500,1206,80
65082,2024,2,2,0,0,100,90000,966,94
65083,2024,8,8,0,0,100,215193,1551,151
65084,2024,1,1,0,0,100,272900,2052,133
65085,2024,1,1,0,0,100,82500,897,92
65087,2024,4,4,0,0,100,159520,1910,83
65089,2024,1,1,0,0,100,140000,2333,60
65091,2024,1,1,0,0,100,240000,1875,128
65092,2024,4,4,0,0,100,154132,1910,78
65093,2024,3,3,0,0,100,120667,1342,100
65095,2024,5,5,0,0,100,163818,1351,117
65096,2024,1,1,0,0,100,133125,1057,126
65097,2024,3,3,0,0,100,110333,909,127
65098,2024,6,6,0,0,100,210497,2870,76
65099,2024,5,4,1,20,80,211410,2618,85
65100,2024,37,33,4,11,89,173528,1698,102
65101,2024,1,1,0,0,100,171000,1305,131
65103,2024,2,2,0,0,100,59500,596,98
65104,2024,6,6,0,0,100,237783,1912,125
65105,2024,3,3,0,0,100,184333,1494,133
65106,2024,2,1,1,50,50,159400,1802,97
65108,2024,8,8,0,0,100,163292,1540,113
65111,2024,1,1,0,0,100,115000,1917,60
65112,2024,2,2,0,0,100,235000,1976,115
65113,2024,3,3,0,0,100,130000,1115,115
65114,2024,5,5,0,0,100,124151,999,123
65116,2024,2,2,0,0,100,164100,2018,84
65119,2024,4,4,0,0,100,130500,1299,113
65121,2024,4,4,0,0,100,155240,1819,84
65123,2024,44,34,10,23,77,169016,2582,73
65125,2024,1,1,0,0,100,170000,1560,109
65126,2024,2,2,0,0,100,85000,692,125
65127,2024,23,21,2,9,91,140288,1489,101
65129,2024,8,8,0,0,100,175750,1618,96
65130,2024,8,8,0,0,100,133468,1310,99
65131,2024,3,3,0,0,100,143387,1353,118
65135,2024,2,2,0,0,100,122500,1644,72
65136,2024,1,1,0,0,100,80000,1000,80
65137,2024,1,1,0,0,100,138400,1203,115
65138,2024,157,8,149,95,5,133483,3596,38
65141,2024,5,5,0,0,100,273060,3566,87
65142,2024,4,4,0,0,100,232391,1889,132
65143,2024,2,2,0,0,100,210000,2064,99
65146,2024,2,2,0,0,100,140245,1771,81
65147,2024,9,9,0,0,100,160733,1337,120
65148,2024,1,1,0,0,100,260210,1942,134
65149,2024,1,1,0,0,100,90000,1200,75
65150,2024,7,7,0,0,100,143545,1440,103
65151,2024,1,1,0,0,100,140000,1591,88
65153,2024,1,1,0,0,100,182000,1255,145
65154,2024,1,1,0,0,100,83000,769,108
65156,2024,1,1,0,0,100,199800,2081,96
65158,2024,1,1,0,0,100,119950,2352,51
65159,2024,1,1,0,0,100,116500,1475,79
65160,2024,1,1,0,0,100,238386,2384,100
65161,2024,1,1,0,0,100,32500,500,65
65165,2024,2,2,0,0,100,75000,1434,55
65166,2024,2,2,0,0,100,195775,2265,85
65168,2024,19,4,15,79,21,151649,3128,54
65169,2024,2,2,0,0,100,143050,2142,105
65170,2024,1,1,0,0,100,305900,1530,200
65173,2024,3,3,0,0,100,151519,2881,61
65180,2024,2,1,1,50,50,137565,2068,65
65181,2024,1,1,0,0,100,229750,1795,128
65182,2024,1,1,0,0,100,133000,1773,75
65183,2024,4,3,1,25,75,189279,1844,103
65184,2024,2,2,0,0,100,219535,1796,122
65185,2024,7,7,0,0,100,221858,1814,133
65187,2024,1,1,0,0,100,230000,1620,142
65189,2024,3,3,0,0,100,268688,1996,131
65191,2024,4,4,0,0,100,148574,1978,85
65192,2024,6,5,1,17,83,164036,3095,56
65194,2024,1,1,0,0,100,45000,900,50
65195,2024,2,1,1,50,50,190000,3046,60
65196,2024,1,1,0,0,100,232400,2094,111
65197,2024,1,1,0,0,100,160000,2000,80
65198,2024,13,13,0,0,100,181336,2103,85
65199,2024,25,1,24,96,4,120692,2697,42
65200,2024,3,3,0,0,100,208993,3036,89
65202,2024,1,0,1,100,0,230000,2091,110
65206,2024,4,4,0,0,100,213494,1575,139
65208,2024,2,2,0,0,100,350755,4300,85
65209,2024,2,1,1,50,50,110000,1666,66
65211,2024,1,1,0,0,100,596100,4111,145
65212,2024,4,3,1,25,75,80250,1533,58
65216,2024,3,3,0,0,100,152667,2837,67
65218,2024,9,8,1,11,89,159628,1596,105
65220,2024,1,1,0,0,100,175000,1733,101
65223,2024,10,10,0,0,100,261804,2152,128
65224,2024,1,1,0,0,100,334500,1672,200
65225,2024,1,1,0,0,100,118000,1326,89
65226,2024,15,15,0,0,100,232432,2042,120
65229,2024,1,1,0,0,100,224000,2358,95
65230,2024,2,2,0,0,100,87100,1363,58
65231,2024,2,2,0,0,100,119250,745,154
65234,2024,1,1,0,0,100,386710,3223,120
65235,2024,33,33,0,0,100,208846,2214,97
65236,2024,1,1,0,0,100,154500,1931,80
65237,2024,2,2,0,0,100,231625,1670,132
65238,2024,3,3,0,0,100,291010,2266,128
65239,2024,1,1,0,0,100,72000,1125,64
65240,2024,9,9,0,0,100,145897,1300,114
65241,2024,2,2,0,0,100,101109,1269,68
65243,2024,3,3,0,0,100,128660,884,173
65244,2024,2,2,0,0,100,198552,1720,119
65245,2024,1,1,0,0,100,100000,625,160
65247,2024,2,2,0,0,100,157558,3426,61
65248,2024,5,5,0,0,100,148210,1472,103
65250,2024,2,2,0,0,100,180000,1688,105
65251,2024,22,20,2,9,91,227650,2085,109
65252,2024,6,6,0,0,100,209288,2011,103
65254,2024,3,3,0,0,100,113044,1254,97
65255,2024,1,1,0,0,100,228220,2926,78
65256,2024,1,1,0,0,100,99000,1904,52
65257,2024,2,2,0,0,100,267375,1736,162
65258,2024,70,34,36,51,49,97469,1250,79
65259,2024,1,1,0,0,100,129000,2529,51
65260,2024,1,1,0,0,100,170000,1076,158
65262,2024,7,6,1,14,86,160803,1140,147
65264,2024,3,3,0,0,100,112333,1108,107
65265,2024,3,3,0,0,100,199833,1694,122
65267,2024,6,5,1,17,83,238167,2818,86
65268,2024,2,2,0,0,100,152500,1452,108
65269,2024,1,1,0,0,100,25000,417,60
65271,2024,3,3,0,0,100,125567,1145,115
65272,2024,2,2,0,0,100,179500,1767,89
65273,2024,1,1,0,0,100,113000,890,127
65274,2024,2,2,0,0,100,129500,1198,117
65277,2024,1,1,0,0,100,95000,1357,70
65279,2024,2,2,0,0,100,85222,1340,73
65280,2024,2,2,0,0,100,156250,1696,98
65282,2024,12,2,10,83,17,282632,5461,50
65283,2024,2,1,1,50,50,368590,3724,89
65284,2024,7,7,0,0,100,239723,2149,119
65286,2024,281,93,188,67,33,108640,1505,75
65287,2024,6,6,0,0,100,139242,1567,90
65288,2024,1,1,0,0,100,150100,956,157
65290,2024,1,1,0,0,100,178000,1060,168
65292,2024,2,2,0,0,100,209525,1943,104
65294,2024,3,3,0,0,100,187890,1910,100
65295,2024,33,5,28,85,15,117250,2892,43
65296,2024,2,2,0,0,100,150045,770,210
65298,2024,3,3,0,0,100,189333,2276,85
65299,2024,3,3,0,0,100,190608,1912,103
65301,2024,1,1,0,0,100,65000,739,88
65303,2024,2,2,0,0,100,210250,2014,111
65304,2024,35,35,0,0,100,146098,1362,109
65305,2024,5,4,1,20,80,67450,1495,55
65306,2024,3,3,0,0,100,130450,1285,98
65307,2024,3,3,0,0,100,132933,1277,107
65309,2024,1,1,0,0,100,397200,2630,151
65311,2024,1,1,0,0,100,385000,1667,231
65313,2024,5,5,0,0,100,244736,1918,134
65314,2024,4,4,0,0,100,116052,1056,110
65315,2024,5,5,0,0,100,132606,1379,102
65316,2024,1,1,0,0,100,180000,2000,90
65318,2024,1,1,0,0,100,85000,649,131
65319,2024,2,2,0,0,100,162930,836,192
65320,2024,6,6,0,0,100,155026,2726,86
65321,2024,1,1,0,0,100,235000,2527,93
65322,2024,3,3,0,0,100,111667,1072,113
65324,2024,2,2,0,0,100,206900,1552,134
65327,2024,1,1,0,0,100,235000,1808,130
65329,2024,3,3,0,0,100,95000,978,121
65330,2024,1,1,0,0,100,350000,1477,237
65331,2024,31,30,1,3,97,211123,1894,112
65332,2024,1,1,0,0,100,100000,1351,74
65334,2024,1,1,0,0,100,110000,1222,90
65335,2024,6,6,0,0,100,183249,1818,114
65337,2024,1,1,0,0,100,174000,1977,88
65338,2024,1,1,0,0,100,65000,1226,53
65340,2024,17,17,0,0,100,190498,1741,114
65341,2024,1,1,0,0,100,263300,1350,195
65343,2024,2,2,0,0,100,332058,2872,114
65344,2024,19,18,1,5,95,172842,1620,114
65345,2024,2,2,0,0,100,211870,2349,90
65346,2024,1,1,0,0,100,233520,1899,123
65350,2024,13,13,0,0,100,190644,1761,104
65351,2024,1,1,0,0,100,93530,3118,30
65352,2024,1,1,0,0,100,310000,3647,85
65353,2024,2,2,0,0,100,173910,2386,73
65354,2024,1,1,0,0,100,160000,2286,70
65355,2024,1,1,0,0,100,148500,1031,144
65360,2024,1,1,0,0,100,48000,533,90
65361,2024,1,1,0,0,100,105000,1105,95
65362,2024,17,11,6,35,65,157752,1990,80
65363,2024,3,3,0,0,100,132561,965,140
65366,2024,6,6,0,0,100,266767,2007,142
65367,2024,1,1,0,0,100,180000,1000,180
65368,2024,2,2,0,0,100,213000,1768,121
65369,2024,7,7,0,0,100,201728,1731,122
65370,2024,13,10,3,23,77,171113,1979,99
65371,2024,3,3,0,0,100,220357,1556,176
65372,2024,3,3,0,0,100,213000,1330,160
65374,2024,1,1,0,0,100,90000,682,132
65375,2024,18,17,1,6,94,109608,1334,89
65376,2024,1,1,0,0,100,169420,941,180
65378,2024,1,1,0,0,100,97000,1386,70
65380,2024,3,3,0,0,100,203717,1841,111
65383,2024,1,1,0,0,100,299195,2152,139
65384,2024,4,3,1,25,75,164694,2333,89
65386,2024,2,2,0,0,100,129000,1648,80
65387,2024,3,3,0,0,100,174377,1586,127
65388,2024,144,12,132,92,8,129953,3361,39
65389,2024,7,7,0,0,100,136311,1299,110
65390,2024,7,7,0,0,100,181850,1589,118
65392,2024,2,2,0,0,100,277000,2142,129
65393,2024,1,1,0,0,100,371500,3505,106
65394,2024,3,2,1,33,67,172360,2176,91
65395,2024,19,16,3,16,84,122564,1227,101
65396,2024,2,0,2,100,0,107905,2732,38
65397,2024,1,1,0,0,100,220000,948,232
65398,2024,2,2,0,0,100,132550,1477,86
65399,2024,2,2,0,0,100,289060,1718,168
65400,2024,5,5,0,0,100,195134,1610,124
65401,2024,3,3,0,0,100,263667,2483,104
65404,2024,5,5,0,0,100,161855,1086,139
65405,2024,1,1,0,0,100,267400,2674,100
65407,2024,2,2,0,0,100,75000,772,88
65408,2024,9,6,3,33,67,118147,1340,102
65409,2024,3,3,0,0,100,105587,914,109
65410,2024,5,5,0,0,100,176548,1398,127
65412,2024,2,2,0,0,100,289242,2048,140
65413,2024,6,5,1,17,83,225772,3004,82
65416,2024,1,1,0,0,100,97800,1075,91
65417,2024,56,50,6,11,89,160071,1883,89
65418,2024,2,2,0,0,100,184347,1668,112
65420,2024,1,1,0,0,100,214000,2675,80
65421,2024,2,2,0,0,100,119000,996,130
65422,2024,3,3,0,0,100,219000,1424,159
65424,2024,4,3,1,25,75,158450,3837,44
65425,2024,2,2,0,0,100,279900,1806,148
65427,2024,1,1,0,0,100,195000,3000,65
65429,2024,7,7,0,0,100,192557,1570,138
65431,2024,5,5,0,0,100,93770,1038,105
65432,2024,2,2,0,0,100,137500,1266,115
65433,2024,37,32,5,14,86,183177,1880,101
65435,2024,2,2,0,0,100,133340,1718,82
65436,2024,4,4,0,0,100,179065,1518,122
65439,2024,1,1,0,0,100,75000,872,86
65440,2024,733,191,542,74,26,111243,1550,73
65441,2024,3,3,0,0,100,80333,1036,85
65442,2024,3,3,0,0,100,126667,1141,106
65444,2024,1,1,0,0,100,140000,1321,106
65445,2024,2,2,0,0,100,137000,1954,82
65446,2024,10,10,0,0,100,164640,1520,116
65447,2024,16,15,1,6,94,124250,1470,89
65448,2024,2,2,0,0,100,188500,1237,150
65450,2024,1,1,0,0,100,210000,4200,50
65451,2024,3,3,0,0,100,166580,1241,139
65452,2024,15,15,0,0,100,102059,990,105
65453,2024,3,3,0,0,100,123267,1420,84
65455,2024,6,6,0,0,100,141618,1156,126
65456,2024,2,2,0,0,100,166740,1616,104
65457,2024,1,1,0,0,100,250500,1869,134
65459,2024,2,2,0,0,100,120000,1090,100
65460,2024,49,34,15,31,69,112437,1402,84
65462,2024,7,7,0,0,100,122018,1157,128
65463,2024,3,3,0,0,100,140454,2823,54
65464,2024,3,3,0,0,100,95385,1399,60
65465,2024,21,1,20,95,5,147712,3630,43
65467,2024,4,4,0,0,100,368225,3498,100
65468,2024,1,1,0,0,100,126000,1260,100
65469,2024,1,0,1,100,0,105000,2917,36
65470,2024,1,1,0,0,100,219800,2498,88
65471,2024,12,4,8,67,33,207873,3786,56
65472,2024,1,1,0,0,100,137000,1054,130
65473,2024,5,5,0,0,100,310454,2280,139
65474,2024,1,1,0,0,100,18100,393,46
65475,2024,1,1,0,0,100,187320,1819,103
65477,2024,1,1,0,0,100,228132,2453,93
65478,2024,1,1,0,0,100,172000,2150,80
65479,2024,4,4,0,0,100,202060,1838,120
65481,2024,26,1,25,96,4,84071,2281,40
65482,2024,4,4,0,0,100,89000,1215,81
66002,2024,41,34,7,17,83,266538,2695,97
66003,2024,233,23,210,90,10,72328,1471,48
66004,2024,86,19,67,78,22,156326,3893,39
66005,2024,6,5,1,17,83,203315,3143,66
66006,2024,3,3,0,0,100,94693,1402,65
66007,2024,1,1,0,0,100,92000,1917,48
66008,2024,414,134,280,68,32,179626,3606,52
66009,2024,43,32,11,26,74,167764,1846,89
66010,2024,1,1,0,0,100,25000,714,35
66011,2024,56,52,4,7,93,214536,2402,91
66012,2024,25,21,4,16,84,201325,2240,89
66014,2024,37,36,1,3,97,153784,1790,87
66015,2024,21,20,1,5,95,235212,2469,95
66016,2024,121,55,66,55,45,253550,3911,70
66017,2024,490,114,376,77,23,128517,3557,37
66018,2024,3,3,0,0,100,83667,1438,60
66020,2024,93,28,65,70,30,168758,3789,44
66021,2024,73,63,10,14,86,215787,2474,89
66022,2024,1,1,0,0,100,286000,2860,100
66023,2024,15,14,1,7,93,139011,1628,83
66024,2024,93,56,37,40,60,204437,2471,81
66025,2024,20,8,12,60,40,199619,3108,71
66026,2024,17,17,0,0,100,268566,2789,96
66027,2024,8,7,1,12,88,325356,3640,90
66028,2024,95,80,15,16,84,291731,2609,109
66029,2024,2,2,0,0,100,392900,3908,107
66030,2024,3,3,0,0,100,362333,2900,122
66032,2024,3,3,0,0,100,328333,3159,112
66033,2024,7,6,1,14,86,503370,3852,138
66034,2024,1,1,0,0,100,115000,1554,74
66035,2024,1,1,0,0,100,75000,962,78
66036,2024,1,1,0,0,100,162200,1386,117
66037,2024,462,130,332,72,28,184931,3695,52
66038,2024,75,62,13,17,83,240192,2795,90
66039,2024,6,5,1,17,83,69217,825,87
66041,2024,9,9,0,0,100,174698,2066,82
66042,2024,1,1,0,0,100,45000,600,75
66043,2024,2,2,0,0,100,112050,2016,55
66044,2024,3,3,0,0,100,243957,2425,127
66045,2024,11,11,0,0,100,240068,2102,115
66046,2024,7,7,0,0,100,93074,1191,79
66047,2024,1,1,0,0,100,140000,1273,110
66048,2024,30,7,23,77,23,160962,3152,53
66049,2024,111,69,42,38,62,210005,2543,84
66050,2024,62,53,9,15,85,211234,2418,86
66051,2024,5,5,0,0,100,167000,2381,66
66052,2024,5,5,0,0,100,245806,1986,131
66053,2024,96,22,74,77,23,271745,5221,55
66054,2024,3,3,0,0,100,66520,1216,55
66055,2024,15,15,0,0,100,203218,2317,84
66056,2024,12,11,1,8,92,189892,2036,90
66057,2024,8,8,0,0,100,154500,1675,92
66058,2024,25,25,0,0,100,191302,1972,95
66059,2024,38,33,5,13,87,253746,2597,96
66060,2024,5,5,0,0,100,166279,1753,91
66061,2024,2,2,0,0,100,82000,1216,68
66062,2024,5,2,3,60,40,148600,3230,47
66063,2024,3,3,0,0,100,315910,2950,110
66064,2024,18,6,12,67,33,184849,2889,58
66065,2024,118,94,24,20,80,188129,2315,84
66066,2024,13,5,8,62,38,179735,3107,61
66067,2024,17,9,8,47,53,184201,3180,59
66068,2024,5,5,0,0,100,192205,2285,87
66069,2024,36,33,3,8,92,218535,2286,98
66070,2024,1,1,0,0,100,700000,16279,43
66071,2024,43,42,1,2,98,139055,1587,87
66072,2024,23,14,9,39,61,243371,3155,81
66073,2024,5,5,0,0,100,65956,958,73
66074,2024,3,2,1,33,67,150833,2113,70
66075,2024,18,10,8,44,56,122730,3272,39
66076,2024,2,2,0,0,100,59250,956,62
66078,2024,6,6,0,0,100,195300,2219,98
66079,2024,7,7,0,0,100,125829,1542,90
66080,2024,4,4,0,0,100,77425,1091,73
66082,2024,23,17,6,26,74,195378,2918,70
66084,2024,20,20,0,0,100,229759,2377,97
66085,2024,3,3,0,0,100,114067,1438,69
66088,2024,71,56,15,21,79,128094,1910,67
66089,2024,5,5,0,0,100,237490,2452,95
66090,2024,1,1,0,0,100,45000,804,56
66092,2024,4,4,0,0,100,90600,854,102
66093,2024,35,33,2,6,94,294386,3108,105
66094,2024,38,37,1,3,97,281621,2861,100
66095,2024,10,8,2,20,80,217897,2866,82
66096,2024,14,13,1,7,93,212681,1858,113
66097,2024,4,4,0,0,100,116750,1463,84
66098,2024,9,6,3,33,67,210611,2911,77
66099,2024,1,1,0,0,100,165000,2171,76
66100,2024,1,1,0,0,100,130000,2826,46
66101,2024,21,18,3,14,86,253874,2532,99
66102,2024,1,1,0,0,100,114010,2850,40
66103,2024,5,5,0,0,100,91103,1201,85
66104,2024,12,12,0,0,100,230719,2528,103
66105,2024,6,6,0,0,100,216700,3020,85
66106,2024,43,42,1,2,98,207313,2219,91
66107,2024,23,23,0,0,100,72137,891,81
66108,2024,58,54,4,7,93,176067,1919,95
66109,2024,6,6,0,0,100,154552,1727,90
66111,2024,6,6,0,0,100,163392,1614,102
66112,2024,2,2,0,0,100,262000,1506,168
66114,2024,18,17,1,6,94,290026,2676,116
66115,2024,17,17,0,0,100,345176,3026,113
66116,2024,3,3,0,0,100,137300,1369,95
66117,2024,8,1,7,88,12,79500,1467,70
66118,2024,6,6,0,0,100,125887,1532,76
66119,2024,10,10,0,0,100,83800,1565,56
66120,2024,5,2,3,60,40,264600,3839,69
66121,2024,19,18,1,5,95,175084,1977,87
66122,2024,1,1,0,0,100,90267,1128,80
66123,2024,1,1,0,0,100,66400,3689,18
66124,2024,152,21,131,86,14,164410,3104,52
66125,2024,5,5,0,0,100,120473,1752,74
66126,2024,7,7,0,0,100,345134,2907,115
66127,2024,19,19,0,0,100,212124,2008,104
66128,2024,1,1,0,0,100,75000,833,90
66129,2024,27,27,0,0,100,260243,2496,106
66130,2024,40,14,26,65,35,221775,3288,71
66132,2024,16,6,10,62,38,303703,4550,68
66133,2024,41,41,0,0,100,229275,2561,86
66134,2024,18,18,0,0,100,210441,2187,96
66136,2024,1926,467,1459,76,24,131077,1782,72
66137,2024,7,6,1,14,86,144820,1386,103
66138,2024,13,10,3,23,77,161699,2167,72
66139,2024,1,1,0,0,100,81000,704,115
66140,2024,36,36,0,0,100,164713,2141,80
66141,2024,106,99,7,7,93,235968,2502,94
66143,2024,2,2,0,0,100,149523,1402,89
66144,2024,62,53,9,15,85,226605,2476,88
66145,2024,26,26,0,0,100,271053,2649,99
66146,2024,4,3,1,25,75,143750,1524,81
66147,2024,1,0,1,100,0,66000,2357,28
66148,2024,74,20,54,73,27,200299,3338,61
66149,2024,82,56,26,32,68,142663,1785,80
66150,2024,28,7,21,75,25,84655,1647,67
66152,2024,3,3,0,0,100,85200,1042,77
66153,2024,1,1,0,0,100,15000,600,25
66154,2024,27,23,4,15,85,136765,3493,40
66155,2024,2,2,0,0,100,83770,1428,62
66156,2024,4,4,0,0,100,71768,599,112
66157,2024,2,2,0,0,100,109475,2163,88
66158,2024,4,4,0,0,100,124442,1798,80
66159,2024,3,2,1,33,67,155933,2185,74
66160,2024,13,12,1,8,92,408428,3636,117
66161,2024,23,23,0,0,100,162126,1956,84
66162,2024,10,9,1,10,90,186441,2181,88
66164,2024,85,74,11,13,87,168808,1917,88
66165,2024,12,12,0,0,100,188221,2242,87
66166,2024,4,2,2,50,50,108625,1337,74
66167,2024,27,16,11,41,59,255309,3232,83
66168,2024,50,46,4,8,92,233272,2664,90
66169,2024,3,3,0,0,100,241162,2275,104
66170,2024,1,1,0,0,100,593900,3433,173
66171,2024,533,226,307,58,42,180543,3978,49
66172,2024,132,91,41,31,69,195321,2409,82
66173,2024,12,12,0,0,100,212533,2335,91
66174,2024,38,38,0,0,100,215456,2232,98
66175,2024,48,45,3,6,94,246236,2891,86
66176,2024,36,36,0,0,100,212620,2356,86
66177,2024,15,15,0,0,100,246287,2298,104
66178,2024,21,18,3,14,86,204413,2196,91
66179,2024,17,11,6,35,65,81576,1191,74
66180,2024,167,134,33,20,80,193981,2326,82
66181,2024,18,9,9,50,50,212000,3503,62
66182,2024,153,116,37,24,76,201113,3569,61
66183,2024,1,1,0,0,100,75000,1250,60
66185,2024,5,5,0,0,100,196740,1960,103
66186,2024,40,36,4,10,90,238122,2567,92
66187,2024,36,32,4,11,89,89084,1125,78
66188,2024,15,7,8,53,47,157479,2991,50
66189,2024,62,52,10,16,84,281887,2664,103
66190,2024,46,46,0,0,100,144162,2030,73
66191,2024,4,4,0,0,100,181425,2641,76
66192,2024,2,2,0,0,100,203280,2042,94
66193,2024,7,6,1,14,86,85914,1144,76
66194,2024,10,8,2,20,80,125488,1637,80
66195,2024,92,80,12,13,87,222282,2512,88
66196,2024,60,57,3,5,95,294216,3313,90
66197,2024,1,1,0,0,100,168000,1400,120
66198,2024,6,6,0,0,100,86052,1511,71
66201,2024,2,2,0,0,100,144000,1712,80
66202,2024,8,3,5,62,38,205825,3534,59
66203,2024,2,2,0,0,100,83530,882,98
66204,2024,3,3,0,0,100,103500,1802,73
66205,2024,14,14,0,0,100,192403,2042,91
66206,2024,5,4,1,20,80,129260,1303,87
66207,2024,8,7,1,12,88,300040,2920,98
66208,2024,20,13,7,35,65,217786,2727,77
66210,2024,92,72,20,22,78,203631,2409,86
66212,2024,87,81,6,7,93,202435,3361,64
66213,2024,70,61,9,13,87,224192,2567,92
66214,2024,11,10,1,9,91,320474,2849,107
66215,2024,2,2,0,0,100,97750,983,100
66217,2024,32,31,1,3,97,183689,2270,82
66218,2024,8,6,2,25,75,195825,2716,74
66219,2024,2,2,0,0,100,69510,1192,58
66220,2024,1,0,1,100,0,224100,2134,105
66221,2024,2,2,0,0,100,63042,822,80
66222,2024,74,32,42,57,43,118785,1698,66
66223,2024,2,2,0,0,100,102500,1120,98
66224,2024,34,33,1,3,97,216761,2247,91
66225,2024,28,27,1,4,96,252832,2968,86
66226,2024,10,9,1,10,90,265086,4055,87
66227,2024,47,44,3,6,94,328086,2934,109
66228,2024,16,16,0,0,100,172653,1952,87
66230,2024,30,29,1,3,97,146196,1767,87
66231,2024,11,11,0,0,100,153402,1526,90
66232,2024,1,1,0,0,100,69500,695,100
66234,2024,3,3,0,0,100,145100,1476,103
68065,2024,1,1,0,0,100,20000,500,40
69001,2024,6,6,0,0,100,204000,1542,155
69002,2024,5,5,0,0,100,146200,1521,97
69003,2024,22,14,8,36,64,416866,4378,93
69004,2024,5,5,0,0,100,413000,3549,118
69005,2024,5,4,1,20,80,337927,3236,109
69006,2024,54,45,9,17,83,145164,1687,92
69007,2024,8,6,2,25,75,292362,2725,105
69008,2024,3,3,0,0,100,208000,1871,104
69009,2024,66,43,23,35,65,280551,3248,87
69010,2024,60,25,35,58,42,242682,2880,83
69012,2024,4,4,0,0,100,184375,1601,113
69013,2024,45,31,14,31,69,315444,3176,99
69014,2024,10,10,0,0,100,242166,2179,116
69016,2024,1,1,0,0,100,189221,3320,57
69017,2024,5,5,0,0,100,491380,3759,119
69018,2024,23,20,3,13,87,163507,1700,100
69019,2024,102,52,50,49,51,215800,2606,83
69020,2024,4,4,0,0,100,355062,3884,92
69021,2024,30,24,6,20,80,220118,2672,87
69022,2024,6,6,0,0,100,313633,3424,90
69023,2024,8,5,3,38,62,316042,2519,126
69024,2024,32,28,4,12,88,389375,3223,118
69026,2024,4,4,0,0,100,293125,2419,165
69027,2024,95,41,54,57,43,330120,3956,86
69028,2024,63,41,22,35,65,416884,4294,98
69029,2024,399,66,333,83,17,226973,3310,70
69030,2024,7,5,2,29,71,123486,2075,66
69031,2024,7,6,1,14,86,159114,1969,85
69032,2024,11,8,3,27,73,244273,2848,88
69033,2024,19,17,2,11,89,485667,4433,111
69034,2024,534,71,463,87,13,324486,4194,76
69035,2024,4,4,0,0,100,241500,2142,115
69036,2024,7,7,0,0,100,211200,2272,92
69037,2024,10,10,0,0,100,243935,2342,104
69038,2024,8,8,0,0,100,183662,1840,97
69039,2024,8,7,1,12,88,211206,2134,102
69040,2024,83,20,63,76,24,355362,4027,86
69042,2024,4,4,0,0,100,220000,2140,104
69043,2024,88,55,33,38,62,419901,4254,102
69044,2024,55,20,35,64,36,566653,5092,103
69045,2024,14,11,3,21,79,225325,2492,97
69046,2024,36,29,7,19,81,457971,4226,113
69047,2024,4,4,0,0,100,493892,4014,119
69049,2024,37,21,16,43,57,408940,3813,108
69050,2024,22,14,8,36,64,289289,3429,85
69051,2024,5,4,1,20,80,331120,3625,88
69052,2024,28,23,5,18,82,370943,4046,95
69053,2024,10,7,3,30,70,179902,1994,86
69054,2024,4,4,0,0,100,187032,2163,89
69055,2024,17,14,3,18,82,459293,3627,120
69056,2024,25,18,7,28,72,338620,3256,110
69057,2024,4,4,0,0,100,345842,3155,113
69058,2024,6,6,0,0,100,230767,1996,124
69059,2024,18,17,1,6,94,400710,3991,100
69060,2024,9,9,0,0,100,164526,1638,100
69061,2024,3,3,0,0,100,153333,1355,140
69062,2024,4,4,0,0,100,256478,2576,96
69063,2024,43,26,17,40,60,752956,5815,125
69064,2024,43,24,19,44,56,188215,2111,98
69065,2024,13,13,0,0,100,265565,2723,97
69066,2024,53,49,4,8,92,143506,1510,95
69067,2024,14,13,1,7,93,248950,2586,94
69068,2024,18,10,8,44,56,372985,3879,91
69069,2024,111,45,66,59,41,366173,4207,85
69070,2024,17,17,0,0,100,173665,1658,105
69071,2024,15,9,6,40,60,461352,4476,102
69072,2024,79,55,24,30,70,517593,4491,117
69074,2024,9,8,1,11,89,229108,2786,85
69075,2024,1,1,0,0,100,290000,2589,112
69076,2024,14,12,2,14,86,571933,4585,124
69077,2024,7,7,0,0,100,311776,2776,114
69078,2024,9,7,2,22,78,257783,2673,102
69080,2024,16,14,2,12,88,262184,2997,89
69081,2024,151,30,121,80,20,420242,4448,91
69082,2024,2,2,0,0,100,149200,1647,88
69083,2024,7,5,2,29,71,362221,3444,105
69084,2024,14,10,4,29,71,296696,2967,110
69085,2024,12,11,1,8,92,515146,4887,104
69086,2024,31,21,10,32,68,333858,3596,97
69087,2024,25,21,4,16,84,432146,3723,123
69088,2024,88,13,75,85,15,277520,3645,76
69089,2024,173,46,127,73,27,315042,3926,80
69090,2024,9,9,0,0,100,349578,3305,108
69091,2024,138,47,91,66,34,167460,2128,79
69092,2024,76,31,45,59,41,223248,2521,85
69093,2024,15,14,1,7,93,138230,1588,86
69094,2024,57,40,17,30,70,409391,4324,98
69095,2024,5,4,1,20,80,285362,2096,118
69096,2024,85,35,50,59,41,195065,2500,81
69097,2024,3,3,0,0,100,196283,2368,85
69098,2024,5,5,0,0,100,231850,2113,119
69099,2024,8,8,0,0,100,210125,1693,129
69100,2024,66,29,37,56,44,330163,3777,85
69102,2024,5,5,0,0,100,234061,2334,101
69103,2024,12,12,0,0,100,270176,2661,103
69104,2024,4,4,0,0,100,174025,1613,116
69105,2024,9,9,0,0,100,335537,2888,124
69106,2024,7,5,2,29,71,451501,3564,129
69107,2024,11,8,3,27,73,164368,1635,107
69108,2024,16,14,2,12,88,275661,2240,118
69109,2024,2,2,0,0,100,244200,2400,102
69110,2024,15,15,0,0,100,281393,2410,123
69111,2024,5,3,2,40,60,383470,3422,113
69112,2024,57,40,17,30,70,441095,4343,104
69113,2024,8,8,0,0,100,215065,1813,112
69115,2024,48,28,20,42,58,254446,3011,82
69116,2024,33,20,13,39,61,606853,5096,116
69117,2024,22,19,3,14,86,439097,3737,118
69118,2024,24,13,11,46,54,230016,2741,86
69119,2024,9,8,1,11,89,219067,2483,89
69120,2024,4,4,0,0,100,124800,856,124
69121,2024,33,15,18,55,45,286454,3451,85
69122,2024,16,13,3,19,81,337730,3514,97
69123,2024,5894,141,5753,98,2,287448,4545,64
69124,2024,4,4,0,0,100,199662,1605,128
69125,2024,15,12,3,20,80,368018,3520,108
69126,2024,8,7,1,12,88,429814,3629,117
69127,2024,25,14,11,44,56,418545,4356,96
69130,2024,6,6,0,0,100,129500,1562,86
69131,2024,20,14,6,30,70,383938,3971,97
69132,2024,4,4,0,0,100,143400,1349,115
69133,2024,37,25,12,32,68,380250,3796,102
69134,2024,3,3,0,0,100,90000,1256,77
69135,2024,17,15,2,12,88,132806,1711,79
69136,2024,29,25,4,14,86,375963,3697,102
69137,2024,5,4,1,20,80,245018,3417,74
69138,2024,2,2,0,0,100,321430,3264,99
69139,2024,8,7,1,12,88,237930,2344,100
69140,2024,15,11,4,27,73,462966,3284,138
69141,2024,52,31,21,40,60,327138,3893,85
69142,2024,75,6,69,92,8,227753,3169,72
69143,2024,74,21,53,72,28,265361,3405,78
69145,2024,7,7,0,0,100,348191,3421,112
69148,2024,16,8,8,50,50,329722,3762,87
69149,2024,330,50,280,85,15,238259,3584,67
69151,2024,16,12,4,25,75,270667,2619,109
69153,2024,9,9,0,0,100,613664,4356,140
69154,2024,28,19,9,32,68,382206,4042,96
69155,2024,11,11,0,0,100,251045,2369,114
69156,2024,20,18,2,10,90,524802,3841,139
69157,2024,50,34,16,32,68,239141,2823,87
69159,2024,7,7,0,0,100,340113,2884,122
69160,2024,18,17,1,6,94,167824,1436,121
69161,2024,2,2,0,0,100,130000,1528,88
69162,2024,10,9,1,10,90,200869,2107,96
69163,2024,32,22,10,31,69,345735,3313,104
69164,2024,5,4,1,20,80,74120,1430,68
69165,2024,8,8,0,0,100,315130,2669,134
69166,2024,2,2,0,0,100,110000,1024,106
69167,2024,3,3,0,0,100,375267,2721,139
69168,2024,10,9,1,10,90,584563,4306,146
69169,2024,4,4,0,0,100,247900,1946,122
69170,2024,9,5,4,44,56,230244,2633,92
69171,2024,29,6,23,79,21,178996,2505,72
69172,2024,8,8,0,0,100,260279,2439,113
69173,2024,9,4,5,56,44,207854,2593,83
69174,2024,3,3,0,0,100,242073,2203,112
69175,2024,10,9,1,10,90,289583,2649,109
69176,2024,36,26,10,28,72,362289,3380,106
69177,2024,10,9,1,10,90,347880,3673,94
69178,2024,4,4,0,0,100,207000,1915,112
69179,2024,28,26,2,7,93,326338,2979,113
69180,2024,2,2,0,0,100,268250,2238,122
69181,2024,1,1,0,0,100,260000,1955,133
69182,2024,4,4,0,0,100,125250,1344,93
69183,2024,2,2,0,0,100,82255,1362,61
69184,2024,7,7,0,0,100,304143,2600,120
69186,2024,2,2,0,0,100,157500,1503,104
69187,2024,9,9,0,0,100,257518,2516,106
69188,2024,6,6,0,0,100,189500,1952,97
69189,2024,33,6,27,82,18,234795,2763,84
69190,2024,13,8,5,38,62,285683,3672,78
69191,2024,53,41,12,23,77,909340,6409,139
69192,2024,2,2,0,0,100,112500,1053,100
69193,2024,6,6,0,0,100,446930,3886,115
69194,2024,52,33,19,37,63,834227,6082,135
69196,2024,5,3,2,40,60,104935,1037,126
69197,2024,20,19,1,5,95,267635,2391,111
69199,2024,91,19,72,79,21,179522,2590,68
69200,2024,14,11,3,21,79,236556,2613,95
69201,2024,18,11,7,39,61,163977,2594,79
69202,2024,216,45,171,79,21,377169,3940,91
69203,2024,8,8,0,0,100,200550,1965,102
69204,2024,183,71,112,61,39,359447,4016,87
69205,2024,39,31,8,21,79,386152,4034,94
69206,2024,39,29,10,26,74,278114,2658,108
69207,2024,27,14,13,48,52,333566,3649,91
69208,2024,19,19,0,0,100,412506,3584,122
69209,2024,4,3,1,25,75,121875,1361,90
69212,2024,2,2,0,0,100,646042,5078,128
69214,2024,11,11,0,0,100,175495,1854,96
69215,2024,2,2,0,0,100,302500,3185,95
69216,2024,4,4,0,0,100,204782,1583,125
69217,2024,5,5,0,0,100,134028,1309,123
69218,2024,12,9,3,25,75,293659,2551,112
69219,2024,16,13,3,19,81,324747,2940,122
69220,2024,13,11,2,15,85,206590,2160,92
69225,2024,4,4,0,0,100,195016,2137,93
69227,2024,20,16,4,20,80,263385,2912,90
69228,2024,30,28,2,7,93,289477,3332,95
69229,2024,7,7,0,0,100,181823,2014,87
69230,2024,4,4,0,0,100,271725,4037,91
69231,2024,13,6,7,54,46,202644,2708,74
69233,2024,7,5,2,29,71,446923,4806,100
69234,2024,4,3,1,25,75,200878,2262,87
69235,2024,22,7,15,68,32,210398,2553,82
69236,2024,5,5,0,0,100,125600,1591,77
69238,2024,40,26,14,35,65,224337,2298,98
69239,2024,9,9,0,0,100,304810,2963,107
69240,2024,10,10,0,0,100,152685,1587,98
69241,2024,18,8,10,56,44,318612,3841,87
69242,2024,12,12,0,0,100,262138,2891,91
69243,2024,104,38,66,63,37,149036,2033,77
69244,2024,261,35,226,87,13,350847,4325,78
69245,2024,14,11,3,21,79,219633,2648,87
69246,2024,14,13,1,7,93,362759,3595,96
69248,2024,48,40,8,17,83,142388,1452,98
69249,2024,21,15,6,29,71,301256,3301,95
69250,2024,56,36,20,36,64,419812,4289,100
69252,2024,2,2,0,0,100,391500,2280,172
69253,2024,7,7,0,0,100,281629,2347,128
69254,2024,7,7,0,0,100,157100,2077,72
69255,2024,50,37,13,26,74,377795,3532,109
69256,2024,283,63,220,78,22,187671,2777,68
69257,2024,8,6,2,25,75,229402,2346,94
69258,2024,4,4,0,0,100,148900,1454,106
69259,2024,392,79,313,80,20,193083,2888,69
69260,2024,40,19,21,52,48,336741,3548,91
69263,2024,6,6,0,0,100,261528,2334,136
69264,2024,451,75,376,83,17,178200,2561,71
69265,2024,5,4,1,20,80,271790,2221,169
69266,2024,1727,84,1643,95,5,217631,3605,62
69267,2024,15,14,1,7,93,278918,2253,122
69268,2024,20,8,12,60,40,364695,4556,81
69269,2024,7,6,1,14,86,195930,3288,63
69270,2024,31,22,9,29,71,404289,4164,98
69271,2024,99,69,30,30,70,395409,4272,95
69272,2024,27,19,8,30,70,350676,3880,91
69273,2024,73,42,31,42,58,266721,3300,81
69275,2024,244,70,174,71,29,246572,3491,72
69276,2024,78,38,40,51,49,243421,3121,77
69277,2024,97,56,41,42,58,392455,4537,87
69278,2024,58,35,23,40,60,336287,3623,89
69279,2024,46,35,11,24,76,345219,3786,94
69280,2024,16,14,2,12,88,343813,3425,105
69281,2024,18,16,2,11,89,345699,3552,104
69282,2024,297,144,153,52,48,287714,3695,78
69283,2024,96,67,29,30,70,342829,3948,88
69284,2024,29,23,6,21,79,398096,4218,90
69285,2024,16,14,2,12,88,324914,3744,88
69286,2024,180,69,111,62,38,282298,3280,85
69287,2024,64,51,13,20,80,400027,4140,99
69288,2024,42,25,17,40,60,330292,3885,88
69289,2024,32,25,7,22,78,338300,3562,103
69290,2024,427,89,338,79,21,221246,3024,74
69291,2024,57,30,27,47,53,276867,3259,85
69292,2024,62,9,53,85,15,253204,3512,75
69293,2024,26,18,8,31,69,527971,4368,119
69294,2024,33,15,18,55,45,296290,3767,79
69295,2024,8,4,4,50,50,357975,3991,87
69296,2024,25,24,1,4,96,397386,3624,110
69297,2024,40,30,10,25,75,389273,4000,98
69298,2024,31,20,11,35,65,359811,3951,91
69299,2024,15,13,2,13,87,322121,3349,100
70001,2024,2,2,0,0,100,121900,653,184
70002,2024,1,1,0,0,100,65000,1300,50
70003,2024,1,1,0,0,100,148600,708,210
70004,2024,5,5,0,0,100,148980,1358,115
70006,2024,7,6,1,14,86,84393,949,90
70008,2024,2,2,0,0,100,84250,794,104
70010,2024,1,1,0,0,100,274300,1841,149
70012,2024,9,9,0,0,100,120144,1181,123
70013,2024,5,5,0,0,100,75620,693,107
70014,2024,2,2,0,0,100,108750,828,130
70015,2024,4,4,0,0,100,123466,1108,110
70016,2024,4,4,0,0,100,118000,1429,85
70017,2024,4,4,0,0,100,103125,914,110
70018,2024,8,7,1,12,88,159738,1453,113
70019,2024,1,1,0,0,100,115000,639,180
70020,2024,1,1,0,0,100,162000,771,210
70023,2024,4,4,0,0,100,50900,446,113
70024,2024,2,2,0,0,100,149575,1546,96
70025,2024,2,2,0,0,100,77250,913,84
70026,2024,21,18,3,14,86,108664,1131,95
70027,2024,1,1,0,0,100,33000,367,90
70028,2024,2,2,0,0,100,152910,1339,114
70029,2024,1,1,0,0,100,95300,681,140
70031,2024,10,10,0,0,100,154950,1440,109
70035,2024,2,2,0,0,100,63450,474,134
70036,2024,1,1,0,0,100,187800,2087,90
70037,2024,4,4,0,0,100,78500,1092,70
70038,2024,2,1,1,50,50,129500,1388,90
70039,2024,3,3,0,0,100,124667,1072,123
70040,2024,4,4,0,0,100,131000,1268,106
70041,2024,4,4,0,0,100,178425,1191,150
70043,2024,7,7,0,0,100,133801,978,136
70044,2024,3,3,0,0,100,120433,1370,88
70045,2024,2,2,0,0,100,177050,2426,73
70046,2024,3,3,0,0,100,130867,1251,105
70049,2024,1,1,0,0,100,90000,692,130
70050,2024,1,1,0,0,100,185000,1609,115
70051,2024,1,1,0,0,100,126000,653,193
70054,2024,3,3,0,0,100,153000,1873,79
70055,2024,9,9,0,0,100,130869,1332,98
70056,2024,5,5,0,0,100,82910,966,86
70057,2024,3,3,0,0,100,173921,1424,126
70058,2024,6,6,0,0,100,136708,1519,96
70059,2024,3,3,0,0,100,130467,1646,84
70060,2024,3,3,0,0,100,227667,1549,120
70061,2024,3,3,0,0,100,146117,1796,81
70063,2024,4,2,2,50,50,143812,1564,97
70064,2024,3,3,0,0,100,178300,1567,128
70065,2024,1,1,0,0,100,125000,1786,70
70066,2024,5,5,0,0,100,85633,745,119
70067,2024,1,1,0,0,100,75000,974,77
70070,2024,2,2,0,0,100,92945,540,152
70071,2024,2,2,0,0,100,120000,1775,52
70072,2024,3,3,0,0,100,97367,718,149
70074,2024,2,2,0,0,100,52675,478,106
70075,2024,1,1,0,0,100,55000,367,150
70076,2024,4,4,0,0,100,223438,1842,120
70077,2024,3,3,0,0,100,124900,1091,110
70079,2024,7,7,0,0,100,157943,1315,129
70080,2024,3,3,0,0,100,200667,1424,155
70082,2024,1,1,0,0,100,21000,412,51
70083,2024,6,6,0,0,100,94175,1143,89
70084,2024,11,11,0,0,100,232309,2134,115
70085,2024,2,2,0,0,100,240000,2294,104
70086,2024,1,1,0,0,100,35000,389,90
70087,2024,1,1,0,0,100,225500,2189,103
70089,2024,1,1,0,0,100,25000,357,70
70090,2024,1,0,1,100,0,90000,1059,85
70091,2024,1,1,0,0,100,150043,769,195
70092,2024,2,2,0,0,100,179811,2302,80
70093,2024,7,7,0,0,100,102821,952,104
70094,2024,3,3,0,0,100,112083,964,121
70095,2024,5,5,0,0,100,105896,854,129
70096,2024,6,6,0,0,100,121140,1555,90
70097,2024,3,3,0,0,100,132500,1267,105
70098,2024,1,1,0,0,100,112500,859,131
70101,2024,8,8,0,0,100,109750,1222,93
70102,2024,3,3,0,0,100,132000,1001,117
70103,2024,2,2,0,0,100,219700,1234,178
70104,2024,7,7,0,0,100,164386,1042,154
70105,2024,2,1,1,50,50,109000,1392,78
70106,2024,1,1,0,0,100,80000,563,142
70107,2024,5,5,0,0,100,207900,1889,115
70109,2024,4,4,0,0,100,277875,4036,80
70111,2024,1,1,0,0,100,142000,1214,117
70112,2024,3,3,0,0,100,153560,985,171
70114,2024,2,2,0,0,100,127500,856,144
70115,2024,2,2,0,0,100,85250,784,108
70116,2024,6,6,0,0,100,158050,1660,96
70117,2024,8,6,2,25,75,202100,2118,95
70119,2024,1,1,0,0,100,209000,2177,96
70120,2024,31,28,3,10,90,123878,1418,90
70121,2024,6,6,0,0,100,145000,1357,105
70122,2024,27,27,0,0,100,81531,1013,85
70125,2024,1,1,0,0,100,87000,870,100
70126,2024,2,2,0,0,100,128300,1172,103
70128,2024,3,3,0,0,100,180333,3544,77
70129,2024,3,3,0,0,100,166367,1817,91
70130,2024,3,3,0,0,100,93133,1035,91
70132,2024,7,7,0,0,100,154071,1433,116
70134,2024,1,1,0,0,100,63400,755,84
70135,2024,1,1,0,0,100,60000,566,106
70136,2024,9,9,0,0,100,159649,1530,112
70137,2024,5,5,0,0,100,106340,1075,107
70138,2024,1,1,0,0,100,55100,716,77
70140,2024,1,1,0,0,100,74100,741,100
70141,2024,2,2,0,0,100,205460,1048,172
70142,2024,2,2,0,0,100,117150,1116,108
70143,2024,1,1,0,0,100,114325,994,115
70144,2024,1,1,0,0,100,78000,629,124
70146,2024,1,1,0,0,100,45000,409,110
70148,2024,1,1,0,0,100,192500,1833,105
70149,2024,3,3,0,0,100,194167,1533,119
70150,2024,1,0,1,100,0,125270,1305,96
70151,2024,2,2,0,0,100,150000,1136,130
70152,2024,4,4,0,0,100,180565,1487,133
70153,2024,1,1,0,0,100,125400,1150,109
70155,2024,6,6,0,0,100,92383,1255,97
70156,2024,1,1,0,0,100,78600,763,103
70157,2024,1,1,0,0,100,123500,807,153
70158,2024,1,1,0,0,100,209000,1756,119
70160,2024,1,1,0,0,100,51000,638,80
70162,2024,4,4,0,0,100,183512,1545,116
70163,2024,3,3,0,0,100,101333,967,105
70164,2024,2,2,0,0,100,143550,920,148
70165,2024,3,3,0,0,100,116967,874,129
70166,2024,1,1,0,0,100,138000,1704,81
70167,2024,1,1,0,0,100,77000,1167,66
70168,2024,4,4,0,0,100,107288,1278,90
70169,2024,4,4,0,0,100,80000,675,118
70171,2024,9,9,0,0,100,95028,996,105
70172,2024,1,1,0,0,100,209500,1703,123
70174,2024,3,3,0,0,100,105603,849,129
70175,2024,5,5,0,0,100,80800,769,107
70176,2024,1,1,0,0,100,54000,692,78
70177,2024,9,9,0,0,100,115819,1417,99
70178,2024,5,5,0,0,100,118620,1877,67
70179,2024,1,1,0,0,100,167000,944,177
70180,2024,3,3,0,0,100,154200,1645,92
70181,2024,1,1,0,0,100,135870,2264,60
70182,2024,4,4,0,0,100,197025,2476,87
70183,2024,1,1,0,0,100,62000,639,97
70184,2024,13,10,3,23,77,142608,1692,86
70185,2024,4,4,0,0,100,86315,890,95
70187,2024,2,2,0,0,100,103600,1064,94
70188,2024,1,1,0,0,100,120000,1121,107
70189,2024,1,1,0,0,100,30000,1500,20
70190,2024,2,2,0,0,100,281380,1310,228
70192,2024,1,1,0,0,100,110000,1528,72
70194,2024,1,1,0,0,100,52250,670,78
70197,2024,8,8,0,0,100,83662,827,94
70198,2024,7,7,0,0,100,107393,1097,103
70200,2024,1,1,0,0,100,75000,773,97
70201,2024,1,1,0,0,100,50000,588,85
70202,2024,2,2,0,0,100,81500,1132,69
70204,2024,1,0,1,100,0,80570,782,103
70205,2024,2,2,0,0,100,179000,2018,86
70206,2024,3,3,0,0,100,166333,1800,93
70207,2024,35,30,5,14,86,152939,1684,92
70208,2024,2,2,0,0,100,128000,1057,119
70210,2024,1,1,0,0,100,150000,1648,91
70211,2024,1,1,0,0,100,44400,493,90
70213,2024,1,1,0,0,100,216100,2205,98
70214,2024,2,2,0,0,100,63500,580,108
70215,2024,4,4,0,0,100,212022,1696,140
70216,2024,3,3,0,0,100,124083,1157,118
70217,2024,3,3,0,0,100,268000,3541,114
70218,2024,2,2,0,0,100,125690,1102,111
70219,2024,5,5,0,0,100,124988,1419,91
70220,2024,5,5,0,0,100,95600,1038,88
70221,2024,5,5,0,0,100,191980,1321,134
70224,2024,3,3,0,0,100,221333,1954,108
70225,2024,2,2,0,0,100,122500,1002,125
70226,2024,1,1,0,0,100,123000,1118,110
70227,2024,6,5,1,17,83,142942,1596,110
70228,2024,8,7,1,12,88,98744,933,107
70229,2024,1,1,0,0,100,132500,1004,132
70230,2024,3,3,0,0,100,124433,904,141
70232,2024,3,3,0,0,100,131567,779,168
70233,2024,1,1,0,0,100,361500,2259,160
70234,2024,1,1,0,0,100,45000,450,100
70235,2024,1,1,0,0,100,139100,1391,100
70236,2024,5,5,0,0,100,112180,1026,104
70237,2024,1,1,0,0,100,55130,551,100
70238,2024,2,2,0,0,100,123000,1226,104
70239,2024,3,3,0,0,100,136100,1593,89
70240,2024,10,10,0,0,100,115442,1118,100
70242,2024,1,1,0,0,100,70000,432,162
70243,2024,1,1,0,0,100,114000,1390,82
70244,2024,2,2,0,0,100,139000,992,130
70245,2024,28,28,0,0,100,134139,1224,108
70247,2024,3,3,0,0,100,104333,956,110
70248,2024,9,9,0,0,100,178171,2127,106
70250,2024,3,3,0,0,100,191283,1606,122
70253,2024,1,1,0,0,100,162900,1244,131
70254,2024,1,1,0,0,100,40000,455,88
70255,2024,2,2,0,0,100,167750,1234,136
70256,2024,11,11,0,0,100,107936,1389,93
70257,2024,6,6,0,0,100,103547,1040,98
70258,2024,13,13,0,0,100,125654,1441,87
70260,2024,4,4,0,0,100,147738,1615,93
70261,2024,17,17,0,0,100,164682,1530,112
70262,2024,5,5,0,0,100,63248,754,90
70264,2024,1,1,0,0,100,173330,1970,88
70265,2024,2,2,0,0,100,158275,1378,116
70267,2024,3,3,0,0,100,159867,1003,126
70269,2024,1,1,0,0,100,94800,817,116
70271,2024,1,1,0,0,100,50000,420,119
70272,2024,4,4,0,0,100,75750,635,122
70273,2024,1,1,0,0,100,82970,864,96
70275,2024,4,4,0,0,100,132500,1282,117
70276,2024,2,2,0,0,100,172425,1284,134
70277,2024,3,3,0,0,100,118333,1219,96
70278,2024,2,2,0,0,100,140820,1140,126
70279,2024,45,22,23,51,49,110075,1234,91
70280,2024,9,9,0,0,100,145956,1289,123
70282,2024,14,10,4,29,71,114533,884,141
70283,2024,5,4,1,20,80,91982,1632,72
70284,2024,1,1,0,0,100,107000,1216,88
70285,2024,99,69,30,30,70,133544,1396,94
70286,2024,1,1,0,0,100,85000,1518,56
70287,2024,1,1,0,0,100,73000,487,150
70290,2024,1,1,0,0,100,20000,333,60
70291,2024,3,3,0,0,100,75333,616,136
70292,2024,28,28,0,0,100,86793,929,94
70293,2024,1,1,0,0,100,135000,649,208
70294,2024,1,1,0,0,100,150000,1456,103
70295,2024,1,1,0,0,100,130000,4643,28
70298,2024,1,1,0,0,100,85000,850,100
70299,2024,3,3,0,0,100,107000,952,108
70302,2024,1,1,0,0,100,165000,1447,114
70303,2024,1,1,0,0,100,70000,667,105
70306,2024,6,6,0,0,100,144883,821,176
70307,2024,1,1,0,0,100,241700,1949,124
70308,2024,2,1,1,50,50,48250,794,57
70309,2024,8,8,0,0,100,150856,1431,108
70310,2024,49,34,15,31,69,119915,1255,97
70311,2024,124,51,73,59,41,105532,1167,86
70312,2024,6,6,0,0,100,236742,2166,112
70313,2024,4,4,0,0,100,105862,896,120
70314,2024,2,2,0,0,100,312500,2856,107
70315,2024,2,2,0,0,100,61550,778,80
70316,2024,1,1,0,0,100,213750,1454,147
70317,2024,4,4,0,0,100,155750,1183,132
70318,2024,3,3,0,0,100,209770,1910,111
70319,2024,1,1,0,0,100,213000,1590,134
70320,2024,2,2,0,0,100,92500,758,135
70321,2024,16,16,0,0,100,195967,1889,105
70322,2024,1,1,0,0,100,25000,373,67
70323,2024,1,1,0,0,100,297500,1836,162
70324,2024,6,6,0,0,100,168683,1979,108
70325,2024,2,2,0,0,100,90000,1368,78
70326,2024,3,3,0,0,100,254683,2066,125
70327,2024,1,1,0,0,100,147105,817,180
70328,2024,2,2,0,0,100,164875,1489,126
70329,2024,1,1,0,0,100,39000,488,80
70330,2024,1,1,0,0,100,146420,2006,73
70331,2024,10,10,0,0,100,115417,1175,110
70334,2024,15,12,3,20,80,170547,1552,112
70336,2024,1,1,0,0,100,34000,596,57
70339,2024,14,14,0,0,100,137074,1784,86
70340,2024,3,3,0,0,100,143633,883,169
70341,2024,3,3,0,0,100,58333,517,116
70342,2024,3,3,0,0,100,84933,657,120
70343,2024,2,2,0,0,100,111000,1170,90
70344,2024,1,1,0,0,100,174000,1758,99
70347,2024,4,4,0,0,100,76370,704,117
70348,2024,9,7,2,22,78,108713,1228,96
70349,2024,1,1,0,0,100,175000,1316,133
70351,2024,3,3,0,0,100,175000,1861,91
70352,2024,1,1,0,0,100,550000,3438,160
70353,2024,5,5,0,0,100,147431,1693,104
70355,2024,3,3,0,0,100,204733,2047,101
70357,2024,2,1,1,50,50,145800,1324,110
70358,2024,1,1,0,0,100,118500,988,120
70359,2024,1,1,0,0,100,117000,848,138
70360,2024,3,3,0,0,100,111800,1023,102
70361,2024,1,1,0,0,100,120000,1017,118
70362,2024,2,2,0,0,100,73850,712,102
70363,2024,7,7,0,0,100,166757,1598,119
70366,2024,1,1,0,0,100,50000,556,90
70367,2024,2,2,0,0,100,112200,972,132
70368,2024,1,1,0,0,100,114700,1147,100
70372,2024,1,1,0,0,100,79750,670,119
70373,2024,3,3,0,0,100,90300,982,96
70374,2024,3,3,0,0,100,32333,819,45
70376,2024,5,5,0,0,100,131660,1174,111
70378,2024,20,16,4,20,80,140971,1487,93
70380,2024,1,1,0,0,100,137500,948,145
70381,2024,1,1,0,0,100,171500,1143,150
70383,2024,2,1,1,50,50,142500,1648,88
70384,2024,3,3,0,0,100,104540,746,134
70385,2024,3,3,0,0,100,168233,1757,103
70386,2024,3,3,0,0,100,140700,1359,103
70387,2024,10,10,0,0,100,126850,1375,100
70388,2024,19,18,1,5,95,159554,1734,95
70390,2024,8,8,0,0,100,88669,1032,93
70393,2024,4,4,0,0,100,185118,1216,150
70397,2024,1,1,0,0,100,117500,1237,95
70398,2024,2,2,0,0,100,112500,2292,65
70399,2024,3,3,0,0,100,85333,925,88
70400,2024,1,1,0,0,100,52000,1182,44
70401,2024,1,1,0,0,100,76500,602,127
70402,2024,4,4,0,0,100,115595,1078,120
70403,2024,3,3,0,0,100,127900,1083,120
70404,2024,2,2,0,0,100,67750,444,148
70405,2024,3,3,0,0,100,201900,1513,132
70406,2024,4,4,0,0,100,48925,644,70
70407,2024,4,4,0,0,100,192000,1786,104
70408,2024,17,16,1,6,94,159519,1548,105
70409,2024,2,2,0,0,100,240750,2116,110
70410,2024,4,3,1,25,75,221239,1912,114
70413,2024,17,16,1,6,94,122392,1624,76
70414,2024,7,7,0,0,100,91743,1189,74
70415,2024,8,8,0,0,100,104300,1071,101
70416,2024,1,1,0,0,100,181000,1168,155
70417,2024,3,3,0,0,100,232667,1941,118
70418,2024,3,3,0,0,100,144167,1318,115
70419,2024,4,4,0,0,100,137500,806,168
70420,2024,1,1,0,0,100,231200,963,240
70421,2024,26,23,3,12,88,119737,1280,91
70422,2024,3,3,0,0,100,76667,839,89
70423,2024,1,1,0,0,100,54795,609,90
70425,2024,3,3,0,0,100,114667,995,114
70426,2024,2,2,0,0,100,71000,656,109
70427,2024,4,4,0,0,100,90750,876,102
70428,2024,9,9,0,0,100,180508,1900,97
70429,2024,5,5,0,0,100,134222,1366,95
70431,2024,5,5,0,0,100,171300,1418,122
70432,2024,3,3,0,0,100,141610,1496,99
70433,2024,5,4,1,20,80,100846,1203,92
70435,2024,10,10,0,0,100,131502,1286,110
70436,2024,3,3,0,0,100,56000,710,77
70438,2024,1,1,0,0,100,145000,1151,126
70439,2024,6,6,0,0,100,134516,1279,113
70441,2024,1,1,0,0,100,138500,996,139
70442,2024,4,4,0,0,100,102175,928,106
70443,2024,1,1,0,0,100,180500,2228,81
70444,2024,1,1,0,0,100,62000,1550,40
70446,2024,5,5,0,0,100,131320,1040,147
70447,2024,23,14,9,39,61,184117,1955,94
70448,2024,2,2,0,0,100,91575,676,130
70451,2024,18,18,0,0,100,114101,1160,106
70452,2024,3,3,0,0,100,97825,541,149
70453,2024,1,1,0,0,100,170640,2666,64
70454,2024,1,1,0,0,100,110000,705,156
70455,2024,16,11,5,31,69,136084,1507,93
70456,2024,1,1,0,0,100,189000,2077,91
70457,2024,2,2,0,0,100,53500,1039,64
70459,2024,12,11,1,8,92,108096,1213,91
70460,2024,5,5,0,0,100,221400,2601,88
70463,2024,1,1,0,0,100,145000,2014,72
70464,2024,20,20,0,0,100,154401,1522,105
70466,2024,1,1,0,0,100,195000,1300,150
70467,2024,16,12,4,25,75,128690,1069,101
70469,2024,4,4,0,0,100,195418,2240,86
70472,2024,1,1,0,0,100,170000,1018,167
70473,2024,17,15,2,12,88,109371,1124,98
70474,2024,1,1,0,0,100,105000,1750,60
70476,2024,3,3,0,0,100,168060,1046,142
70477,2024,3,3,0,0,100,151757,1275,124
70478,2024,7,7,0,0,100,170421,1705,102
70479,2024,1,1,0,0,100,219650,1615,136
70480,2024,1,1,0,0,100,72000,900,80
70482,2024,12,11,1,8,92,139744,1468,99
70483,2024,1,1,0,0,100,161050,1895,85
70485,2024,6,6,0,0,100,90167,1019,97
70486,2024,2,2,0,0,100,74250,784,96
70487,2024,1,1,0,0,100,208500,1642,127
70488,2024,4,3,1,25,75,76762,827,95
70489,2024,11,11,0,0,100,152045,2063,74
70490,2024,1,1,0,0,100,109300,643,170
70491,2024,5,5,0,0,100,136780,1278,104
70492,2024,6,6,0,0,100,64778,573,113
70493,2024,2,2,0,0,100,163400,1821,90
70494,2024,6,6,0,0,100,159468,1579,100
70498,2024,4,4,0,0,100,162450,1689,88
70499,2024,2,2,0,0,100,77131,542,142
70500,2024,2,2,0,0,100,116500,1271,88
70501,2024,1,1,0,0,100,56000,622,90
70503,2024,2,2,0,0,100,204300,1367,138
70504,2024,5,5,0,0,100,133370,1186,112
70505,2024,3,3,0,0,100,125520,1645,77
70506,2024,1,1,0,0,100,189220,1911,99
70507,2024,3,3,0,0,100,192000,1759,117
70510,2024,6,6,0,0,100,110217,1031,106
70511,2024,3,3,0,0,100,108833,746,145
70512,2024,1,1,0,0,100,65000,844,77
70513,2024,14,10,4,29,71,165248,1593,103
70514,2024,3,3,0,0,100,190000,1331,143
70515,2024,3,3,0,0,100,159167,2885,59
70516,2024,2,2,0,0,100,84745,590,144
70517,2024,4,4,0,0,100,196920,2193,91
70519,2024,2,2,0,0,100,159000,1691,93
70520,2024,2,2,0,0,100,88100,1120,78
70521,2024,1,1,0,0,100,219150,2170,101
70522,2024,1,1,0,0,100,197000,1775,111
70523,2024,3,3,0,0,100,52333,695,74
70524,2024,1,1,0,0,100,50000,667,75
70525,2024,3,3,0,0,100,70667,1092,64
70526,2024,9,7,2,22,78,76057,690,114
70527,2024,1,1,0,0,100,128000,800,160
70528,2024,2,2,0,0,100,106525,743,142
70529,2024,3,3,0,0,100,188926,2112,90
70530,2024,1,1,0,0,100,80000,879,91
70531,2024,1,1,0,0,100,130000,1444,90
70532,2024,6,6,0,0,100,143067,1340,109
70534,2024,1,1,0,0,100,50700,859,59
70535,2024,1,1,0,0,100,243000,1321,184
70536,2024,1,1,0,0,100,55000,500,110
70538,2024,2,2,0,0,100,184700,2280,82
70539,2024,4,4,0,0,100,85625,916,100
70541,2024,2,2,0,0,100,110625,714,178
70542,2024,3,3,0,0,100,96667,1132,73
70544,2024,1,1,0,0,100,285580,2040,140
70546,2024,4,4,0,0,100,108575,952,120
70547,2024,1,1,0,0,100,191000,2358,81
70549,2024,1,1,0,0,100,60000,522,115
70550,2024,192,40,152,79,21,95653,1269,75
70554,2024,2,2,0,0,100,42500,474,90
70555,2024,1,1,0,0,100,66500,821,81
70557,2024,1,1,0,0,100,185000,1682,110
70559,2024,3,3,0,0,100,111000,1040,99
70560,2024,1,1,0,0,100,228000,1824,125
70561,2024,13,10,3,23,77,117135,1160,97
70562,2024,1,1,0,0,100,140000,1077,130
70563,2024,2,2,0,0,100,121150,1266,79
70564,2024,6,6,0,0,100,143768,1449,100
70565,2024,1,1,0,0,100,282800,2548,111
70566,2024,1,1,0,0,100,143400,1112,129
70568,2024,2,2,0,0,100,55000,596,92
70569,2024,1,1,0,0,100,171650,1291,133
70572,2024,6,6,0,0,100,68818,609,109
70573,2024,2,2,0,0,100,285000,2409,115
70575,2024,8,8,0,0,100,225711,2142,106
70576,2024,1,1,0,0,100,30000,441,68
70577,2024,5,5,0,0,100,153773,1352,118
70578,2024,1,1,0,0,100,345700,2188,158
70579,2024,4,4,0,0,100,151800,1430,106
70580,2024,2,2,0,0,100,153250,1196,134
70581,2024,4,4,0,0,100,203966,1532,126
70582,2024,2,2,0,0,100,124000,1186,108
70583,2024,1,1,0,0,100,202300,1376,147
71001,2024,5,5,0,0,100,214202,1548,136
71002,2024,11,11,0,0,100,158859,1574,115
71003,2024,5,4,1,20,80,134700,1475,88
71004,2024,9,9,0,0,100,221558,2015,110
71005,2024,4,4,0,0,100,242212,1826,130
71006,2024,1,1,0,0,100,210000,1312,160
71007,2024,5,5,0,0,100,250949,1943,122
71008,2024,1,1,0,0,100,112000,1867,60
71009,2024,27,27,0,0,100,117331,1170,95
71010,2024,11,11,0,0,100,103000,1165,92
71011,2024,8,7,1,12,88,168516,1798,97
71012,2024,3,3,0,0,100,270900,1573,161
71013,2024,6,6,0,0,100,137867,1504,97
71014,2024,137,72,65,47,53,98626,1192,82
71015,2024,4,4,0,0,100,108680,1190,87
71016,2024,12,11,1,8,92,217694,2084,109
71017,2024,1,1,0,0,100,85000,794,107
71018,2024,6,6,0,0,100,106083,1275,82
71019,2024,1,1,0,0,100,152000,2027,75
71020,2024,1,1,0,0,100,38000,1152,33
71021,2024,3,3,0,0,100,157317,1428,118
71022,2024,8,7,1,12,88,104802,1183,88
71023,2024,13,13,0,0,100,170132,1889,95
71024,2024,4,4,0,0,100,170275,1759,96
71025,2024,6,6,0,0,100,272199,2541,116
71026,2024,2,2,0,0,100,141500,1692,85
71027,2024,5,4,1,20,80,217180,3728,102
71028,2024,1,1,0,0,100,146475,2253,65
71029,2024,5,5,0,0,100,145148,1502,95
71032,2024,4,4,0,0,100,209988,2654,79
71033,2024,8,8,0,0,100,168231,1448,116
71034,2024,1,1,0,0,100,71400,892,80
71035,2024,1,1,0,0,100,205000,1475,139
71036,2024,3,2,1,33,67,86617,1358,60
71037,2024,1,1,0,0,100,90000,1636,55
71038,2024,3,3,0,0,100,225978,1762,139
71039,2024,1,1,0,0,100,267000,2225,120
71040,2024,47,45,2,4,96,113995,1414,85
71041,2024,2,2,0,0,100,183365,1482,126
71042,2024,6,6,0,0,100,142302,1521,94
71044,2024,4,4,0,0,100,141250,1403,105
71045,2024,1,1,0,0,100,117000,1918,61
71046,2024,2,2,0,0,100,81750,1333,63
71047,2024,47,47,0,0,100,101906,1229,83
71048,2024,1,1,0,0,100,85000,708,120
71050,2024,3,3,0,0,100,261467,2267,98
71051,2024,4,4,0,0,100,173500,1616,102
71052,2024,4,4,0,0,100,106705,1063,105
71054,2024,8,8,0,0,100,107075,1528,64
71056,2024,33,32,1,3,97,164560,1543,109
71057,2024,2,2,0,0,100,282500,1776,178
71058,2024,4,4,0,0,100,230375,1715,125
71059,2024,38,38,0,0,100,140048,1530,89
71060,2024,4,4,0,0,100,158500,1373,120
71061,2024,9,9,0,0,100,215989,1737,129
71062,2024,1,1,0,0,100,135840,1345,101
71063,2024,15,15,0,0,100,112957,1077,101
71064,2024,14,14,0,0,100,173880,1697,103
71065,2024,9,9,0,0,100,155016,1740,89
71066,2024,1,1,0,0,100,404000,2557,158
71067,2024,3,3,0,0,100,259425,2170,104
71068,2024,2,2,0,0,100,145000,1238,113
71069,2024,7,7,0,0,100,252838,2238,114
71070,2024,20,17,3,15,85,181010,2096,92
71071,2024,5,5,0,0,100,132020,1138,103
71072,2024,1,1,0,0,100,108200,958,113
71073,2024,50,35,15,30,70,135071,1673,80
71074,2024,7,7,0,0,100,284043,2465,115
71075,2024,12,10,2,17,83,77458,862,87
71076,2024,670,94,576,86,14,110994,1499,73
71077,2024,8,8,0,0,100,103155,1068,93
71078,2024,1,1,0,0,100,128650,960,134
71079,2024,6,6,0,0,100,188250,2050,100
71081,2024,26,21,5,19,81,150588,1723,88
71082,2024,3,3,0,0,100,210733,1542,142
71084,2024,4,4,0,0,100,369138,2735,133
71085,2024,2,2,0,0,100,204250,1547,134
71086,2024,3,3,0,0,100,114667,1422,74
71087,2024,5,5,0,0,100,149500,1485,105
71089,2024,6,6,0,0,100,253872,2234,114
71090,2024,16,15,1,6,94,213530,2187,101
71091,2024,2,2,0,0,100,113000,818,144
71092,2024,9,9,0,0,100,141253,1428,101
71093,2024,10,10,0,0,100,153750,1563,98
71094,2024,3,3,0,0,100,104700,1574,89
71095,2024,5,5,0,0,100,72848,876,80
71096,2024,1,1,0,0,100,313400,2089,150
71097,2024,11,11,0,0,100,106382,1234,91
71098,2024,5,3,2,40,60,64820,738,86
71099,2024,3,3,0,0,100,276610,2410,122
71100,2024,1,1,0,0,100,210000,2625,80
71101,2024,5,5,0,0,100,95700,992,98
71102,2024,3,3,0,0,100,247952,2151,121
71104,2024,2,2,0,0,100,107500,1147,97
71105,2024,90,34,56,62,38,209363,2491,84
71106,2024,32,28,4,12,88,134939,1400,97
71107,2024,3,3,0,0,100,127103,1355,97
71108,2024,2,2,0,0,100,343500,2888,110
71109,2024,3,3,0,0,100,121456,1523,92
71110,2024,6,6,0,0,100,164983,1578,105
71111,2024,4,4,0,0,100,94091,1100,86
71112,2024,3,2,1,33,67,159167,1793,87
71113,2024,7,7,0,0,100,135093,1002,135
71115,2024,1,1,0,0,100,75000,1875,40
71117,2024,14,14,0,0,100,216718,1814,118
71118,2024,79,54,25,32,68,162950,1960,88
71119,2024,14,14,0,0,100,197186,1712,134
71120,2024,44,35,9,20,80,124524,1373,88
71121,2024,4,4,0,0,100,158000,1658,106
71122,2024,4,4,0,0,100,170352,1735,100
71123,2024,9,9,0,0,100,109833,1281,94
71124,2024,1,1,0,0,100,170000,2537,67
71125,2024,2,2,0,0,100,70710,996,71
71126,2024,3,3,0,0,100,374667,3231,119
71127,2024,1,1,0,0,100,131500,1252,105
71128,2024,1,1,0,0,100,119500,2390,50
71129,2024,5,5,0,0,100,59160,630,91
71130,2024,8,8,0,0,100,139160,1166,120
71131,2024,1,1,0,0,100,57000,838,68
71132,2024,27,24,3,11,89,91045,1003,93
71133,2024,22,18,4,18,82,126610,1414,94
71134,2024,5,5,0,0,100,178641,2242,95
71135,2024,3,3,0,0,100,217467,2007,110
71137,2024,45,31,14,31,69,216942,2603,94
71139,2024,2,2,0,0,100,88000,1210,72
71141,2024,3,3,0,0,100,175000,1725,101
71142,2024,2,2,0,0,100,256732,2494,105
71143,2024,8,8,0,0,100,147000,1814,84
71144,2024,1,1,0,0,100,146230,1462,100
71145,2024,5,5,0,0,100,136640,1553,88
71146,2024,2,2,0,0,100,38100,576,68
71147,2024,6,6,0,0,100,105917,1304,84
71148,2024,10,10,0,0,100,121050,1176,102
71149,2024,19,19,0,0,100,130337,1209,96
71150,2024,27,25,2,7,93,218542,2182,101
71152,2024,5,5,0,0,100,141000,1198,108
71153,2024,208,107,101,49,51,86885,1200,77
71154,2024,24,22,2,8,92,201345,1918,109
71155,2024,6,6,0,0,100,125102,1174,100
71156,2024,7,7,0,0,100,177070,1802,100
71157,2024,14,14,0,0,100,119786,1396,86
71158,2024,22,17,5,23,77,137447,1602,85
71159,2024,1,1,0,0,100,310200,2674,116
71160,2024,4,4,0,0,100,123750,1700,76
71161,2024,4,4,0,0,100,143050,1469,96
71162,2024,11,11,0,0,100,99105,1143,85
71163,2024,1,1,0,0,100,97000,2021,48
71164,2024,3,3,0,0,100,70000,1046,80
71165,2024,9,9,0,0,100,65311,824,74
71166,2024,1,1,0,0,100,80000,563,142
71167,2024,4,4,0,0,100,161268,1487,97
71168,2024,2,2,0,0,100,203367,1848,112
71169,2024,2,2,0,0,100,310500,3430,92
71170,2024,20,18,2,10,90,226275,2136,102
71171,2024,3,3,0,0,100,73000,1587,45
71173,2024,6,6,0,0,100,162250,1408,115
71174,2024,1,1,0,0,100,52000,675,77
71175,2024,6,6,0,0,100,113017,1146,106
71176,2024,58,36,22,38,62,99219,1133,83
71177,2024,9,9,0,0,100,156700,1621,99
71178,2024,11,10,1,9,91,150727,1759,82
71181,2024,1,1,0,0,100,172425,2973,58
71182,2024,14,14,0,0,100,397719,2492,161
71183,2024,1,1,0,0,100,33000,478,69
71184,2024,3,3,0,0,100,87667,1032,81
71185,2024,2,2,0,0,100,205000,1198,172
71186,2024,2,2,0,0,100,107510,1436,80
71187,2024,21,18,3,14,86,114236,1382,86
71188,2024,3,3,0,0,100,74333,835,90
71189,2024,11,11,0,0,100,223567,1863,124
71190,2024,31,27,4,13,87,80443,940,83
71191,2024,1,1,0,0,100,156000,1545,101
71192,2024,20,20,0,0,100,122815,1222,106
71193,2024,5,5,0,0,100,106550,1129,110
71194,2024,7,7,0,0,100,199986,1821,117
71195,2024,5,5,0,0,100,187600,1760,110
71196,2024,11,11,0,0,100,156424,1613,102
71198,2024,5,5,0,0,100,165300,1471,107
71199,2024,2,2,0,0,100,147500,1904,78
71200,2024,12,12,0,0,100,185183,1483,122
71201,2024,3,3,0,0,100,168033,1095,139
71202,2024,15,14,1,7,93,247046,2322,102
71203,2024,2,2,0,0,100,60000,768,76
71204,2024,4,4,0,0,100,195425,2200,90
71205,2024,9,9,0,0,100,97757,1033,93
71206,2024,5,5,0,0,100,187200,1819,104
71207,2024,2,2,0,0,100,98125,768,129
71208,2024,1,1,0,0,100,250000,1938,129
71209,2024,10,10,0,0,100,169114,1874,93
71210,2024,3,3,0,0,100,218800,2354,94
71212,2024,14,14,0,0,100,78560,845,94
71213,2024,5,5,0,0,100,106000,1127,96
71214,2024,5,5,0,0,100,90190,1206,99
71215,2024,20,19,1,5,95,176736,1675,104
71216,2024,6,6,0,0,100,128267,1225,103
71218,2024,6,6,0,0,100,122765,1382,86
71219,2024,6,6,0,0,100,152683,1429,106
71220,2024,5,5,0,0,100,92000,1154,67
71221,2024,35,33,2,6,94,273076,2265,123
71222,2024,7,7,0,0,100,156915,1672,91
71223,2024,6,6,0,0,100,112933,1372,83
71224,2024,2,2,0,0,100,187000,1575,136
71225,2024,6,6,0,0,100,206424,1823,108
71227,2024,4,4,0,0,100,79250,1109,74
71228,2024,2,2,0,0,100,181000,1443,106
71229,2024,4,4,0,0,100,67688,768,86
71230,2024,74,66,8,11,89,106688,1210,91
71231,2024,10,9,1,10,90,196957,1925,92
71232,2024,1,1,0,0,100,90000,1084,83
71233,2024,1,1,0,0,100,77500,596,130
71234,2024,2,2,0,0,100,140000,1446,98
71235,2024,17,14,3,18,82,222338,2263,100
71236,2024,8,8,0,0,100,244806,2219,110
71237,2024,7,7,0,0,100,98393,1540,79
71238,2024,12,12,0,0,100,217647,1964,108
71239,2024,13,13,0,0,100,82024,980,87
71240,2024,5,5,0,0,100,438644,3041,146
71241,2024,3,3,0,0,100,218533,2108,101
71242,2024,8,8,0,0,100,131619,1213,94
71243,2024,8,8,0,0,100,141125,1378,104
71244,2024,10,10,0,0,100,131665,1366,93
71245,2024,2,2,0,0,100,132500,1516,88
71246,2024,4,4,0,0,100,187638,1936,124
71247,2024,1,1,0,0,100,80000,593,135
71248,2024,11,11,0,0,100,149374,1518,98
71249,2024,14,14,0,0,100,198521,2024,102
71250,2024,8,8,0,0,100,194869,1827,108
71251,2024,4,4,0,0,100,62375,1169,55
71252,2024,5,5,0,0,100,258565,2024,134
71253,2024,6,6,0,0,100,198092,1685,127
71254,2024,3,3,0,0,100,132567,1311,101
71255,2024,1,1,0,0,100,120000,1412,85
71256,2024,2,2,0,0,100,137500,1309,106
71257,2024,1,1,0,0,100,60000,652,92
71258,2024,9,9,0,0,100,183764,1926,99
71259,2024,2,2,0,0,100,199675,1302,142
71261,2024,6,6,0,0,100,141167,1470,96
71262,2024,2,2,0,0,100,91455,2616,37
71263,2024,67,46,21,31,69,165324,1699,98
71264,2024,6,6,0,0,100,107147,1477,84
71266,2024,7,7,0,0,100,78787,1051,79
71267,2024,11,11,0,0,100,166750,1528,106
71268,2024,5,4,1,20,80,197170,1449,136
71269,2024,41,21,20,49,51,154025,1800,84
71270,2024,389,83,306,79,21,140324,1820,76
71271,2024,2,2,0,0,100,222750,1678,132
71272,2024,3,3,0,0,100,140630,1501,100
71273,2024,4,4,0,0,100,34300,553,60
71274,2024,2,2,0,0,100,362030,2015,159
71275,2024,27,26,1,4,96,110218,1040,102
71276,2024,2,2,0,0,100,220925,2008,110
71277,2024,6,6,0,0,100,170410,1543,108
71279,2024,11,11,0,0,100,123169,1221,100
71280,2024,2,2,0,0,100,92500,782,160
71281,2024,4,4,0,0,100,140500,1158,111
71282,2024,9,9,0,0,100,154457,1407,105
71283,2024,6,6,0,0,100,191318,1720,114
71285,2024,7,7,0,0,100,93571,1273,75
71286,2024,4,4,0,0,100,157350,1710,89
71287,2024,3,3,0,0,100,124036,1891,66
71289,2024,13,12,1,8,92,148281,1315,114
71291,2024,13,13,0,0,100,125175,1006,116
71292,2024,10,10,0,0,100,249188,1881,132
71293,2024,14,14,0,0,100,138350,1237,110
71294,2024,6,6,0,0,100,161083,1901,83
71295,2024,16,15,1,6,94,123956,1243,103
71296,2024,3,3,0,0,100,197050,2115,93
71297,2024,9,9,0,0,100,102560,1103,98
71299,2024,1,1,0,0,100,306000,2026,151
71300,2024,10,10,0,0,100,165455,1520,104
71301,2024,1,1,0,0,100,90000,1154,78
71302,2024,2,2,0,0,100,200000,3009,77
71303,2024,3,3,0,0,100,130000,1742,75
71305,2024,7,7,0,0,100,155714,1659,97
71306,2024,180,132,48,27,73,86995,1089,81
71307,2024,1,1,0,0,100,99000,1375,72
71308,2024,1,1,0,0,100,220000,1257,175
71309,2024,21,19,2,10,90,116050,1363,84
71310,2024,38,34,4,11,89,121836,1534,78
71311,2024,3,3,0,0,100,144833,1868,76
71312,2024,1,1,0,0,100,145000,1648,88
71313,2024,1,1,0,0,100,235000,5222,45
71314,2024,2,2,0,0,100,130500,1366,96
71315,2024,1,1,0,0,100,275000,1279,215
71316,2024,10,10,0,0,100,157350,1618,93
71317,2024,3,3,0,0,100,194383,1776,101
71318,2024,15,14,1,7,93,130693,1601,79
71319,2024,11,11,0,0,100,171000,1662,105
71320,2024,3,3,0,0,100,64500,1017,67
71321,2024,2,2,0,0,100,163912,1765,93
71323,2024,2,2,0,0,100,120000,1704,84
71324,2024,5,5,0,0,100,180294,1993,95
71325,2024,8,8,0,0,100,128526,1550,106
71326,2024,10,10,0,0,100,132495,1356,105
71327,2024,2,2,0,0,100,126375,1633,73
71328,2024,6,6,0,0,100,282667,1769,155
71329,2024,5,5,0,0,100,96860,1029,98
71330,2024,11,11,0,0,100,136282,1265,106
71332,2024,8,8,0,0,100,232442,1761,131
71333,2024,10,10,0,0,100,218011,1773,128
71334,2024,2,2,0,0,100,149500,2212,69
71335,2024,1,1,0,0,100,201000,2233,90
71336,2024,21,21,0,0,100,161849,1515,109
71337,2024,6,6,0,0,100,244267,2286,109
71338,2024,3,3,0,0,100,147000,1006,147
71339,2024,2,2,0,0,100,140250,1026,126
71340,2024,25,25,0,0,100,115736,1224,96
71341,2024,4,4,0,0,100,208855,1887,99
71342,2024,139,79,60,43,57,113996,1500,77
71343,2024,5,5,0,0,100,128900,1163,108
71344,2024,1,1,0,0,100,443000,4027,110
71345,2024,5,5,0,0,100,239350,2283,104
71346,2024,14,14,0,0,100,107473,1113,98
71347,2024,4,4,0,0,100,97250,1223,75
71348,2024,2,2,0,0,100,94000,1237,74
71349,2024,3,3,0,0,100,146317,1256,96
71350,2024,4,4,0,0,100,175501,2338,80
71351,2024,32,27,5,16,84,152941,1518,97
71352,2024,3,3,0,0,100,174893,1287,136
71353,2024,6,6,0,0,100,177867,1592,111
71354,2024,6,6,0,0,100,70846,1014,78
71355,2024,4,4,0,0,100,118250,1626,72
71356,2024,5,5,0,0,100,89638,1200,68
71357,2024,4,4,0,0,100,114715,1482,79
71358,2024,2,2,0,0,100,325654,1945,165
71359,2024,4,4,0,0,100,221690,1744,137
71360,2024,16,12,4,25,75,194032,2048,95
71361,2024,1,1,0,0,100,128600,2572,50
71362,2024,2,2,0,0,100,239500,2192,110
71363,2024,3,3,0,0,100,118433,1694,69
71364,2024,3,3,0,0,100,259600,1722,141
71365,2024,3,3,0,0,100,235935,3292,71
71366,2024,6,6,0,0,100,221237,1686,142
71367,2024,6,6,0,0,100,146200,1574,108
71368,2024,4,4,0,0,100,186484,1488,126
71369,2024,2,2,0,0,100,179500,2672,66
71370,2024,8,8,0,0,100,87708,825,104
71371,2024,19,17,2,11,89,222815,2318,97
71372,2024,19,18,1,5,95,188588,2019,97
71373,2024,23,22,1,4,96,137315,1367,105
71374,2024,1,1,0,0,100,38000,1267,30
71376,2024,5,5,0,0,100,97632,1035,94
71378,2024,16,16,0,0,100,202281,2092,104
71379,2024,19,19,0,0,100,129986,1355,98
71380,2024,8,8,0,0,100,219029,1720,127
71381,2024,1,1,0,0,100,245000,2269,108
71382,2024,8,8,0,0,100,152936,1353,112
71383,2024,4,4,0,0,100,109168,1637,68
71384,2024,2,2,0,0,100,150618,1116,140
71385,2024,6,6,0,0,100,425283,3757,108
71386,2024,1,1,0,0,100,100000,1136,88
71387,2024,4,4,0,0,100,191050,1570,117
71388,2024,9,9,0,0,100,152026,1513,107
71389,2024,6,6,0,0,100,73333,812,89
71390,2024,11,11,0,0,100,120757,1196,101
71391,2024,5,5,0,0,100,91360,1096,82
71392,2024,4,4,0,0,100,193270,1768,109
71393,2024,5,5,0,0,100,158550,1344,110
71394,2024,6,6,0,0,100,162450,1857,89
71395,2024,4,4,0,0,100,126989,2114,82
71396,2024,9,9,0,0,100,133000,1341,106
71397,2024,3,3,0,0,100,247633,2572,96
71398,2024,9,9,0,0,100,240372,2110,114
71399,2024,4,4,0,0,100,144000,1555,101
71400,2024,1,1,0,0,100,50000,1020,49
71401,2024,4,4,0,0,100,123275,1075,105
71402,2024,10,10,0,0,100,194583,2081,89
71403,2024,1,1,0,0,100,341700,2058,166
71404,2024,10,9,1,10,90,223496,1986,118
71405,2024,1,1,0,0,100,137500,1375,100
71406,2024,2,2,0,0,100,132500,994,184
71407,2024,2,2,0,0,100,161555,1456,129
71408,2024,2,2,0,0,100,74550,980,75
71409,2024,6,6,0,0,100,135858,1204,108
71410,2024,9,9,0,0,100,112444,1413,83
71412,2024,11,11,0,0,100,223326,2095,106
71413,2024,4,4,0,0,100,88625,1098,79
71414,2024,4,4,0,0,100,131500,1307,98
71415,2024,1,1,0,0,100,125000,893,140
71416,2024,6,5,1,17,83,160633,2264,87
71417,2024,12,11,1,8,92,130435,1400,95
71419,2024,34,31,3,9,91,175938,1688,107
71420,2024,25,22,3,12,88,162200,1834,91
71422,2024,1,1,0,0,100,229435,1995,115
71423,2024,7,7,0,0,100,204266,1725,126
71424,2024,4,4,0,0,100,176816,1275,117
71425,2024,2,2,0,0,100,160325,1150,143
71426,2024,3,3,0,0,100,155300,1537,84
71428,2024,11,11,0,0,100,127136,1230,111
71430,2024,4,4,0,0,100,192350,1813,109
71431,2024,3,3,0,0,100,194844,1378,141
71433,2024,12,12,0,0,100,163020,1078,157
71434,2024,5,5,0,0,100,126840,1001,124
71435,2024,2,2,0,0,100,108100,1345,86
71436,2024,5,4,1,20,80,153828,1462,107
71437,2024,3,3,0,0,100,96823,1038,92
71438,2024,9,9,0,0,100,156770,1141,127
71439,2024,8,8,0,0,100,186811,1770,106
71440,2024,4,4,0,0,100,146022,1301,126
71441,2024,1,1,0,0,100,207750,1960,106
71442,2024,17,17,0,0,100,224539,1737,121
71443,2024,11,11,0,0,100,280326,2197,137
71444,2024,9,9,0,0,100,214101,1635,140
71445,2024,43,31,12,28,72,172326,1778,95
71446,2024,4,4,0,0,100,123302,1231,82
71447,2024,3,3,0,0,100,220463,1721,127
71448,2024,10,9,1,10,90,225890,2162,106
71449,2024,1,1,0,0,100,60000,741,81
71450,2024,2,2,0,0,100,95000,1018,88
71451,2024,1,1,0,0,100,172000,1274,135
71452,2024,1,1,0,0,100,166300,1109,150
71453,2024,3,3,0,0,100,196400,1031,152
71455,2024,1,1,0,0,100,212060,3213,66
71456,2024,19,19,0,0,100,165143,1524,110
71457,2024,2,2,0,0,100,186250,1589,114
71458,2024,2,2,0,0,100,115500,1924,62
71459,2024,3,3,0,0,100,218000,2207,97
71460,2024,8,8,0,0,100,203323,2156,99
71462,2024,5,5,0,0,100,155900,1627,96
71463,2024,5,5,0,0,100,163720,1345,118
71464,2024,2,2,0,0,100,70000,1442,47
71465,2024,3,3,0,0,100,198910,1460,137
71466,2024,2,2,0,0,100,94872,1329,72
71468,2024,5,5,0,0,100,247000,2055,123
71469,2024,2,2,0,0,100,52500,745,71
71470,2024,5,5,0,0,100,136300,1401,102
71471,2024,1,1,0,0,100,361000,2407,150
71472,2024,4,4,0,0,100,120984,1146,78
71473,2024,3,3,0,0,100,183833,1134,145
71474,2024,2,2,0,0,100,225000,1236,152
71475,2024,62,52,10,16,84,192507,2008,96
71477,2024,3,3,0,0,100,265900,2878,95
71478,2024,3,3,0,0,100,105000,1022,96
71479,2024,18,18,0,0,100,154288,1466,104
71480,2024,11,11,0,0,100,136927,1240,97
71481,2024,10,10,0,0,100,169087,1901,91
71482,2024,3,3,0,0,100,104867,1026,94
71483,2024,3,3,0,0,100,200150,1860,111
71484,2024,16,16,0,0,100,161575,1805,93
71485,2024,3,3,0,0,100,145333,1334,105
71486,2024,102,98,4,4,96,110270,1271,90
71487,2024,1,1,0,0,100,235000,2670,88
71488,2024,2,2,0,0,100,271875,1706,162
71489,2024,8,8,0,0,100,168862,1706,93
71490,2024,10,10,0,0,100,130247,1191,108
71491,2024,13,12,1,8,92,158433,1404,111
71493,2024,2,2,0,0,100,112500,792,132
71494,2024,5,5,0,0,100,250660,1915,135
71495,2024,7,7,0,0,100,159035,1862,85
71497,2024,14,12,2,14,86,267686,2327,120
71498,2024,1,1,0,0,100,150000,1807,83
71499,2024,45,45,0,0,100,107019,1178,89
71500,2024,3,3,0,0,100,272200,1247,212
71501,2024,4,4,0,0,100,255000,2908,79
71502,2024,11,11,0,0,100,226767,2106,109
71503,2024,2,2,0,0,100,46500,892,50
71506,2024,9,9,0,0,100,172461,1613,113
71507,2024,1,1,0,0,100,65000,1444,45
71508,2024,8,8,0,0,100,146438,1695,85
71509,2024,4,4,0,0,100,88000,998,105
71510,2024,3,3,0,0,100,110642,1393,83
71512,2024,34,31,3,9,91,128649,1488,86
71513,2024,9,9,0,0,100,189744,1957,98
71514,2024,6,6,0,0,100,142683,1361,110
71515,2024,1,1,0,0,100,130000,1444,90
71516,2024,10,10,0,0,100,214900,1786,120
71517,2024,5,5,0,0,100,183434,1352,129
71518,2024,3,3,0,0,100,323267,2712,120
71520,2024,3,3,0,0,100,102587,1203,95
71521,2024,9,9,0,0,100,146781,1480,109
71522,2024,16,16,0,0,100,209330,1650,131
71523,2024,17,17,0,0,100,146852,1554,96
71524,2024,2,2,0,0,100,170800,1095,156
71525,2024,8,8,0,0,100,208694,1574,127
71526,2024,1,1,0,0,100,37000,536,69
71527,2024,8,8,0,0,100,131038,1257,104
71528,2024,27,27,0,0,100,131420,1716,82
71529,2024,2,2,0,0,100,126250,952,148
71530,2024,8,8,0,0,100,104625,1212,84
71531,2024,1,1,0,0,100,200000,1786,112
71533,2024,9,9,0,0,100,151126,1574,101
71534,2024,1,1,0,0,100,92000,1082,85
71535,2024,1,1,0,0,100,212800,2107,101
71537,2024,5,5,0,0,100,84488,1221,68
71538,2024,5,5,0,0,100,168556,1695,103
71539,2024,1,1,0,0,100,48000,960,50
71540,2024,9,9,0,0,100,135728,1422,96
71541,2024,3,3,0,0,100,93333,1165,79
71542,2024,18,15,3,17,83,100114,1248,78
71543,2024,86,49,37,43,57,112635,1407,80
71544,2024,3,3,0,0,100,102667,1083,91
71545,2024,5,5,0,0,100,189940,1644,126
71546,2024,4,4,0,0,100,118550,1894,67
71547,2024,4,4,0,0,100,196000,1378,130
71548,2024,3,3,0,0,100,203533,1910,104
71549,2024,3,3,0,0,100,84667,860,99
71550,2024,15,15,0,0,100,138127,1390,100
71551,2024,1,1,0,0,100,380000,2375,160
71552,2024,4,4,0,0,100,105500,974,98
71553,2024,2,2,0,0,100,70500,1068,62
71554,2024,6,6,0,0,100,95930,1027,93
71555,2024,17,17,0,0,100,186010,1767,107
71556,2024,5,4,1,20,80,149400,1906,80
71557,2024,7,7,0,0,100,123818,1287,96
71558,2024,12,12,0,0,100,142083,1530,99
71559,2024,6,6,0,0,100,149542,1529,96
71561,2024,4,4,0,0,100,145375,1676,99
71562,2024,2,2,0,0,100,220125,1472,148
71563,2024,2,2,0,0,100,120200,1046,115
71564,2024,9,9,0,0,100,130311,1521,82
71565,2024,6,6,0,0,100,114383,1441,80
71566,2024,9,8,1,11,89,126033,1207,123
71567,2024,1,1,0,0,100,322129,2369,136
71568,2024,1,1,0,0,100,168000,1474,114
71570,2024,3,3,0,0,100,149700,1330,97
71571,2024,1,1,0,0,100,189000,2333,81
71573,2024,3,3,0,0,100,133837,956,142
71574,2024,9,8,1,11,89,233367,2284,96
71576,2024,5,5,0,0,100,129400,1314,106
71577,2024,2,2,0,0,100,177770,1429,128
71578,2024,7,7,0,0,100,116376,1319,88
71579,2024,1,1,0,0,100,190000,1712,111
71580,2024,3,3,0,0,100,148167,1272,116
71581,2024,2,2,0,0,100,70000,534,132
71582,2024,6,6,0,0,100,204237,1624,112
71583,2024,7,7,0,0,100,245429,2244,113
71584,2024,5,5,0,0,100,212440,1870,110
71585,2024,8,6,2,25,75,197296,1831,104
71586,2024,4,4,0,0,100,115000,717,140
71588,2024,11,11,0,0,100,226015,1726,130
71589,2024,6,6,0,0,100,83510,948,83
71590,2024,8,8,0,0,100,207119,1793,115
71591,2024,4,3,1,25,75,191941,1726,114
72001,2024,6,6,0,0,100,248360,2192,115
72002,2024,2,2,0,0,100,288300,1696,157
72003,2024,95,60,35,37,63,125814,1568,80
72004,2024,5,5,0,0,100,154500,1336,116
72005,2024,14,14,0,0,100,159379,1364,122
72006,2024,20,20,0,0,100,145245,1535,91
72007,2024,3,3,0,0,100,216667,1820,120
72008,2024,67,67,0,0,100,173419,1913,94
72009,2024,4,4,0,0,100,113250,1062,105
72010,2024,1,1,0,0,100,45000,682,66
72011,2024,3,3,0,0,100,76833,874,92
72012,2024,9,9,0,0,100,60390,842,73
72013,2024,34,34,0,0,100,96106,1278,85
72016,2024,22,22,0,0,100,123525,1475,93
72017,2024,4,4,0,0,100,226250,1950,115
72018,2024,2,2,0,0,100,54500,684,90
72019,2024,4,4,0,0,100,127250,1309,96
72020,2024,7,7,0,0,100,119029,1265,89
72021,2024,9,9,0,0,100,130922,1514,107
72022,2024,9,9,0,0,100,121044,1603,85
72023,2024,22,22,0,0,100,116568,1314,93
72024,2024,35,35,0,0,100,207265,1983,105
72025,2024,19,19,0,0,100,157564,1646,102
72026,2024,12,12,0,0,100,170333,1978,87
72027,2024,4,4,0,0,100,101000,984,109
72028,2024,5,5,0,0,100,108800,1006,106
72029,2024,33,32,1,3,97,106270,1197,86
72031,2024,8,8,0,0,100,89062,1116,77
72032,2024,9,9,0,0,100,111994,1038,101
72034,2024,2,2,0,0,100,126000,1890,66
72035,2024,36,35,1,3,97,101818,1190,84
72037,2024,4,4,0,0,100,146900,1056,141
72038,2024,10,10,0,0,100,86185,1104,79
72039,2024,58,57,1,2,98,107563,1233,87
72041,2024,4,4,0,0,100,204500,1536,136
72042,2024,28,28,0,0,100,134364,1360,103
72043,2024,2,2,0,0,100,47500,1104,44
72044,2024,4,4,0,0,100,179500,2198,90
72045,2024,8,8,0,0,100,146906,1386,104
72046,2024,20,20,0,0,100,126650,1365,95
72047,2024,18,18,0,0,100,195277,1710,113
72048,2024,2,2,0,0,100,106350,1086,97
72049,2024,2,2,0,0,100,95000,1303,72
72050,2024,14,13,1,7,93,102643,1096,93
72051,2024,37,37,0,0,100,186335,1698,110
72052,2024,13,13,0,0,100,75262,1208,63
72053,2024,12,12,0,0,100,171667,1587,110
72054,2024,14,13,1,7,93,158964,1594,101
72056,2024,8,8,0,0,100,134246,1451,95
72058,2024,51,51,0,0,100,241825,2094,116
72059,2024,5,5,0,0,100,91600,1090,83
72060,2024,2,2,0,0,100,43000,578,75
72061,2024,13,13,0,0,100,123962,1325,93
72062,2024,12,12,0,0,100,139208,1330,104
72064,2024,5,4,1,20,80,109200,1409,82
72065,2024,17,17,0,0,100,255772,2289,116
72066,2024,2,2,0,0,100,121250,1284,87
72067,2024,7,7,0,0,100,170643,1749,101
72068,2024,21,20,1,5,95,87953,1201,81
72070,2024,1,1,0,0,100,426000,2662,160
72071,2024,85,82,3,4,96,118168,1337,90
72072,2024,3,3,0,0,100,116000,1218,92
72073,2024,11,11,0,0,100,170218,1666,104
72074,2024,3,3,0,0,100,53667,865,64
72075,2024,6,6,0,0,100,139667,1342,109
72076,2024,2,2,0,0,100,178000,1565,112
72077,2024,6,6,0,0,100,90733,880,94
72078,2024,1,1,0,0,100,141000,1102,128
72079,2024,1,1,0,0,100,150000,987,152
72080,2024,17,17,0,0,100,206741,1852,111
72083,2024,2,2,0,0,100,206000,1094,186
72084,2024,16,16,0,0,100,136888,1482,90
72085,2024,5,5,0,0,100,95570,1347,80
72086,2024,1,1,0,0,100,52804,733,72
72087,2024,5,5,0,0,100,109400,835,123
72088,2024,4,4,0,0,100,75125,774,80
72089,2024,17,17,0,0,100,128906,1490,91
72090,2024,48,48,0,0,100,116320,1479,79
72091,2024,5,5,0,0,100,140100,1201,127
72093,2024,9,9,0,0,100,215667,1753,123
72094,2024,9,9,0,0,100,65944,857,77
72095,2024,61,43,18,30,70,184195,1890,96
72096,2024,14,14,0,0,100,188160,1698,106
72098,2024,9,9,0,0,100,148046,1216,119
72099,2024,10,10,0,0,100,172000,1500,120
72100,2024,5,5,0,0,100,145000,1553,98
72101,2024,11,11,0,0,100,137409,1720,80
72103,2024,9,9,0,0,100,86904,1051,78
72104,2024,7,7,0,0,100,122929,1257,94
72105,2024,5,5,0,0,100,90400,1014,87
72106,2024,3,3,0,0,100,212333,2269,96
72107,2024,5,5,0,0,100,195015,2535,67
72109,2024,5,5,0,0,100,162700,1316,113
72110,2024,10,10,0,0,100,154440,1538,99
72111,2024,7,7,0,0,100,156679,1685,99
72112,2024,6,6,0,0,100,102817,1315,84
72113,2024,5,5,0,0,100,170300,1636,107
72114,2024,2,2,0,0,100,134500,1126,124
72115,2024,8,8,0,0,100,113688,1270,95
72118,2024,32,32,0,0,100,116002,1259,90
72119,2024,10,10,0,0,100,174700,1728,94
72120,2024,2,2,0,0,100,197650,1816,110
72121,2024,6,6,0,0,100,97462,1279,76
72122,2024,9,9,0,0,100,156444,1442,111
72123,2024,1,1,0,0,100,119000,1676,71
72124,2024,35,35,0,0,100,173863,1671,108
72125,2024,3,3,0,0,100,118833,1410,79
72126,2024,8,8,0,0,100,88312,1140,96
72127,2024,27,27,0,0,100,190722,1922,97
72128,2024,10,10,0,0,100,127550,1079,112
72129,2024,7,7,0,0,100,199440,1921,105
72130,2024,6,6,0,0,100,195500,1730,121
72131,2024,11,11,0,0,100,125191,1405,87
72132,2024,102,77,25,25,75,147741,1718,90
72133,2024,8,8,0,0,100,218562,1864,117
72134,2024,7,7,0,0,100,119929,1208,106
72135,2024,9,9,0,0,100,103056,1090,99
72136,2024,1,1,0,0,100,90000,1000,90
72137,2024,26,26,0,0,100,171645,1544,119
72138,2024,46,44,2,4,96,103556,1230,88
72139,2024,8,8,0,0,100,124488,1301,95
72141,2024,10,10,0,0,100,141200,1612,90
72142,2024,4,4,0,0,100,87000,888,85
72143,2024,26,26,0,0,100,115615,1321,89
72144,2024,11,11,0,0,100,105909,1431,72
72145,2024,2,2,0,0,100,209500,1218,173
72146,2024,22,21,1,5,95,175329,1756,102
72147,2024,18,18,0,0,100,161000,1905,90
72148,2024,1,1,0,0,100,140000,2000,70
72149,2024,7,7,0,0,100,101029,1116,86
72150,2024,15,15,0,0,100,164967,1639,102
72151,2024,14,14,0,0,100,140877,1436,100
72152,2024,6,6,0,0,100,220775,1430,139
72153,2024,3,3,0,0,100,114967,1970,64
72154,2024,137,129,8,6,94,176789,1788,101
72155,2024,22,22,0,0,100,209995,1902,115
72156,2024,8,8,0,0,100,135249,1318,108
72157,2024,12,12,0,0,100,250867,1895,139
72158,2024,9,9,0,0,100,123639,1470,84
72160,2024,8,8,0,0,100,122075,1927,72
72161,2024,10,10,0,0,100,99410,1136,92
72163,2024,6,6,0,0,100,154167,1267,119
72164,2024,2,2,0,0,100,75500,984,74
72165,2024,23,23,0,0,100,166004,1746,99
72166,2024,3,3,0,0,100,111417,1432,77
72167,2024,8,8,0,0,100,133438,1431,92
72168,2024,22,22,0,0,100,130610,1351,97
72169,2024,17,17,0,0,100,197818,1864,110
72170,2024,5,5,0,0,100,120900,1149,101
72171,2024,2,2,0,0,100,265250,2166,106
72172,2024,15,14,1,7,93,129807,1542,82
72173,2024,10,10,0,0,100,141510,1178,131
72174,2024,2,2,0,0,100,120000,904,134
72175,2024,14,14,0,0,100,115607,1370,90
72176,2024,50,50,0,0,100,105420,1247,86
72177,2024,2,2,0,0,100,145000,1330,105
72178,2024,3,3,0,0,100,90500,1096,79
72179,2024,27,26,1,4,96,92185,1248,74
72180,2024,64,58,6,9,91,96298,1096,90
72181,2024,2061,964,1097,53,47,149870,2076,73
72182,2024,18,18,0,0,100,122361,1381,89
72183,2024,15,15,0,0,100,118207,1451,87
72184,2024,1,1,0,0,100,130000,1667,78
72185,2024,7,7,0,0,100,143543,1537,88
72186,2024,4,4,0,0,100,125750,1296,92
72187,2024,11,11,0,0,100,101500,1214,76
72189,2024,30,30,0,0,100,97026,1088,90
72190,2024,2,2,0,0,100,162500,1614,100
72191,2024,41,41,0,0,100,135259,1360,99
72192,2024,1,1,0,0,100,114000,1036,110
72193,2024,9,9,0,0,100,108533,854,123
72194,2024,3,3,0,0,100,133167,1423,93
72195,2024,12,12,0,0,100,114792,1421,99
72196,2024,7,7,0,0,100,94661,1130,90
72197,2024,7,7,0,0,100,84886,954,88
72198,2024,29,28,1,3,97,237741,2168,110
72199,2024,1,1,0,0,100,210000,1721,122
72200,2024,38,38,0,0,100,194434,1905,103
72201,2024,3,3,0,0,100,136167,1111,123
72202,2024,4,4,0,0,100,86500,856,96
72204,2024,10,10,0,0,100,123100,1117,107
72205,2024,15,14,1,7,93,145770,1392,98
72208,2024,3,3,0,0,100,148333,1135,133
72209,2024,5,5,0,0,100,104200,992,108
72210,2024,5,5,0,0,100,78000,783,98
72211,2024,16,16,0,0,100,103664,1289,83
72212,2024,5,5,0,0,100,80900,957,89
72213,2024,44,44,0,0,100,189169,1892,101
72214,2024,1,1,0,0,100,260000,1625,160
72215,2024,11,11,0,0,100,88409,1106,84
72216,2024,10,10,0,0,100,158244,1361,121
72217,2024,30,30,0,0,100,233439,1802,126
72218,2024,4,4,0,0,100,78500,1100,70
72219,2024,11,11,0,0,100,90905,1012,93
72220,2024,7,7,0,0,100,75071,993,77
72221,2024,6,6,0,0,100,141167,1495,105
72223,2024,40,40,0,0,100,110717,1374,88
72224,2024,9,9,0,0,100,124467,1494,84
72225,2024,10,10,0,0,100,99490,1148,96
72226,2024,13,13,0,0,100,110662,1275,91
72228,2024,19,19,0,0,100,104860,1246,87
72229,2024,5,5,0,0,100,52640,644,86
72230,2024,10,10,0,0,100,171910,1548,108
72231,2024,48,48,0,0,100,195574,1840,107
72232,2024,8,8,0,0,100,155536,1558,106
72233,2024,1,1,0,0,100,120000,1053,114
72234,2024,5,5,0,0,100,100942,973,112
72236,2024,4,4,0,0,100,143000,1560,92
72237,2024,4,4,0,0,100,133054,1376,99
72239,2024,9,9,0,0,100,106037,1013,105
72241,2024,37,36,1,3,97,134643,1579,87
72243,2024,11,11,0,0,100,137818,1286,106
72244,2024,39,37,2,5,95,212955,1872,102
72245,2024,5,5,0,0,100,168400,1791,93
72246,2024,4,4,0,0,100,213250,1886,116
72247,2024,8,8,0,0,100,186125,1822,100
72248,2024,9,9,0,0,100,149056,1365,108
72249,2024,9,9,0,0,100,217889,2040,110
72250,2024,3,3,0,0,100,161667,1044,146
72251,2024,7,7,0,0,100,66463,751,82
72252,2024,14,14,0,0,100,120071,1151,112
72253,2024,17,17,0,0,100,160824,1747,92
72254,2024,5,5,0,0,100,45700,553,85
72255,2024,10,10,0,0,100,118500,1085,105
72256,2024,6,6,0,0,100,157500,1307,112
72257,2024,20,18,2,10,90,311996,2592,116
72259,2024,4,4,0,0,100,97000,1388,75
72260,2024,25,22,3,12,88,203768,2049,102
72261,2024,3,3,0,0,100,147167,1291,117
72262,2024,39,39,0,0,100,94692,1181,80
72264,2024,108,82,26,24,76,122872,1410,88
72265,2024,1,1,0,0,100,131707,4249,31
72266,2024,11,11,0,0,100,99668,1430,78
72267,2024,17,17,0,0,100,125824,1359,96
72268,2024,4,2,2,50,50,85833,1629,54
72269,2024,46,43,3,7,93,75435,946,84
72270,2024,2,2,0,0,100,157500,861,182
72271,2024,11,11,0,0,100,148890,1514,102
72272,2024,4,4,0,0,100,112750,1108,97
72273,2024,2,2,0,0,100,65750,1782,41
72275,2024,13,13,0,0,100,171846,1839,93
72276,2024,24,24,0,0,100,114503,1220,92
72277,2024,1,1,0,0,100,315000,1770,178
72278,2024,13,13,0,0,100,112631,1193,96
72279,2024,5,5,0,0,100,157116,1672,91
72280,2024,14,14,0,0,100,183714,2024,92
72281,2024,3,3,0,0,100,37542,451,87
72282,2024,5,5,0,0,100,83378,1211,70
72283,2024,4,4,0,0,100,56625,867,67
72286,2024,5,5,0,0,100,120300,1115,117
72287,2024,7,7,0,0,100,220071,1995,115
72289,2024,32,32,0,0,100,137881,1595,88
72290,2024,16,16,0,0,100,191414,1751,107
72291,2024,9,9,0,0,100,131111,1467,98
72292,2024,1,1,0,0,100,65000,670,97
72293,2024,4,4,0,0,100,81625,1227,58
72294,2024,9,9,0,0,100,79612,1036,76
72295,2024,8,8,0,0,100,119607,986,123
72296,2024,17,17,0,0,100,143280,1223,108
72297,2024,7,7,0,0,100,122229,1321,98
72298,2024,2,2,0,0,100,165000,1123,160
72299,2024,21,21,0,0,100,129876,1324,104
72300,2024,18,18,0,0,100,129454,1786,74
72302,2024,1,1,0,0,100,87500,1182,74
72303,2024,9,9,0,0,100,114111,1551,80
72305,2024,13,13,0,0,100,149157,1542,93
72306,2024,12,12,0,0,100,156917,1406,110
72308,2024,19,19,0,0,100,159953,1684,96
72309,2024,5,5,0,0,100,99080,921,102
72310,2024,19,19,0,0,100,275729,2251,127
72311,2024,6,6,0,0,100,122417,1537,85
72312,2024,5,5,0,0,100,95000,1196,78
72313,2024,4,4,0,0,100,86825,1136,78
72314,2024,7,7,0,0,100,69857,784,78
72315,2024,8,8,0,0,100,71500,747,102
72316,2024,6,6,0,0,100,128217,1344,96
72317,2024,7,7,0,0,100,139329,1129,117
72319,2024,9,9,0,0,100,113925,1494,75
72320,2024,11,11,0,0,100,294642,2254,130
72321,2024,10,10,0,0,100,121210,1248,104
72322,2024,8,8,0,0,100,85000,1253,72
72323,2024,6,6,0,0,100,130417,1919,78
72324,2024,4,4,0,0,100,128750,1366,90
72325,2024,5,5,0,0,100,142300,1078,143
72326,2024,4,4,0,0,100,90875,1207,73
72327,2024,3,3,0,0,100,82667,811,96
72328,2024,25,25,0,0,100,286289,2435,120
72329,2024,40,40,0,0,100,188902,1954,96
72330,2024,8,8,0,0,100,92812,1073,87
72331,2024,7,7,0,0,100,116209,1311,84
72332,2024,8,8,0,0,100,130906,1264,102
72333,2024,1,1,0,0,100,74700,1167,64
72334,2024,24,24,0,0,100,97903,1173,84
72335,2024,18,18,0,0,100,162250,1770,92
72336,2024,14,14,0,0,100,170866,1662,101
72337,2024,13,13,0,0,100,112008,1150,91
72338,2024,8,8,0,0,100,236394,1885,128
72339,2024,11,11,0,0,100,130455,1570,82
72340,2024,14,14,0,0,100,174193,1727,103
72341,2024,17,17,0,0,100,178359,1573,117
72343,2024,3,3,0,0,100,82800,564,132
72344,2024,28,28,0,0,100,210910,2118,105
72345,2024,3,3,0,0,100,105667,1174,95
72346,2024,53,50,3,6,94,141010,1604,89
72347,2024,5,5,0,0,100,133000,1106,119
72348,2024,1,1,0,0,100,25000,568,44
72349,2024,5,5,0,0,100,95400,826,117
72350,2024,36,36,0,0,100,216338,1945,115
72351,2024,9,9,0,0,100,98537,1480,67
72352,2024,2,2,0,0,100,92500,1173,67
72353,2024,3,3,0,0,100,193124,1999,99
72354,2024,2,2,0,0,100,145000,1436,98
72355,2024,2,2,0,0,100,55000,875,56
72356,2024,3,3,0,0,100,60333,737,75
72357,2024,5,5,0,0,100,131200,1657,77
72358,2024,10,10,0,0,100,130400,1870,90
72359,2024,16,16,0,0,100,184453,1652,108
72360,2024,13,13,0,0,100,223999,2209,102
72361,2024,9,9,0,0,100,118378,1220,96
72362,2024,3,3,0,0,100,159667,1998,88
72363,2024,16,16,0,0,100,116594,1446,80
72364,2024,27,27,0,0,100,100928,1270,79
72366,2024,9,9,0,0,100,101606,1405,88
72367,2024,10,10,0,0,100,130760,1031,128
72368,2024,8,8,0,0,100,118438,871,116
72369,2024,8,8,0,0,100,167750,1297,123
72370,2024,2,2,0,0,100,70125,892,78
72372,2024,2,2,0,0,100,50000,840,62
72373,2024,37,37,0,0,100,104608,1283,81
72374,2024,3,3,0,0,100,81000,1033,71
72375,2024,6,6,0,0,100,136333,1279,116
72376,2024,8,8,0,0,100,172612,1766,106
72377,2024,9,9,0,0,100,120086,1348,88
72378,2024,17,17,0,0,100,161824,1413,114
72379,2024,1,1,0,0,100,57000,460,124
72380,2024,8,8,0,0,100,121925,1475,88
72381,2024,7,7,0,0,100,296831,1733,165
72382,2024,15,15,0,0,100,140467,1409,96
72385,2024,13,13,0,0,100,134291,1696,88
72386,2024,31,31,0,0,100,247981,1943,126
73001,2024,7,4,3,43,57,214419,3396,63
73003,2024,32,11,21,66,34,182329,2835,70
73004,2024,21,3,18,86,14,115234,2201,48
73005,2024,2,2,0,0,100,367465,3150,118
73006,2024,118,16,102,86,14,196573,4645,49
73007,2024,12,9,3,25,75,177246,3030,72
73008,2024,568,84,484,85,15,271210,4444,63
73010,2024,50,39,11,22,78,391022,3738,106
73011,2024,274,46,228,83,17,167975,2365,73
73012,2024,3,3,0,0,100,326567,4431,73
73013,2024,45,5,40,89,11,134426,2718,47
73014,2024,1,1,0,0,100,277000,3044,91
73015,2024,163,22,141,87,13,535793,10129,52
73017,2024,3,1,2,67,33,278887,3621,78
73018,2024,9,3,6,67,33,209398,2649,83
73019,2024,14,13,1,7,93,225177,2182,97
73020,2024,4,3,1,25,75,243988,3050,81
73021,2024,17,14,3,18,82,206736,2252,97
73022,2024,3,3,0,0,100,319650,2096,155
73023,2024,14,0,14,100,0,115040,3630,32
73024,2024,49,5,44,90,10,177133,4934,36
73025,2024,5,5,0,0,100,139500,2000,98
73026,2024,4,3,1,25,75,156928,1833,124
73027,2024,5,5,0,0,100,209060,2320,90
73028,2024,3,3,0,0,100,174740,1897,96
73029,2024,57,17,40,70,30,270125,3496,76
73030,2024,32,9,23,72,28,283741,3552,81
73031,2024,49,6,43,88,12,268200,3474,75
73032,2024,20,17,3,15,85,194713,2312,88
73033,2024,6,5,1,17,83,247653,2222,109
73034,2024,29,8,21,72,28,266159,4965,56
73036,2024,4,1,3,75,25,209250,2774,78
73039,2024,5,5,0,0,100,212050,2289,93
73040,2024,9,1,8,89,11,218471,4294,57
73041,2024,2,1,1,50,50,222750,2592,98
73042,2024,2,2,0,0,100,275080,1633,152
73043,2024,13,11,2,15,85,405510,3906,110
73047,2024,4,1,3,75,25,363152,7520,48
73048,2024,2,2,0,0,100,242462,2911,84
73049,2024,2,2,0,0,100,207292,2550,82
73050,2024,1,1,0,0,100,570000,9500,60
73051,2024,47,13,34,72,28,405865,4384,93
73052,2024,4,4,0,0,100,254130,2422,109
73053,2024,9,9,0,0,100,248420,2699,91
73054,2024,227,13,214,94,6,243937,5798,45
73055,2024,28,14,14,50,50,477828,5439,86
73057,2024,34,4,30,88,12,200915,4320,49
73058,2024,9,5,4,44,56,150622,1598,93
73059,2024,25,18,7,28,72,595829,6410,98
73061,2024,3,3,0,0,100,322588,2740,129
73063,2024,7,7,0,0,100,162341,2081,74
73064,2024,78,24,54,69,31,289524,3504,83
73065,2024,754,86,668,89,11,211150,3074,70
73067,2024,17,5,12,71,29,177635,2166,81
73068,2024,2,1,1,50,50,261910,3824,64
73069,2024,7,6,1,14,86,254271,2492,104
73070,2024,5,5,0,0,100,199686,2316,85
73071,2024,27,7,20,74,26,379724,5932,58
73072,2024,2,2,0,0,100,286740,2311,92
73073,2024,10,9,1,10,90,299908,3535,97
73074,2024,6,6,0,0,100,152330,1874,81
73075,2024,4,4,0,0,100,338138,3553,96
73076,2024,3,3,0,0,100,606153,3738,151
73077,2024,3,2,1,33,67,505800,4475,138
73079,2024,8,8,0,0,100,230828,2165,111
73081,2024,9,6,3,33,67,183372,2626,80
73082,2024,5,2,3,60,40,227044,3360,72
73083,2024,4,3,1,25,75,147212,2031,71
73084,2024,8,8,0,0,100,226066,2736,88
73085,2024,15,12,3,20,80,282429,3408,92
73086,2024,3,3,0,0,100,327671,3500,94
73087,2024,82,11,71,87,13,211146,3061,72
73088,2024,15,5,10,67,33,308850,5700,48
73089,2024,6,6,0,0,100,375082,3482,108
73090,2024,2,1,1,50,50,161340,1964,88
73091,2024,1,1,0,0,100,480000,6575,73
73092,2024,4,3,1,25,75,202502,2768,100
73094,2024,10,4,6,60,40,349334,6092,53
73095,2024,5,4,1,20,80,295026,3109,97
73096,2024,11,8,3,27,73,220865,2351,92
73097,2024,2,2,0,0,100,273645,1822,165
73098,2024,12,6,6,50,50,269699,4429,64
73099,2024,4,4,0,0,100,169320,2188,70
73100,2024,13,12,1,8,92,317942,2826,108
73101,2024,4,4,0,0,100,205162,2189,85
73103,2024,29,12,17,59,41,318639,4083,78
73104,2024,2,2,0,0,100,622665,3996,174
73105,2024,13,10,3,23,77,180463,2169,86
73106,2024,7,7,0,0,100,191640,1962,94
73107,2024,9,8,1,11,89,158167,2399,67
73109,2024,8,8,0,0,100,152688,1807,92
73110,2024,6,5,1,17,83,133690,1839,72
73114,2024,13,3,10,77,23,157616,3961,41
73116,2024,70,6,64,91,9,143008,3644,38
73117,2024,2,0,2,100,0,58500,926,61
73119,2024,2,2,0,0,100,155775,2252,56
73120,2024,1,1,0,0,100,218500,3973,55
73121,2024,13,8,5,38,62,286222,2856,100
73122,2024,3,3,0,0,100,299093,3168,102
73123,2024,24,2,22,92,8,184748,3828,48
73124,2024,29,20,9,31,69,310552,3248,96
73128,2024,52,33,19,37,63,406280,4547,90
73129,2024,22,17,5,23,77,215451,3136,87
73130,2024,18,14,4,22,78,247827,3049,84
73131,2024,6,4,2,33,67,231432,3072,100
73132,2024,72,5,67,93,7,330751,6838,45
73133,2024,3,2,1,33,67,255593,2431,110
73135,2024,10,7,3,30,70,187131,2712,72
73137,2024,47,11,36,77,23,276017,3856,75
73138,2024,8,6,2,25,75,205240,4768,49
73139,2024,6,6,0,0,100,96500,2079,46
73140,2024,2,2,0,0,100,262600,2517,113
73141,2024,7,5,2,29,71,265462,3242,84
73142,2024,24,9,15,62,38,334222,5676,59
73145,2024,2,2,0,0,100,511545,2460,204
73146,2024,3,2,1,33,67,208867,2910,73
73149,2024,2,2,0,0,100,203775,2655,79
73150,2024,274,22,252,92,8,189562,5271,37
73151,2024,26,20,6,23,77,316468,3781,85
73152,2024,2,2,0,0,100,294885,3041,94
73153,2024,13,10,3,23,77,295023,2720,103
73154,2024,28,16,12,43,57,274724,3081,95
73155,2024,30,20,10,33,67,398112,4312,94
73156,2024,1,1,0,0,100,361500,2781,130
73157,2024,111,10,101,91,9,115097,2489,53
73159,2024,4,3,1,25,75,213650,1904,114
73160,2024,5,4,1,20,80,492647,4738,105
73161,2024,6,5,1,17,83,232865,2964,73
73162,2024,7,7,0,0,100,220984,2478,99
73164,2024,10,6,4,40,60,375817,3839,103
73168,2024,3,3,0,0,100,189167,2106,93
73170,2024,3,2,1,33,67,269333,2637,103
73171,2024,25,4,21,84,16,197666,2573,76
73173,2024,9,7,2,22,78,188988,2125,82
73175,2024,3,3,0,0,100,234807,2378,99
73176,2024,60,7,53,88,12,398799,6347,60
73177,2024,3,3,0,0,100,125860,1684,80
73178,2024,3,3,0,0,100,392767,3590,109
73179,2024,126,43,83,66,34,309563,3628,85
73180,2024,5,5,0,0,100,276050,2774,106
73181,2024,40,4,36,90,10,143588,2191,62
73182,2024,18,13,5,28,72,449578,5094,89
73183,2024,8,5,3,38,62,294202,4135,82
73184,2024,3,2,1,33,67,377000,2187,170
73186,2024,44,6,38,86,14,192713,4813,38
73187,2024,29,19,10,34,66,177565,2399,69
73188,2024,7,7,0,0,100,253585,2125,114
73189,2024,3,2,1,33,67,118667,1329,87
73190,2024,7,4,3,43,57,100791,2311,46
73191,2024,16,15,1,6,94,330018,3422,98
73192,2024,4,4,0,0,100,297220,2885,107
73193,2024,1,1,0,0,100,697000,4076,171
73194,2024,29,11,18,62,38,134373,2850,49
73196,2024,6,3,3,50,50,298358,3334,92
73197,2024,25,5,20,80,20,237950,5486,45
73200,2024,5,4,1,20,80,259756,3026,89
73201,2024,7,6,1,14,86,222336,3407,68
73202,2024,3,3,0,0,100,462617,2800,136
73204,2024,23,10,13,57,43,156839,1955,79
73205,2024,2,2,0,0,100,189025,2016,87
73206,2024,28,4,24,86,14,235528,4909,50
73207,2024,3,3,0,0,100,254467,2924,81
73208,2024,13,10,3,23,77,511593,4725,108
73210,2024,3,3,0,0,100,345937,4014,89
73211,2024,12,11,1,8,92,240265,3267,77
73212,2024,17,11,6,35,65,178238,1984,92
73213,2024,90,26,64,71,29,257073,3333,78
73214,2024,1,1,0,0,100,250000,1389,180
73215,2024,45,28,17,38,62,209793,2436,85
73216,2024,3,3,0,0,100,287777,2907,100
73217,2024,3,2,1,33,67,297000,2966,106
73218,2024,8,5,3,38,62,280562,2223,128
73219,2024,7,4,3,43,57,404672,5310,81
73220,2024,10,8,2,20,80,206868,2228,96
73221,2024,1,0,1,100,0,74000,1057,70
73222,2024,55,29,26,47,53,424892,4091,98
73223,2024,7,5,2,29,71,181357,2469,73
73224,2024,5,4,1,20,80,277684,2761,91
73225,2024,26,17,9,35,65,403959,3660,110
73226,2024,19,16,3,16,84,227709,2307,102
73227,2024,94,14,80,85,15,671576,10589,62
73228,2024,6,4,2,33,67,364037,3811,92
73229,2024,3,3,0,0,100,177000,2251,81
73230,2024,9,3,6,67,33,108075,2209,51
73231,2024,12,10,2,17,83,155892,2110,73
73232,2024,18,11,7,39,61,509320,5800,80
73233,2024,3,3,0,0,100,247100,2742,109
73234,2024,3,1,2,67,33,111900,1754,62
73235,2024,80,7,73,91,9,148836,3730,38
73236,2024,36,25,11,31,69,225560,2526,90
73237,2024,7,7,0,0,100,224457,3160,72
73240,2024,4,4,0,0,100,379435,3298,134
73241,2024,12,11,1,8,92,250831,2461,114
73242,2024,37,3,34,92,8,136143,2951,46
73243,2024,10,8,2,20,80,375218,3806,100
73245,2024,10,10,0,0,100,273650,2481,121
73246,2024,1,1,0,0,100,276500,3072,90
73247,2024,9,9,0,0,100,203252,2483,76
73248,2024,79,15,64,81,19,150914,2024,76
73249,2024,30,9,21,70,30,317741,3666,87
73250,2024,14,12,2,14,86,214413,2470,89
73252,2024,3,3,0,0,100,248250,2725,91
73253,2024,5,4,1,20,80,301059,3389,92
73254,2024,2,2,0,0,100,266100,2028,132
73255,2024,13,13,0,0,100,197281,2175,93
73256,2024,6,5,1,17,83,111717,1866,66
73257,2024,273,29,244,89,11,316156,8124,38
73258,2024,9,7,2,22,78,112789,1542,79
73259,2024,3,3,0,0,100,208717,2033,116
73261,2024,17,9,8,47,53,128117,1776,71
73262,2024,7,3,4,57,43,368464,3901,80
73263,2024,10,10,0,0,100,462424,3960,124
73265,2024,5,3,2,40,60,319617,2885,113
73267,2024,7,4,3,43,57,212184,2672,76
73268,2024,5,4,1,20,80,110429,1795,57
73269,2024,4,4,0,0,100,361762,3075,114
73270,2024,40,22,18,45,55,202077,2621,80
73271,2024,2,2,0,0,100,184010,1632,104
73272,2024,2,2,0,0,100,140000,1784,96
73273,2024,6,5,1,17,83,305340,3920,78
73274,2024,10,9,1,10,90,231373,2734,85
73276,2024,4,4,0,0,100,234138,2478,92
73277,2024,2,2,0,0,100,60750,1159,51
73278,2024,15,12,3,20,80,236698,2784,89
73280,2024,42,5,37,88,12,136969,3734,37
73281,2024,1,1,0,0,100,357200,2977,120
73282,2024,4,4,0,0,100,284018,3588,84
73283,2024,5,3,2,40,60,209640,3032,70
73284,2024,8,5,3,38,62,211124,3030,67
73285,2024,19,8,11,58,42,296642,3768,80
73286,2024,8,6,2,25,75,310827,4291,77
73288,2024,11,6,5,45,55,399656,3829,106
73289,2024,6,6,0,0,100,186990,2130,83
73290,2024,54,5,49,91,9,188079,3686,50
73292,2024,4,4,0,0,100,368435,3441,110
73293,2024,8,8,0,0,100,319787,4278,91
73296,2024,163,2,161,99,1,352253,9290,37
73297,2024,5,5,0,0,100,444838,3271,141
73298,2024,9,7,2,22,78,259363,3482,83
73299,2024,2,2,0,0,100,198935,2278,82
73300,2024,30,19,11,37,63,578579,5590,97
73301,2024,10,7,3,30,70,400019,3800,106
73302,2024,1,0,1,100,0,237350,2498,95
73303,2024,49,25,24,49,51,207827,2743,73
73304,2024,80,0,80,100,0,421897,11896,34
73306,2024,79,7,72,91,9,268345,5508,45
73307,2024,74,6,68,92,8,131455,3547,38
73308,2024,5,5,0,0,100,296900,3089,94
73309,2024,3,3,0,0,100,330687,2910,112
73310,2024,5,5,0,0,100,330950,3392,99
73311,2024,4,4,0,0,100,198258,2224,99
73312,2024,8,8,0,0,100,357569,2797,130
73313,2024,5,4,1,20,80,363158,3866,97
73314,2024,3,3,0,0,100,313480,2688,117
73315,2024,3,3,0,0,100,225580,2033,107
73316,2024,3,2,1,33,67,166782,1745,96
73317,2024,31,8,23,74,26,322922,5554,67
73318,2024,92,1,91,99,1,65922,2425,26
73320,2024,7,6,1,14,86,217686,2483,83
73322,2024,31,3,28,90,10,122385,3143,40
73323,2024,1,0,1,100,0,345000,4012,86
73326,2024,10,7,3,30,70,363520,3558,105
73327,2024,5,5,0,0,100,242624,2100,112
73328,2024,25,15,10,40,60,379473,4201,91
73329,2024,24,15,9,38,62,370450,4319,91
73330,2024,31,23,8,26,74,200114,2364,93
74001,2024,45,14,31,69,31,232652,4255,52
74002,2024,15,6,9,60,40,309543,4037,79
74003,2024,9,4,5,56,44,652749,5936,111
74004,2024,4,3,1,25,75,212438,2177,100
74005,2024,49,40,9,18,82,413979,3999,102
74006,2024,26,5,21,81,19,384290,4676,86
74007,2024,24,14,10,42,58,401520,4491,95
74008,2024,114,7,107,94,6,235777,3885,60
74009,2024,4,2,2,50,50,402380,4214,95
74010,2024,1543,162,1381,90,10,371963,5379,69
74012,2024,529,17,512,97,3,217643,3465,64
74013,2024,22,18,4,18,82,504161,5352,95
74014,2024,167,16,151,90,10,241963,5153,43
74015,2024,6,5,1,17,83,439593,4012,112
74016,2024,41,20,21,51,49,521973,5188,100
74018,2024,22,15,7,32,68,418371,4245,100
74019,2024,34,10,24,71,29,473984,6083,79
74020,2024,6,6,0,0,100,439582,4266,111
74021,2024,15,12,3,20,80,508305,4810,113
74024,2024,25,16,9,36,64,312180,3607,96
74025,2024,16,11,5,31,69,387613,3481,113
74026,2024,60,24,36,60,40,352439,4419,80
74027,2024,2,2,0,0,100,492505,4938,92
74029,2024,2,2,0,0,100,213000,1690,108
74030,2024,4,4,0,0,100,377500,2264,155
74031,2024,35,13,22,63,37,443474,4876,89
74032,2024,22,4,18,82,18,119787,2869,42
74033,2024,38,20,18,47,53,289144,4535,63
74034,2024,35,12,23,66,34,208598,3218,56
74035,2024,2,2,0,0,100,252325,3028,101
74036,2024,1,0,1,100,0,424000,7709,55
74037,2024,25,15,10,40,60,320250,3723,86
74038,2024,16,6,10,62,38,149028,3120,47
74040,2024,44,27,17,39,61,381891,4366,95
74041,2024,2,2,0,0,100,438742,7633,66
74042,2024,164,35,129,79,21,221825,3323,70
74043,2024,45,21,24,53,47,344558,4351,82
74044,2024,17,9,8,47,53,647780,5834,107
74045,2024,4,4,0,0,100,279900,4537,59
74046,2024,2,2,0,0,100,284850,3902,73
74048,2024,10,8,2,20,80,441305,4696,115
74049,2024,13,10,3,23,77,262578,4698,59
74050,2024,4,4,0,0,100,320485,3675,95
74051,2024,9,4,5,56,44,308750,3857,80
74052,2024,9,5,4,44,56,429385,4116,106
74053,2024,5,3,2,40,60,300485,3919,97
74054,2024,9,8,1,11,89,382141,3209,115
74055,2024,8,5,3,38,62,312064,2658,119
74056,2024,286,31,255,89,11,540332,9455,55
74057,2024,8,8,0,0,100,457508,3933,120
74058,2024,35,7,28,80,20,272238,4311,62
74059,2024,1,1,0,0,100,495000,4500,110
74061,2024,9,6,3,33,67,565751,4855,116
74062,2024,17,12,5,29,71,473571,4525,107
74063,2024,97,14,83,86,14,329466,5785,54
74064,2024,8,8,0,0,100,405818,3508,114
74065,2024,4,4,0,0,100,254325,2650,91
74066,2024,2,2,0,0,100,559000,4168,134
74067,2024,18,12,6,33,67,418569,4193,103
74068,2024,1,1,0,0,100,295000,1639,180
74069,2024,10,6,4,40,60,386093,4214,97
74070,2024,54,24,30,56,44,479412,5096,89
74071,2024,4,4,0,0,100,399509,3246,123
74073,2024,5,5,0,0,100,429896,5960,74
74074,2024,7,3,4,57,43,304031,3874,86
74075,2024,18,12,6,33,67,353587,3861,98
74076,2024,15,14,1,7,93,493653,4530,108
74077,2024,15,15,0,0,100,411924,4247,101
74078,2024,3,3,0,0,100,317169,2851,102
74079,2024,6,5,1,17,83,500720,6142,82
74080,2024,75,13,62,83,17,506862,8713,55
74081,2024,187,27,160,86,14,162882,2374,69
74082,2024,62,23,39,63,37,429828,4974,86
74083,2024,71,22,49,69,31,753677,7527,83
74085,2024,50,9,41,82,18,288567,5539,52
74086,2024,10,8,2,20,80,371571,3320,104
74087,2024,10,8,2,20,80,406187,4240,101
74088,2024,17,10,7,41,59,491585,4107,124
74089,2024,21,6,15,71,29,403803,5174,68
74090,2024,9,5,4,44,56,331940,4094,83
74091,2024,8,8,0,0,100,930036,6336,143
74094,2024,64,42,22,34,66,424688,4544,93
74095,2024,3,3,0,0,100,237818,2178,111
74096,2024,62,28,34,55,45,367147,4274,93
74097,2024,16,15,1,6,94,485712,4874,108
74098,2024,11,7,4,36,64,619252,6252,98
74099,2024,39,9,30,77,23,822096,8275,73
74100,2024,9,8,1,11,89,319337,3354,100
74101,2024,6,5,1,17,83,463372,3276,147
74102,2024,8,6,2,25,75,574353,5791,102
74103,2024,18,9,9,50,50,350031,4044,86
74104,2024,38,18,20,53,47,378100,4525,91
74105,2024,92,44,48,52,48,349001,4288,84
74106,2024,8,7,1,12,88,329321,4045,84
74107,2024,2,1,1,50,50,386800,3691,104
74108,2024,15,6,9,60,40,508632,6920,73
74109,2024,7,5,2,29,71,378686,3197,117
74112,2024,72,22,50,69,31,443172,5164,86
74114,2024,4,4,0,0,100,833806,5984,135
74116,2024,15,8,7,47,53,365052,4001,110
74117,2024,12,9,3,25,75,423359,3758,113
74118,2024,30,8,22,73,27,367097,5108,65
74119,2024,174,21,153,88,12,314185,4791,64
74121,2024,22,16,6,27,73,320485,4199,81
74122,2024,7,5,2,29,71,236036,3585,70
74123,2024,73,25,48,66,34,253536,3306,77
74124,2024,14,7,7,50,50,519930,5611,101
74126,2024,7,6,1,14,86,387335,3655,113
74127,2024,9,8,1,11,89,368787,3614,111
74128,2024,43,30,13,30,70,386986,4090,97
74129,2024,4,4,0,0,100,301372,5354,63
74130,2024,1,1,0,0,100,373300,3660,102
74131,2024,19,10,9,47,53,263228,3171,89
74133,2024,172,22,150,87,13,220372,3765,58
74134,2024,96,17,79,82,18,392549,7346,54
74135,2024,13,6,7,54,46,202538,2721,74
74136,2024,79,8,71,90,10,283413,6213,45
74137,2024,40,17,23,57,42,442931,4988,93
74138,2024,17,9,8,47,53,386722,4398,87
74139,2024,4,1,3,75,25,288862,2895,95
74140,2024,41,13,28,68,32,180707,3260,56
74141,2024,8,6,2,25,75,382804,3838,103
74142,2024,9,8,1,11,89,335553,4311,80
74143,2024,108,28,80,74,26,485043,7615,62
74144,2024,14,11,3,21,79,425600,4068,112
74145,2024,4,3,1,25,75,414000,4273,107
74146,2024,12,9,3,25,75,355707,3978,91
74147,2024,15,7,8,53,47,447461,6186,76
74148,2024,3,0,3,100,0,215533,3118,71
74150,2024,6,6,0,0,100,451417,3557,125
74151,2024,5,5,0,0,100,262124,3475,90
74152,2024,12,7,5,42,58,561160,5470,102
74153,2024,17,14,3,18,82,441644,4016,111
74154,2024,36,12,24,67,33,276859,3788,65
74155,2024,7,6,1,14,86,290714,2981,102
74156,2024,7,7,0,0,100,506179,3762,134
74157,2024,14,13,1,7,93,409533,4102,104
74158,2024,11,9,2,18,82,337581,4386,82
74159,2024,38,14,24,63,37,206739,3381,73
74160,2024,52,6,46,88,12,250520,5745,36
74161,2024,22,18,4,18,82,374110,3908,106
74162,2024,12,10,2,17,83,492148,5128,104
74163,2024,22,20,2,9,91,491692,5045,95
74164,2024,61,29,32,52,48,255232,3458,75
74165,2024,6,4,2,33,67,389074,3538,110
74166,2024,9,4,5,56,44,389257,4101,94
74167,2024,8,6,2,25,75,243175,2457,104
74168,2024,6,6,0,0,100,396466,4005,96
74169,2024,48,22,26,54,46,270537,2838,96
74170,2024,2,2,0,0,100,322500,3072,103
74171,2024,23,18,5,22,78,447990,4361,106
74172,2024,28,13,15,54,46,419067,4702,91
74173,2024,155,15,140,90,10,676638,9732,64
74174,2024,7,7,0,0,100,339763,3586,98
74175,2024,12,5,7,58,42,310163,2944,105
74176,2024,23,7,16,70,30,519256,6422,86
74177,2024,10,6,4,40,60,323470,3429,95
74178,2024,7,7,0,0,100,360567,3366,108
74179,2024,9,8,1,11,89,444312,4369,108
74180,2024,24,20,4,17,83,496075,4999,105
74183,2024,33,17,16,48,52,248425,3877,66
74184,2024,16,12,4,25,75,389738,4084,96
74185,2024,25,21,4,16,84,396191,4411,94
74186,2024,3,3,0,0,100,409450,3528,116
74188,2024,11,3,8,73,27,321453,5380,69
74189,2024,37,20,17,46,54,210652,3230,67
74190,2024,87,11,76,87,13,169729,4268,39
74191,2024,223,17,206,92,8,371899,7639,49
74192,2024,4,4,0,0,100,303738,2717,127
74193,2024,7,5,2,29,71,361654,4048,87
74194,2024,8,4,4,50,50,433515,4567,98
74195,2024,4,4,0,0,100,364675,3659,99
74196,2024,9,9,0,0,100,265567,2879,96
74197,2024,21,4,17,81,19,235305,3821,62
74198,2024,9,8,1,11,89,448313,4728,99
74199,2024,11,8,3,27,73,653533,5396,119
74200,2024,28,15,13,46,54,370841,4527,83
74201,2024,24,13,11,46,54,500105,4870,106
74202,2024,11,5,6,55,45,404901,4523,96
74203,2024,2,2,0,0,100,381375,5390,78
74205,2024,27,10,17,63,37,146425,3656,39
74206,2024,4,2,2,50,50,146938,2852,54
74208,2024,125,58,67,54,46,332408,4036,82
74209,2024,7,5,2,29,71,414871,4106,105
74210,2024,15,6,9,60,40,245721,3483,75
74211,2024,29,27,2,7,93,421507,4163,104
74212,2024,24,20,4,17,83,378298,4123,96
74213,2024,97,26,71,73,27,404967,5325,76
74215,2024,76,5,71,93,7,254491,5735,41
74216,2024,15,8,7,47,53,458746,4495,105
74218,2024,71,31,40,56,44,397374,4755,84
74220,2024,97,24,73,75,25,347003,4230,82
74222,2024,5,2,3,60,40,226254,2641,82
74223,2024,8,5,3,38,62,329151,4431,95
74224,2024,109,27,82,75,25,305488,3768,80
74225,2024,184,38,146,79,21,227156,3333,69
74226,2024,5,5,0,0,100,234860,3287,76
74228,2024,4,2,2,50,50,378468,4410,86
74229,2024,38,30,8,21,79,437868,4214,107
74231,2024,4,4,0,0,100,506334,5812,93
74232,2024,6,5,1,17,83,477965,3697,127
74233,2024,20,9,11,55,45,298869,3702,80
74234,2024,6,5,1,17,83,306887,4170,78
74235,2024,6,6,0,0,100,416062,3684,116
74236,2024,214,37,177,83,17,312733,5520,55
74237,2024,18,5,13,72,28,316168,4053,76
74238,2024,72,21,51,71,29,240457,4221,55
74239,2024,32,9,23,72,28,327300,5584,59
74240,2024,11,11,0,0,100,396118,4452,102
74241,2024,38,10,28,74,26,184118,2812,66
74242,2024,75,32,43,57,43,538963,5866,91
74243,2024,186,26,160,86,14,355976,4832,73
74244,2024,8,5,3,38,62,399874,4248,100
74249,2024,20,16,4,20,80,379184,4368,94
74250,2024,73,28,45,62,38,347651,4173,82
74252,2024,6,5,1,17,83,406715,4327,92
74253,2024,18,18,0,0,100,421575,4090,111
74254,2024,1,1,0,0,100,556000,4712,118
74255,2024,37,20,17,46,54,329249,3885,87
74256,2024,243,39,204,84,16,246150,3819,66
74257,2024,3,3,0,0,100,360281,2799,148
74258,2024,147,19,128,87,13,271449,5302,50
74259,2024,1,1,0,0,100,55445,578,96
74260,2024,5,5,0,0,100,382801,2846,140
74261,2024,2,2,0,0,100,379800,3998,91
74262,2024,8,4,4,50,50,422049,4603,89
74263,2024,65,42,23,35,65,360354,4065,95
74264,2024,97,34,63,65,35,212129,2887,73
74265,2024,1,1,0,0,100,295630,6033,49
74266,2024,19,6,13,68,32,401405,6621,58
74267,2024,55,23,32,58,42,641916,6713,93
74269,2024,24,13,11,46,54,213165,2878,76
74271,2024,11,8,3,27,73,471191,5154,94
74272,2024,45,25,20,44,56,403270,4561,91
74273,2024,8,7,1,12,88,430594,5205,81
74275,2024,34,15,19,56,44,561548,7137,83
74276,2024,75,21,54,72,28,234969,4110,58
74278,2024,100,28,72,72,28,250641,3287,76
74279,2024,69,8,61,88,12,143920,3776,38
74280,2024,75,20,55,73,27,319355,4712,68
74281,2024,554,79,475,86,14,261013,3804,68
74282,2024,84,55,29,35,65,447860,4840,95
74283,2024,10,9,1,10,90,361548,3508,105
74284,2024,8,5,3,38,62,226256,3774,86
74285,2024,3,2,1,33,67,427968,3723,114
74286,2024,9,8,1,11,89,246385,4504,56
74287,2024,13,10,3,23,77,241308,3028,88
74288,2024,65,21,44,68,32,333926,4244,80
74289,2024,21,14,7,33,67,321823,3551,91
74290,2024,10,3,7,70,30,275649,4439,58
74291,2024,7,7,0,0,100,336274,4332,81
74292,2024,7,7,0,0,100,492601,4260,117
74293,2024,88,38,50,57,43,457537,4430,104
74294,2024,14,7,7,50,50,372279,5137,76
74295,2024,4,3,1,25,75,249350,3559,77
74296,2024,10,4,6,60,40,372986,3764,105
74297,2024,9,8,1,11,89,305088,3250,97
74298,2024,113,43,70,62,38,373894,4626,80
74299,2024,21,14,7,33,67,1181654,9919,114
74301,2024,8,4,4,50,50,256313,3011,86
74302,2024,8,2,6,75,25,155454,4328,44
74303,2024,34,15,19,56,44,472882,5076,96
74304,2024,7,5,2,29,71,361103,4379,91
74305,2024,131,35,96,73,27,330881,4372,73
74306,2024,4,3,1,25,75,380088,3189,113
74307,2024,9,4,5,56,44,452690,5081,88
74308,2024,10,9,1,10,90,372773,5127,85
74309,2024,73,32,41,56,44,384409,4669,84
74310,2024,18,11,7,39,61,354689,3862,94
74311,2024,50,28,22,44,56,335110,3671,89
74312,2024,13,11,2,15,85,371008,3729,100
74313,2024,7,6,1,14,86,302257,3899,86
74314,2024,23,14,9,39,61,375923,4302,91
74315,2024,7,7,0,0,100,474347,5021,99
75056,2024,24246,84,24162,100,0,507698,9674,51
76001,2024,5,5,0,0,100,245600,2268,105
76002,2024,8,8,0,0,100,189682,1601,121
76004,2024,4,4,0,0,100,156100,1424,114
76005,2024,57,40,17,30,70,191787,2316,82
76006,2024,2,2,0,0,100,192000,1592,122
76007,2024,6,6,0,0,100,235497,1876,128
76008,2024,6,6,0,0,100,188887,1838,102
76009,2024,1,1,0,0,100,214600,2467,87
76010,2024,3,3,0,0,100,155500,1835,88
76011,2024,5,5,0,0,100,284294,1938,146
76012,2024,3,3,0,0,100,134204,1152,130
76013,2024,7,7,0,0,100,235429,2146,112
76014,2024,14,13,1,7,93,223711,2874,83
76015,2024,11,11,0,0,100,178909,1876,97
76016,2024,2,2,0,0,100,161000,2037,79
76017,2024,5,5,0,0,100,207000,2538,94
76018,2024,10,10,0,0,100,134030,1738,82
76019,2024,10,10,0,0,100,176620,1710,109
76020,2024,7,7,0,0,100,187814,1955,94
76021,2024,1,1,0,0,100,205000,1990,103
76022,2024,1,1,0,0,100,160000,1600,100
76023,2024,2,2,0,0,100,213800,1988,108
76024,2024,2,2,0,0,100,133250,1728,77
76025,2024,4,4,0,0,100,142750,1885,74
76026,2024,28,26,2,7,93,154886,1780,93
76028,2024,1,1,0,0,100,130000,2407,54
76030,2024,6,6,0,0,100,175392,1863,93
76032,2024,3,3,0,0,100,229000,2421,99
76033,2024,10,10,0,0,100,200640,2286,91
76034,2024,20,18,2,10,90,167555,1907,94
76035,2024,27,27,0,0,100,110995,1476,73
76036,2024,4,4,0,0,100,161250,2129,81
76039,2024,17,17,0,0,100,233523,2474,98
76040,2024,3,3,0,0,100,354000,2308,138
76041,2024,16,16,0,0,100,201600,1918,106
76043,2024,5,5,0,0,100,225940,1942,109
76045,2024,2,2,0,0,100,144750,1375,108
76046,2024,6,6,0,0,100,270733,2001,138
76047,2024,3,3,0,0,100,120707,1376,92
76048,2024,3,3,0,0,100,253917,1903,135
76049,2024,7,7,0,0,100,154643,1571,97
76050,2024,6,6,0,0,100,212233,2057,119
76051,2024,17,17,0,0,100,136594,1507,91
76053,2024,4,4,0,0,100,221875,2243,102
76054,2024,9,9,0,0,100,145383,1765,93
76055,2024,7,7,0,0,100,137765,1351,101
76056,2024,7,7,0,0,100,191967,2049,98
76057,2024,90,86,4,4,96,182708,1967,95
76058,2024,4,4,0,0,100,257525,2004,130
76059,2024,4,4,0,0,100,154412,1685,94
76060,2024,4,4,0,0,100,168225,1617,98
76062,2024,3,3,0,0,100,197417,1830,107
76063,2024,7,7,0,0,100,214990,2171,100
76064,2024,5,5,0,0,100,206620,1532,126
76065,2024,8,8,0,0,100,115131,1385,95
76067,2024,9,9,0,0,100,141092,1708,97
76068,2024,6,6,0,0,100,190708,2311,86
76069,2024,28,27,1,4,96,292545,2795,111
76070,2024,5,5,0,0,100,149200,1844,81
76071,2024,6,6,0,0,100,195467,1956,100
76072,2024,4,4,0,0,100,139428,1730,88
76075,2024,6,6,0,0,100,155899,1522,106
76077,2024,2,2,0,0,100,234950,1494,158
76079,2024,1,1,0,0,100,293000,2640,111
76082,2024,10,10,0,0,100,204237,2333,98
76084,2024,1,1,0,0,100,210000,3000,70
76085,2024,4,4,0,0,100,209625,1992,100
76086,2024,2,2,0,0,100,155000,1586,98
76087,2024,5,5,0,0,100,248800,2067,120
76088,2024,4,4,0,0,100,184300,1522,123
76090,2024,10,10,0,0,100,206345,2334,91
76091,2024,4,4,0,0,100,187500,1716,102
76092,2024,8,8,0,0,100,111375,1812,73
76093,2024,4,4,0,0,100,146100,2181,72
76094,2024,3,3,0,0,100,168333,1725,100
76095,2024,135,48,87,64,36,196693,2148,84
76096,2024,8,8,0,0,100,177254,1760,97
76097,2024,1,1,0,0,100,179000,2238,80
76099,2024,13,13,0,0,100,220596,1841,123
76100,2024,13,13,0,0,100,220402,1989,116
76101,2024,23,22,1,4,96,118024,1573,77
76103,2024,94,36,58,62,38,209550,2410,87
76104,2024,5,5,0,0,100,198750,2072,86
76105,2024,4,4,0,0,100,220800,1787,126
76106,2024,4,4,0,0,100,233388,2292,103
76107,2024,4,4,0,0,100,213800,2229,99
76108,2024,207,119,88,43,57,309106,3076,98
76111,2024,1,1,0,0,100,220000,1571,140
76112,2024,6,6,0,0,100,216450,2272,91
76113,2024,2,2,0,0,100,256295,2268,110
76114,2024,141,126,15,11,89,112564,1457,79
76115,2024,6,6,0,0,100,189810,1969,98
76116,2024,32,32,0,0,100,271605,2419,118
76117,2024,11,11,0,0,100,258332,3198,92
76118,2024,1,1,0,0,100,153000,1093,140
76119,2024,1,1,0,0,100,240000,2474,97
76120,2024,4,4,0,0,100,228805,2588,98
76121,2024,3,3,0,0,100,204233,2001,97
76122,2024,5,5,0,0,100,168400,1705,106
76123,2024,7,7,0,0,100,307136,2379,127
76124,2024,7,7,0,0,100,215941,2326,97
76125,2024,13,11,2,15,85,154706,1649,92
76126,2024,3,3,0,0,100,233500,1274,167
76128,2024,8,8,0,0,100,181262,1687,107
76129,2024,1,1,0,0,100,165000,2115,78
76130,2024,6,6,0,0,100,131279,1151,118
76131,2024,6,5,1,17,83,169383,1988,85
76132,2024,4,4,0,0,100,154854,1753,88
76133,2024,7,7,0,0,100,243893,3985,93
76134,2024,1,1,0,0,100,190000,1520,125
76135,2024,11,11,0,0,100,216136,1981,110
76136,2024,6,6,0,0,100,143417,1988,77
76138,2024,3,3,0,0,100,195167,1947,98
76139,2024,2,2,0,0,100,187500,1696,112
76140,2024,1,1,0,0,100,108000,1479,73
76141,2024,8,8,0,0,100,200438,2225,86
76142,2024,3,3,0,0,100,169167,1257,132
76143,2024,13,13,0,0,100,205647,2237,95
76144,2024,2,2,0,0,100,253250,2124,114
76146,2024,24,23,1,4,96,183581,2257,90
76147,2024,6,6,0,0,100,160333,1564,106
76148,2024,3,3,0,0,100,118410,1469,81
76151,2024,2,2,0,0,100,150000,1956,75
76152,2024,6,6,0,0,100,158603,1732,96
76153,2024,6,6,0,0,100,155167,1768,96
76154,2024,4,4,0,0,100,75512,1531,52
76155,2024,10,10,0,0,100,157450,1768,90
76156,2024,3,3,0,0,100,139500,1419,92
76157,2024,102,59,43,42,58,149285,1786,84
76158,2024,6,6,0,0,100,189083,1842,108
76159,2024,40,38,2,5,95,156165,1797,91
76160,2024,6,6,0,0,100,197706,2045,93
76161,2024,1,1,0,0,100,125000,1471,85
76162,2024,3,3,0,0,100,146367,1426,105
76163,2024,8,8,0,0,100,195838,1972,105
76164,2024,50,34,16,32,68,181960,2077,88
76165,2024,96,58,38,40,60,122792,1517,81
76166,2024,4,4,0,0,100,122250,1074,121
76167,2024,15,15,0,0,100,324683,2641,129
76169,2024,13,13,0,0,100,234269,2306,104
76171,2024,1,1,0,0,100,125000,1389,90
76172,2024,3,3,0,0,100,129717,1909,64
76173,2024,5,5,0,0,100,165310,1654,102
76174,2024,2,2,0,0,100,145750,1827,78
76176,2024,2,2,0,0,100,204700,2370,100
76177,2024,1,1,0,0,100,320000,1951,164
76178,2024,26,25,1,4,96,161185,1708,95
76179,2024,9,9,0,0,100,253006,2371,110
76180,2024,1,1,0,0,100,85000,1090,78
76181,2024,3,3,0,0,100,250833,2102,111
76183,2024,5,5,0,0,100,176450,1961,89
76184,2024,1,1,0,0,100,185000,2312,80
76185,2024,3,3,0,0,100,165000,2350,73
76186,2024,5,5,0,0,100,153480,1588,100
76187,2024,3,3,0,0,100,557167,2506,205
76188,2024,2,2,0,0,100,146925,2034,74
76189,2024,1,1,0,0,100,82500,1179,70
76190,2024,4,4,0,0,100,151570,1825,82
76192,2024,93,70,23,25,75,162010,2516,69
76193,2024,3,3,0,0,100,178667,2089,87
76194,2024,6,6,0,0,100,227417,2049,110
76195,2024,1,1,0,0,100,256350,1972,130
76196,2024,21,19,2,10,90,232276,2522,101
76197,2024,1,1,0,0,100,110000,1571,70
76198,2024,8,8,0,0,100,174228,1863,99
76199,2024,4,4,0,0,100,144000,1186,127
76200,2024,5,5,0,0,100,183016,1897,96
76201,2024,5,4,1,20,80,149400,1738,87
76202,2024,2,2,0,0,100,81000,2175,49
76203,2024,7,7,0,0,100,215214,1988,113
76204,2024,4,4,0,0,100,200000,1773,110
76205,2024,7,7,0,0,100,156843,1481,103
76206,2024,1,1,0,0,100,140500,3603,39
76207,2024,2,2,0,0,100,71250,891,80
76208,2024,8,8,0,0,100,192562,1860,105
76209,2024,3,3,0,0,100,202483,1861,113
76210,2024,5,5,0,0,100,192860,2366,86
76211,2024,4,4,0,0,100,108455,2007,58
76212,2024,136,50,86,63,37,111128,2047,55
76213,2024,4,4,0,0,100,141750,1789,82
76214,2024,1,1,0,0,100,251520,1480,170
76216,2024,162,83,79,49,51,133558,2014,69
76217,2024,472,170,302,64,36,154589,2417,67
76219,2024,35,35,0,0,100,173497,1656,110
76220,2024,5,5,0,0,100,139110,1727,87
76221,2024,2,2,0,0,100,295900,3686,77
76222,2024,49,42,7,14,86,180615,1819,103
76223,2024,7,7,0,0,100,239129,1911,124
76224,2024,10,10,0,0,100,238896,2596,93
76225,2024,9,9,0,0,100,170756,1636,107
76226,2024,1,1,0,0,100,300000,1714,175
76227,2024,3,3,0,0,100,150967,1779,84
76228,2024,1,1,0,0,100,214000,2277,94
76229,2024,1,1,0,0,100,225000,1667,135
76230,2024,5,5,0,0,100,233840,1901,132
76231,2024,127,44,83,65,35,99582,1364,75
76232,2024,4,4,0,0,100,191200,1864,107
76233,2024,2,2,0,0,100,307500,2186,143
76234,2024,5,5,0,0,100,256540,2039,129
76235,2024,20,18,2,10,90,124572,1651,76
76236,2024,6,6,0,0,100,174100,1460,121
76237,2024,3,3,0,0,100,265667,1335,214
76238,2024,32,31,1,3,97,265784,2479,104
76239,2024,10,10,0,0,100,252155,2586,105
76240,2024,6,6,0,0,100,238694,2147,116
76241,2024,4,4,0,0,100,374475,2866,113
76242,2024,4,4,0,0,100,196250,1666,110
76243,2024,2,2,0,0,100,213000,2178,98
76244,2024,7,7,0,0,100,208971,1733,123
76245,2024,15,15,0,0,100,250207,2232,114
76247,2024,8,8,0,0,100,225900,1996,114
76249,2024,5,5,0,0,100,181760,1971,90
76250,2024,8,8,0,0,100,233712,2376,105
76251,2024,1,1,0,0,100,75000,1415,53
76252,2024,4,4,0,0,100,172625,2116,81
76253,2024,6,5,1,17,83,226117,2304,96
76254,2024,39,27,12,31,69,237915,3197,89
76255,2024,106,72,34,32,68,153008,1966,77
76257,2024,1,1,0,0,100,58000,1160,50
76258,2024,40,38,2,5,95,185275,1802,105
76259,2024,251,163,88,35,65,158388,2121,75
76260,2024,18,17,1,6,94,125718,1974,74
76261,2024,6,6,0,0,100,117157,1492,84
76262,2024,1,1,0,0,100,71000,899,79
76263,2024,17,17,0,0,100,196015,1931,105
76264,2024,3,2,1,33,67,184833,1527,115
76265,2024,2,2,0,0,100,86500,900,104
76266,2024,1,1,0,0,100,148550,4952,30
76268,2024,1,1,0,0,100,104000,2737,38
76269,2024,3,3,0,0,100,237517,1549,152
76270,2024,21,20,1,5,95,373958,2936,125
76271,2024,10,10,0,0,100,204647,2377,93
76272,2024,8,8,0,0,100,154325,1929,84
76273,2024,7,7,0,0,100,305994,2205,142
76274,2024,1,1,0,0,100,195000,1773,110
76275,2024,10,10,0,0,100,233730,2308,100
76276,2024,37,37,0,0,100,152304,1697,92
76278,2024,4,4,0,0,100,153281,1610,99
76279,2024,2,2,0,0,100,146000,1754,85
76280,2024,1,1,0,0,100,159000,1223,130
76281,2024,14,10,4,29,71,142806,1818,78
76282,2024,16,16,0,0,100,194111,1903,108
76283,2024,3,3,0,0,100,130631,1045,162
76284,2024,2,2,0,0,100,205000,2714,90
76285,2024,4,4,0,0,100,257250,2072,126
76286,2024,10,10,0,0,100,155040,1661,96
76287,2024,5,5,0,0,100,198290,1828,117
76288,2024,4,4,0,0,100,158000,1655,95
76289,2024,17,17,0,0,100,182053,1605,111
76290,2024,3,3,0,0,100,225000,2272,101
76291,2024,17,15,2,12,88,208002,1966,111
76293,2024,5,5,0,0,100,197920,2194,91
76294,2024,10,10,0,0,100,174185,1844,101
76295,2024,15,15,0,0,100,93969,1353,70
76296,2024,21,21,0,0,100,238779,2347,103
76297,2024,4,4,0,0,100,109875,1618,63
76298,2024,4,4,0,0,100,193200,2266,88
76299,2024,6,6,0,0,100,222872,2081,101
76300,2024,5,5,0,0,100,204597,2449,95
76302,2024,30,23,7,23,77,173486,2254,86
76303,2024,7,7,0,0,100,252671,2033,124
76304,2024,6,6,0,0,100,253764,2276,114
76305,2024,49,46,3,6,94,185347,2315,84
76306,2024,1,1,0,0,100,310000,3196,97
76307,2024,17,15,2,12,88,222409,2362,103
76308,2024,5,5,0,0,100,147011,1478,104
76309,2024,1,1,0,0,100,40000,336,119
76311,2024,4,4,0,0,100,211950,1894,113
76312,2024,61,50,11,18,82,134595,1510,88
76313,2024,11,11,0,0,100,214013,2070,104
76314,2024,8,8,0,0,100,221825,2198,107
76315,2024,10,10,0,0,100,205735,2168,98
76316,2024,6,6,0,0,100,209442,1935,107
76317,2024,3,3,0,0,100,230887,7118,92
76318,2024,2,2,0,0,100,197500,2167,91
76319,2024,55,51,4,7,93,180976,1946,95
76320,2024,9,9,0,0,100,108776,1473,78
76321,2024,24,23,1,4,96,163788,1977,88
76322,2024,135,73,62,46,54,172195,2317,75
76323,2024,3,3,0,0,100,115000,1416,84
76324,2024,7,7,0,0,100,209842,1587,129
76325,2024,9,9,0,0,100,187889,2036,99
76327,2024,6,6,0,0,100,197800,2245,87
76328,2024,3,3,0,0,100,210900,1697,133
76329,2024,31,30,1,3,97,170797,1908,91
76330,2024,6,6,0,0,100,252860,2719,95
76331,2024,7,7,0,0,100,182721,1809,106
76332,2024,2,2,0,0,100,128500,1607,80
76333,2024,6,6,0,0,100,141825,1816,88
76334,2024,5,5,0,0,100,142204,1863,78
76336,2024,6,6,0,0,100,179583,1509,117
76338,2024,2,2,0,0,100,201500,1896,107
76339,2024,2,2,0,0,100,220000,2550,107
76340,2024,8,8,0,0,100,193800,1714,129
76341,2024,76,48,28,37,63,142719,2085,70
76342,2024,5,5,0,0,100,175178,1641,104
76343,2024,5,5,0,0,100,93880,955,98
76344,2024,11,11,0,0,100,109505,1105,103
76345,2024,7,6,1,14,86,230893,1445,153
76346,2024,1,1,0,0,100,118000,2458,48
76347,2024,4,4,0,0,100,195750,1684,114
76348,2024,8,8,0,0,100,186916,2087,90
76349,2024,17,16,1,6,94,450684,3970,112
76350,2024,2,2,0,0,100,240000,1952,123
76351,2024,2086,670,1416,68,32,164621,2424,68
76352,2024,9,9,0,0,100,173778,1872,90
76353,2024,4,4,0,0,100,146750,1652,90
76354,2024,13,13,0,0,100,277300,2570,112
76355,2024,17,17,0,0,100,150345,1853,84
76356,2024,1,1,0,0,100,180000,2400,75
76357,2024,4,4,0,0,100,159105,1901,87
76358,2024,1,1,0,0,100,151700,3034,50
76359,2024,3,3,0,0,100,237267,2226,106
76360,2024,3,3,0,0,100,191533,1270,158
76361,2024,9,9,0,0,100,278478,2882,108
76362,2024,4,4,0,0,100,155075,1530,106
76363,2024,1,1,0,0,100,95000,1131,84
76364,2024,6,6,0,0,100,243083,2596,98
76365,2024,1,1,0,0,100,140750,2815,50
76366,2024,46,44,2,4,96,152909,1887,81
76367,2024,28,28,0,0,100,291542,2518,118
76368,2024,3,3,0,0,100,217593,2049,109
76369,2024,3,3,0,0,100,156000,1789,84
76370,2024,1,1,0,0,100,230000,2110,109
76371,2024,2,2,0,0,100,80000,1170,68
76372,2024,2,2,0,0,100,135000,952,141
76373,2024,3,3,0,0,100,141000,1633,85
76374,2024,12,12,0,0,100,135451,1755,80
76375,2024,5,5,0,0,100,191780,2163,90
76377,2024,24,22,2,8,92,313759,2781,112
76378,2024,21,21,0,0,100,183519,1845,101
76380,2024,3,3,0,0,100,181667,1260,129
76381,2024,2,2,0,0,100,145500,1318,138
76382,2024,14,14,0,0,100,164940,1838,95
76383,2024,1,1,0,0,100,184500,1708,108
76384,2024,78,57,21,27,73,115142,1646,72
76385,2024,18,18,0,0,100,208015,1968,104
76387,2024,3,3,0,0,100,149000,1418,112
76388,2024,2,2,0,0,100,230000,2040,115
76389,2024,2,2,0,0,100,288525,1871,153
76390,2024,15,14,1,7,93,192452,2164,91
76391,2024,18,18,0,0,100,185056,1805,105
76392,2024,7,7,0,0,100,203414,1610,121
76394,2024,4,4,0,0,100,145879,1679,88
76395,2024,5,5,0,0,100,155300,1700,91
76396,2024,3,3,0,0,100,171092,1535,113
76397,2024,8,8,0,0,100,177969,1938,96
76398,2024,8,8,0,0,100,201250,2022,100
76399,2024,2,2,0,0,100,69500,1078,64
76400,2024,31,30,1,3,97,186236,2056,92
76401,2024,33,33,0,0,100,195907,1882,107
76402,2024,53,51,2,4,96,190369,2127,90
76403,2024,1,1,0,0,100,250000,1689,148
76404,2024,16,15,1,6,94,264719,2427,115
76405,2024,1,1,0,0,100,94000,1106,85
76406,2024,6,3,3,50,50,147543,1821,76
76407,2024,1,1,0,0,100,389700,2051,190
76408,2024,16,16,0,0,100,217955,2284,103
76409,2024,9,9,0,0,100,264133,2530,108
76410,2024,97,46,51,53,47,128014,1769,74
76411,2024,2,2,0,0,100,113750,1087,109
76412,2024,6,6,0,0,100,210392,2171,103
76413,2024,6,6,0,0,100,154100,1952,81
76414,2024,16,14,2,12,88,222528,2003,109
76416,2024,2,2,0,0,100,180000,1672,125
76417,2024,6,6,0,0,100,164650,1945,89
76418,2024,3,3,0,0,100,174300,1812,98
76419,2024,3,3,0,0,100,118500,1282,102
76421,2024,14,14,0,0,100,224410,2132,107
76422,2024,3,3,0,0,100,170407,1666,119
76423,2024,1,1,0,0,100,249700,3374,74
76424,2024,3,3,0,0,100,175000,1947,91
76425,2024,6,6,0,0,100,228192,1919,118
76427,2024,9,9,0,0,100,178278,1547,120
76429,2024,97,64,33,34,66,233505,2806,87
76430,2024,1,1,0,0,100,60000,968,62
76431,2024,1,1,0,0,100,228000,2815,81
76432,2024,5,5,0,0,100,122770,1612,78
76433,2024,7,7,0,0,100,155271,1633,88
76434,2024,11,11,0,0,100,267775,2377,119
76435,2024,5,5,0,0,100,161530,1906,84
76436,2024,4,4,0,0,100,320125,2665,110
76437,2024,5,5,0,0,100,177884,1428,118
76439,2024,2,2,0,0,100,226000,1886,130
76440,2024,3,3,0,0,100,189667,2057,94
76441,2024,6,6,0,0,100,96325,1536,64
76442,2024,3,3,0,0,100,210877,2062,102
76443,2024,5,5,0,0,100,250660,1909,132
76445,2024,5,5,0,0,100,131500,1737,71
76446,2024,17,17,0,0,100,329706,2927,114
76447,2024,176,125,51,29,71,207919,2473,85
76448,2024,22,22,0,0,100,236886,2442,98
76449,2024,10,10,0,0,100,169550,1778,95
76450,2024,2,2,0,0,100,195500,2540,90
76451,2024,265,76,189,71,29,242119,2517,90
76452,2024,50,47,3,6,94,196100,2158,91
76453,2024,14,14,0,0,100,256211,2252,118
76454,2024,1,1,0,0,100,188455,1356,139
76455,2024,3,3,0,0,100,182215,2150,83
76456,2024,10,10,0,0,100,192465,1729,114
76457,2024,14,11,3,21,79,182544,1902,98
76458,2024,2,2,0,0,100,299500,1384,195
76459,2024,9,9,0,0,100,150182,1267,119
76460,2024,8,8,0,0,100,122972,1135,115
76461,2024,3,3,0,0,100,143000,1690,83
76462,2024,60,50,10,17,83,147990,1821,81
76463,2024,4,4,0,0,100,147375,1824,91
76464,2024,25,25,0,0,100,258332,2259,116
76465,2024,4,4,0,0,100,149925,1706,105
76467,2024,18,18,0,0,100,194663,1995,96
76468,2024,7,7,0,0,100,179457,1872,98
76469,2024,4,4,0,0,100,120125,1652,70
76470,2024,8,8,0,0,100,214012,1797,129
76471,2024,13,13,0,0,100,177914,1732,97
76472,2024,5,5,0,0,100,113356,1447,77
76473,2024,2,1,1,50,50,139100,1162,112
76474,2024,85,65,20,24,76,195984,2344,84
76475,2024,60,56,4,7,93,314079,3142,102
76476,2024,107,102,5,5,95,164043,1867,91
76477,2024,4,4,0,0,100,232775,2540,94
76478,2024,4,4,0,0,100,107975,1567,72
76479,2024,1,1,0,0,100,255500,2581,99
76480,2024,5,5,0,0,100,221000,2657,85
76481,2024,42,42,0,0,100,388459,3158,124
76482,2024,31,29,2,6,94,248561,2543,99
76483,2024,2,2,0,0,100,274350,2270,119
76484,2024,80,75,5,6,94,153072,1778,87
76485,2024,3,3,0,0,100,126767,1240,111
76486,2024,7,7,0,0,100,127320,1414,92
76487,2024,1,1,0,0,100,124500,1754,71
76488,2024,2,2,0,0,100,224675,2308,98
76489,2024,5,5,0,0,100,311180,2562,122
76490,2024,10,10,0,0,100,152810,1771,85
76491,2024,12,12,0,0,100,190421,1665,116
76492,2024,6,5,1,17,83,142754,1494,98
76493,2024,3,3,0,0,100,225493,1976,130
76494,2024,1,1,0,0,100,209000,2679,78
76495,2024,50,47,3,6,94,165244,1950,88
76497,2024,60,39,21,35,65,163878,2008,80
76498,2024,282,148,134,48,52,122054,1810,68
76499,2024,15,15,0,0,100,174490,2088,84
76500,2024,3,3,0,0,100,115641,1351,80
76501,2024,5,5,0,0,100,265800,2446,101
76502,2024,5,5,0,0,100,214710,2321,97
76503,2024,7,6,1,14,86,240371,1660,153
76504,2024,3,3,0,0,100,243197,1784,129
76505,2024,3,3,0,0,100,189833,1375,138
76506,2024,1,1,0,0,100,232800,2503,93
76507,2024,11,11,0,0,100,125127,1609,84
76508,2024,3,3,0,0,100,251367,2490,103
76509,2024,15,15,0,0,100,254259,2294,113
76510,2024,1,1,0,0,100,236000,2565,92
76511,2024,1,1,0,0,100,36667,431,85
76512,2024,1,1,0,0,100,50000,833,60
76513,2024,3,3,0,0,100,471000,2619,184
76514,2024,15,14,1,7,93,207521,1952,109
76515,2024,14,13,1,7,93,406375,4356,96
76516,2024,3,3,0,0,100,234000,1810,128
76517,2024,20,20,0,0,100,347086,3005,123
76518,2024,9,9,0,0,100,154328,1867,87
76520,2024,6,6,0,0,100,88100,1287,70
76521,2024,1,1,0,0,100,189000,1643,115
76522,2024,12,12,0,0,100,239354,2263,108
76523,2024,1,1,0,0,100,264300,1835,144
76524,2024,1,1,0,0,100,200000,1020,196
76526,2024,1,1,0,0,100,215000,2172,99
76527,2024,3,3,0,0,100,69667,608,116
76528,2024,2,2,0,0,100,194600,2060,100
76529,2024,3,3,0,0,100,146500,2597,55
76530,2024,2,2,0,0,100,183250,2184,86
76531,2024,6,6,0,0,100,172000,2035,92
76532,2024,9,9,0,0,100,173728,1840,97
76533,2024,10,10,0,0,100,212425,2587,80
76534,2024,11,10,1,9,91,206714,2223,94
76535,2024,3,3,0,0,100,175883,1734,110
76536,2024,15,15,0,0,100,216590,2329,92
76537,2024,1,1,0,0,100,97000,1010,96
76538,2024,5,5,0,0,100,204600,2384,87
76540,2024,1920,328,1592,83,17,161945,2783,59
76541,2024,8,8,0,0,100,272744,2361,117
76542,2024,3,3,0,0,100,189333,1923,98
76543,2024,7,7,0,0,100,195556,1920,106
76544,2024,4,4,0,0,100,164750,1401,124
76545,2024,31,20,11,35,65,136394,2073,66
76546,2024,1,1,0,0,100,30000,600,50
76547,2024,9,9,0,0,100,263333,2311,118
76548,2024,8,8,0,0,100,232688,2522,102
76549,2024,2,2,0,0,100,112500,1174,98
76550,2024,7,7,0,0,100,190754,1978,97
76551,2024,6,5,1,17,83,270517,2292,123
76552,2024,105,59,46,44,56,398065,3577,111
76553,2024,4,4,0,0,100,116500,1507,80
76554,2024,1,1,0,0,100,177000,1670,106
76555,2024,9,9,0,0,100,264122,2128,126
76556,2024,7,7,0,0,100,214849,2078,104
76557,2024,12,12,0,0,100,172746,1716,103
76558,2024,15,15,0,0,100,220375,2240,98
76559,2024,7,7,0,0,100,169886,1547,114
76560,2024,13,13,0,0,100,250053,2221,111
76561,2024,109,77,32,29,71,146724,1717,84
76562,2024,12,11,1,8,92,177092,1977,91
76563,2024,9,9,0,0,100,270533,2508,108
76564,2024,7,7,0,0,100,206929,2138,106
76565,2024,11,11,0,0,100,220764,2431,88
76566,2024,6,6,0,0,100,158533,1810,90
76567,2024,2,2,0,0,100,105000,1126,92
76568,2024,4,4,0,0,100,403475,5528,108
76569,2024,1,1,0,0,100,144400,1459,99
76570,2024,2,2,0,0,100,152500,1045,144
76571,2024,9,9,0,0,100,192078,1906,101
76572,2024,1,1,0,0,100,131000,1191,110
76573,2024,6,6,0,0,100,178150,2043,100
76574,2024,5,5,0,0,100,193420,1644,121
76575,2024,220,191,29,13,87,154338,1893,81
76576,2024,10,10,0,0,100,200264,1907,108
76577,2024,2,2,0,0,100,173500,1169,118
76578,2024,4,4,0,0,100,136217,1690,96
76580,2024,5,5,0,0,100,239770,2301,106
76581,2024,2,2,0,0,100,194500,2624,76
76582,2024,4,4,0,0,100,184575,1650,110
76583,2024,2,2,0,0,100,197500,2596,75
76584,2024,1,1,0,0,100,55000,625,88
76585,2024,1,1,0,0,100,160000,1379,116
76586,2024,8,8,0,0,100,166325,1898,95
76587,2024,6,6,0,0,100,222333,2048,109
76588,2024,2,2,0,0,100,188750,1848,103
76589,2024,1,1,0,0,100,131800,1938,68
76591,2024,21,21,0,0,100,265591,2420,112
76592,2024,6,6,0,0,100,201133,1934,105
76593,2024,6,6,0,0,100,144283,1840,84
76594,2024,17,17,0,0,100,259022,2245,118
76595,2024,15,15,0,0,100,299527,2712,123
76596,2024,21,21,0,0,100,246933,2463,99
76597,2024,2,2,0,0,100,129000,1613,80
76598,2024,9,9,0,0,100,126767,1423,94
76599,2024,38,35,3,8,92,205440,2401,84
76600,2024,21,19,2,10,90,204014,2368,95
76601,2024,2,2,0,0,100,180875,1801,102
76602,2024,3,3,0,0,100,148000,1593,95
76603,2024,4,3,1,25,75,153500,1996,75
76604,2024,2,2,0,0,100,175025,1770,99
76605,2024,7,7,0,0,100,340736,2611,132
76606,2024,3,3,0,0,100,124677,1566,77
76608,2024,20,20,0,0,100,235486,2027,122
76609,2024,4,4,0,0,100,280952,2652,109
76610,2024,17,17,0,0,100,215854,2491,90
76611,2024,2,2,0,0,100,235750,2016,116
76612,2024,4,4,0,0,100,165750,1712,99
76613,2024,12,10,2,17,83,211221,3084,88
76614,2024,19,19,0,0,100,384600,2995,133
76615,2024,8,8,0,0,100,228334,2284,110
76616,2024,14,14,0,0,100,254861,2589,97
76617,2024,23,23,0,0,100,416656,3104,135
76618,2024,90,89,1,1,99,189578,2072,98
76619,2024,3,3,0,0,100,213700,2823,83
76620,2024,1,1,0,0,100,245570,1997,123
76621,2024,10,10,0,0,100,181770,1931,99
76622,2024,3,3,0,0,100,139223,1403,97
76623,2024,2,2,0,0,100,190000,2632,70
76624,2024,52,51,1,2,98,154739,1881,84
76626,2024,5,5,0,0,100,204294,1761,118
76627,2024,19,19,0,0,100,237255,2258,111
76628,2024,11,11,0,0,100,153727,1572,101
76630,2024,1,1,0,0,100,95000,2262,42
76631,2024,13,13,0,0,100,150477,1724,90
76632,2024,1,1,0,0,100,229000,2027,113
76634,2024,6,6,0,0,100,202333,2085,118
76635,2024,1,1,0,0,100,126000,1800,70
76636,2024,25,25,0,0,100,209023,1931,111
76637,2024,18,14,4,22,78,178408,2403,84
76638,2024,9,9,0,0,100,195536,2267,92
76640,2024,89,67,22,25,75,152126,1769,87
76641,2024,4,4,0,0,100,251638,2170,109
76642,2024,3,3,0,0,100,213133,1507,111
76644,2024,8,8,0,0,100,164500,1694,99
76645,2024,2,2,0,0,100,117000,1942,58
76646,2024,8,8,0,0,100,229941,2264,103
76647,2024,58,45,13,22,78,212494,2528,87
76648,2024,18,17,1,6,94,158847,1657,96
76649,2024,5,5,0,0,100,181739,2063,109
76650,2024,10,10,0,0,100,259810,2153,120
76652,2024,7,7,0,0,100,154086,1958,92
76653,2024,5,5,0,0,100,140400,1527,96
76654,2024,4,4,0,0,100,374750,4022,104
76655,2024,76,52,24,32,68,177975,2270,81
76656,2024,6,6,0,0,100,275260,2819,105
76657,2024,15,15,0,0,100,270194,2578,110
76658,2024,8,8,0,0,100,220500,2090,112
76660,2024,6,6,0,0,100,201500,2042,104
76662,2024,3,3,0,0,100,193738,2716,78
76663,2024,20,20,0,0,100,192829,2405,91
76664,2024,1,1,0,0,100,142000,1303,109
76665,2024,2,2,0,0,100,197600,1676,114
76666,2024,5,5,0,0,100,184050,1644,109
76667,2024,1,1,0,0,100,317800,2445,130
76668,2024,6,6,0,0,100,241571,1698,145
76669,2024,9,9,0,0,100,184944,1597,123
76670,2024,12,12,0,0,100,187250,2218,85
76671,2024,2,2,0,0,100,154925,1995,76
76672,2024,8,7,1,12,88,192064,1624,123
76673,2024,7,7,0,0,100,238523,2093,114
76675,2024,10,10,0,0,100,250372,2260,111
76676,2024,4,4,0,0,100,128972,1414,100
76677,2024,2,2,0,0,100,59750,1195,50
76678,2024,8,8,0,0,100,166350,1738,102
76679,2024,1,1,0,0,100,110300,1697,65
76680,2024,1,1,0,0,100,80000,1111,72
76681,2024,299,208,91,30,70,154913,2061,77
76682,2024,3,3,0,0,100,210550,5130,49
76683,2024,3,3,0,0,100,157833,1743,92
76684,2024,16,16,0,0,100,172399,1730,99
76685,2024,6,6,0,0,100,201205,2279,88
76686,2024,3,3,0,0,100,164667,1899,84
76688,2024,2,2,0,0,100,142500,1650,85
76689,2024,3,3,0,0,100,155000,1513,106
76690,2024,9,9,0,0,100,212201,1940,111
76691,2024,2,2,0,0,100,263500,2352,110
76692,2024,2,2,0,0,100,149000,1776,86
76693,2024,4,4,0,0,100,261025,3049,86
76694,2024,1,1,0,0,100,168000,1461,115
76695,2024,2,2,0,0,100,113200,1486,74
76697,2024,8,8,0,0,100,110981,1417,79
76698,2024,8,8,0,0,100,169266,1938,87
76699,2024,5,5,0,0,100,183900,1606,112
76700,2024,10,10,0,0,100,218845,1642,118
76702,2024,4,4,0,0,100,172250,2220,80
76703,2024,2,2,0,0,100,264166,2052,130
76705,2024,18,16,2,11,89,197822,2139,93
76706,2024,9,9,0,0,100,179419,2061,88
76707,2024,13,13,0,0,100,229431,1855,121
76708,2024,1,1,0,0,100,410000,7455,55
76709,2024,56,49,7,12,88,127838,1708,77
76710,2024,1,1,0,0,100,167000,2319,72
76711,2024,106,56,50,47,53,127999,2547,55
76712,2024,7,7,0,0,100,191200,1842,106
76714,2024,9,9,0,0,100,199917,2340,90
76715,2024,11,11,0,0,100,213397,1840,118
76716,2024,12,12,0,0,100,255212,2258,112
76717,2024,8,8,0,0,100,192935,1892,106
76718,2024,11,11,0,0,100,208273,2295,98
76719,2024,8,8,0,0,100,207462,1844,108
76720,2024,9,7,2,22,78,309377,3811,80
76721,2024,3,3,0,0,100,135000,1429,102
76723,2024,3,3,0,0,100,118848,1537,77
76724,2024,2,2,0,0,100,129600,1560,81
76725,2024,4,4,0,0,100,247000,2285,116
76726,2024,3,3,0,0,100,235433,3773,80
76727,2024,11,11,0,0,100,179836,1818,114
76728,2024,8,8,0,0,100,221875,2261,102
76730,2024,1,1,0,0,100,253000,3514,72
76731,2024,1,1,0,0,100,250000,1471,170
76732,2024,6,6,0,0,100,162548,1700,97
76733,2024,4,4,0,0,100,140525,1622,86
76734,2024,2,2,0,0,100,202900,2570,100
76735,2024,20,12,8,40,60,320070,3914,79
76736,2024,5,5,0,0,100,256060,2540,103
76737,2024,8,8,0,0,100,175738,1857,100
76738,2024,10,10,0,0,100,206417,1897,110
76739,2024,5,5,0,0,100,106076,1080,101
76740,2024,3,3,0,0,100,249150,2008,125
76741,2024,6,6,0,0,100,240042,2014,136
76743,2024,16,16,0,0,100,219278,2049,111
76744,2024,3,3,0,0,100,93333,1290,74
76746,2024,3,3,0,0,100,198333,2221,92
76748,2024,7,7,0,0,100,197829,2312,83
76749,2024,6,6,0,0,100,131300,1811,78
76750,2024,18,17,1,6,94,170931,2126,83
76751,2024,14,14,0,0,100,159229,1828,88
76752,2024,29,26,3,10,90,188097,2053,99
76753,2024,14,13,1,7,93,218318,2090,107
76754,2024,20,17,3,15,85,239632,3420,73
76755,2024,6,6,0,0,100,207083,1805,109
76756,2024,2,2,0,0,100,148000,1717,84
76757,2024,12,12,0,0,100,156375,1878,88
76758,2024,147,88,59,40,60,172966,2121,82
76759,2024,3,3,0,0,100,183333,1828,104
77001,2024,17,17,0,0,100,339935,2956,122
77002,2024,14,14,0,0,100,181464,1820,102
77003,2024,6,6,0,0,100,309300,2662,119
77004,2024,1,1,0,0,100,347600,4574,76
77005,2024,30,22,8,27,73,342649,3719,97
77006,2024,11,11,0,0,100,342082,3398,110
77007,2024,2,2,0,0,100,275000,2353,118
77008,2024,3,3,0,0,100,319383,3870,85
77009,2024,3,3,0,0,100,158333,1603,102
77010,2024,3,3,0,0,100,173333,2141,83
77011,2024,2,2,0,0,100,206000,1466,142
77012,2024,7,7,0,0,100,150929,1604,97
77013,2024,3,3,0,0,100,371667,2233,165
77014,2024,220,32,188,85,15,195787,2979,68
77015,2024,1,1,0,0,100,130000,1857,70
77016,2024,6,6,0,0,100,127055,2138,70
77018,2024,77,41,36,47,53,345500,4365,82
77019,2024,3,3,0,0,100,126000,1398,93
77020,2024,4,4,0,0,100,219225,1636,137
77021,2024,4,4,0,0,100,240038,2070,114
77022,2024,25,21,4,16,84,685806,5110,136
77023,2024,8,8,0,0,100,194744,2319,88
77024,2024,1,1,0,0,100,260000,970,268
77025,2024,7,7,0,0,100,151041,1580,98
77026,2024,2,2,0,0,100,133000,1622,82
77027,2024,10,9,1,10,90,123827,1232,97
77029,2024,3,3,0,0,100,273833,2622,104
77030,2024,10,10,0,0,100,173030,1852,104
77031,2024,6,6,0,0,100,376650,2509,150
77032,2024,14,13,1,7,93,179929,1951,93
77033,2024,2,2,0,0,100,187500,1248,146
77034,2024,4,4,0,0,100,243475,2537,103
77035,2024,10,10,0,0,100,134401,1443,92
77037,2024,67,53,14,21,79,370903,3969,92
77038,2024,5,5,0,0,100,670200,3827,181
77039,2024,9,8,1,11,89,401028,3439,122
77040,2024,29,28,1,3,97,321145,2872,115
77041,2024,4,4,0,0,100,320175,2820,118
77042,2024,34,34,0,0,100,218145,2202,103
77043,2024,3,3,0,0,100,123933,1796,67
77044,2024,13,12,1,8,92,267461,2769,97
77045,2024,5,5,0,0,100,212722,2035,105
77046,2024,2,2,0,0,100,248400,2968,79
77047,2024,13,8,5,38,62,277262,3326,82
77048,2024,20,17,3,15,85,501264,4149,127
77049,2024,7,7,0,0,100,293143,2588,116
77050,2024,4,4,0,0,100,110000,1390,92
77051,2024,16,16,0,0,100,160743,1702,94
77052,2024,4,4,0,0,100,247000,2072,120
77053,2024,218,87,131,60,40,234305,3410,72
77054,2024,5,5,0,0,100,208670,2302,89
77055,2024,51,7,44,86,14,179017,2845,65
77056,2024,6,6,0,0,100,210375,1930,104
77057,2024,5,5,0,0,100,213700,1762,128
77058,2024,292,65,227,78,22,299239,4255,73
77059,2024,8,7,1,12,88,436123,4628,98
77060,2024,9,9,0,0,100,229689,1916,120
77061,2024,27,23,4,15,85,177724,2284,81
77062,2024,5,3,2,40,60,419521,4010,112
77063,2024,11,11,0,0,100,218157,2467,93
77065,2024,11,10,1,9,91,246409,2738,94
77066,2024,1,1,0,0,100,248341,2258,110
77067,2024,99,85,14,14,86,262426,2936,92
77068,2024,3,3,0,0,100,160000,1350,112
77069,2024,27,25,2,7,93,325744,3309,101
77070,2024,12,12,0,0,100,239182,2140,116
77071,2024,9,9,0,0,100,411205,2929,125
77072,2024,6,6,0,0,100,141380,1676,96
77073,2024,7,7,0,0,100,198029,1640,122
77075,2024,15,11,4,27,73,248575,3147,84
77076,2024,7,7,0,0,100,208571,1772,122
77077,2024,14,12,2,14,86,204786,2594,78
77078,2024,13,13,0,0,100,228900,1941,119
77079,2024,45,39,6,13,87,208280,2498,84
77080,2024,4,4,0,0,100,400125,2321,204
77081,2024,4,4,0,0,100,278250,2942,100
77082,2024,8,7,1,12,88,188646,2796,80
77083,2024,164,72,92,56,44,285766,3771,80
77084,2024,19,16,3,16,84,223211,2682,88
77085,2024,39,22,17,44,56,330916,3960,85
77086,2024,20,20,0,0,100,214572,2268,103
77087,2024,3,3,0,0,100,336000,2461,139
77088,2024,22,19,3,14,86,251436,2495,103
77089,2024,13,13,0,0,100,248731,2547,99
77090,2024,1,1,0,0,100,231000,2243,103
77091,2024,3,3,0,0,100,342350,2752,126
77093,2024,1,1,0,0,100,173000,2110,82
77094,2024,2,2,0,0,100,429450,3336,129
77095,2024,23,18,5,22,78,320999,3428,97
77096,2024,34,30,4,12,88,333413,3413,99
77098,2024,6,6,0,0,100,164750,1834,99
77099,2024,42,39,3,7,93,166517,1899,93
77100,2024,47,46,1,2,98,225851,2594,87
77101,2024,13,13,0,0,100,196787,1995,102
77103,2024,4,3,1,25,75,248246,3702,76
77104,2024,6,6,0,0,100,341525,3377,110
77106,2024,10,10,0,0,100,231140,2258,104
77107,2024,32,24,8,25,75,231025,2770,89
77108,2024,431,179,252,58,42,249588,3520,73
77109,2024,20,19,1,5,95,171106,1895,100
77110,2024,2,2,0,0,100,132500,1820,73
77111,2024,63,18,45,71,29,318617,4642,71
77112,2024,4,4,0,0,100,270138,2278,117
77113,2024,9,9,0,0,100,285167,2095,134
77114,2024,38,28,10,26,74,306534,3370,95
77115,2024,7,7,0,0,100,215732,2185,102
77116,2024,11,11,0,0,100,178227,1876,92
77117,2024,9,6,3,33,67,146889,1971,84
77118,2024,112,68,44,39,61,287476,3577,83
77119,2024,1,1,0,0,100,264000,2164,122
77120,2024,5,5,0,0,100,265200,2034,133
77121,2024,22,14,8,36,64,326760,4028,86
77122,2024,190,119,71,37,63,247089,3082,82
77123,2024,3,3,0,0,100,578333,6326,101
77124,2024,14,12,2,14,86,308912,3751,85
77125,2024,17,16,1,6,94,291723,3144,94
77126,2024,24,24,0,0,100,179354,1884,96
77127,2024,14,4,10,71,29,174150,2820,60
77128,2024,16,16,0,0,100,330709,3180,114
77129,2024,7,7,0,0,100,177940,1593,125
77130,2024,3,3,0,0,100,272800,3035,91
77131,2024,170,79,91,54,46,190730,2612,77
77132,2024,39,31,8,21,79,329842,3812,91
77133,2024,2,2,0,0,100,240960,1350,173
77134,2024,2,2,0,0,100,133500,2252,59
77135,2024,15,14,1,7,93,267241,2378,120
77136,2024,1,1,0,0,100,350000,3302,106
77137,2024,4,4,0,0,100,193000,1868,110
77138,2024,12,11,1,8,92,235958,2375,107
77139,2024,62,53,9,15,85,297126,3414,90
77140,2024,6,6,0,0,100,222750,1621,141
77141,2024,19,10,9,47,53,298687,3212,95
77142,2024,43,27,16,37,63,244528,3153,82
77143,2024,32,25,7,22,78,238100,2823,88
77144,2024,2,2,0,0,100,371550,2159,217
77145,2024,5,5,0,0,100,250440,2914,101
77146,2024,13,12,1,8,92,412288,3712,111
77147,2024,11,11,0,0,100,163623,2097,83
77148,2024,24,20,4,17,83,202875,2129,103
77150,2024,2,2,0,0,100,142500,1704,88
77151,2024,7,7,0,0,100,198048,1652,109
77152,2024,187,100,87,47,53,202324,2832,74
77153,2024,118,68,50,42,58,232130,3084,78
77154,2024,18,17,1,6,94,278074,3291,97
77155,2024,26,23,3,12,88,344374,3507,100
77156,2024,10,10,0,0,100,189850,2293,85
77157,2024,2,1,1,50,50,160815,1546,102
77158,2024,3,3,0,0,100,172833,1729,101
77159,2024,26,25,1,4,96,183683,1726,110
77161,2024,15,15,0,0,100,213911,2251,96
77162,2024,10,10,0,0,100,192304,2277,88
77163,2024,1,1,0,0,100,299900,1947,154
77164,2024,3,3,0,0,100,196267,1871,103
77165,2024,6,6,0,0,100,400717,2781,138
77167,2024,4,4,0,0,100,150611,1548,95
77168,2024,30,26,4,13,87,164772,1703,100
77169,2024,64,23,41,64,36,264366,3672,74
77171,2024,50,33,17,34,66,261729,3577,78
77172,2024,7,7,0,0,100,186857,1957,96
77173,2024,11,11,0,0,100,219395,2243,98
77174,2024,5,5,0,0,100,162100,1701,100
77175,2024,35,35,0,0,100,342464,3320,111
77176,2024,30,30,0,0,100,232048,2600,91
77177,2024,5,4,1,20,80,352460,3709,98
77178,2024,8,7,1,12,88,189375,1866,104
77179,2024,4,4,0,0,100,208243,2070,106
77180,2024,4,4,0,0,100,319438,3676,92
77181,2024,57,19,38,67,33,272465,4397,65
77182,2024,35,24,11,31,69,139869,1848,78
77183,2024,114,66,48,42,58,171243,2395,76
77184,2024,9,9,0,0,100,227610,1999,122
77185,2024,8,8,0,0,100,410191,4029,96
77186,2024,216,49,167,77,23,372493,4990,74
77187,2024,9,9,0,0,100,151800,1695,105
77188,2024,12,11,1,8,92,227379,2856,79
77190,2024,2,2,0,0,100,178820,1548,133
77191,2024,7,7,0,0,100,219857,2142,106
77192,2024,64,39,25,39,61,239506,2944,87
77193,2024,2,2,0,0,100,245500,2048,116
77194,2024,5,5,0,0,100,213880,2273,95
77195,2024,10,9,1,10,90,230757,2925,84
77196,2024,11,7,4,36,64,290495,3265,93
77197,2024,3,3,0,0,100,182000,1769,107
77198,2024,1,1,0,0,100,172950,2471,70
77199,2024,10,10,0,0,100,220254,3017,74
77201,2024,10,9,1,10,90,211000,2212,107
77202,2024,8,8,0,0,100,269714,2705,103
77203,2024,13,13,0,0,100,327517,2869,119
77204,2024,3,3,0,0,100,132290,1429,99
77205,2024,1,1,0,0,100,320000,2319,138
77206,2024,1,1,0,0,100,215000,1641,131
77207,2024,2,2,0,0,100,119500,1254,93
77208,2024,18,6,12,67,33,77167,1254,59
77209,2024,7,5,2,29,71,347800,3822,92
77210,2024,29,29,0,0,100,211084,2077,110
77211,2024,3,3,0,0,100,215403,2168,104
77212,2024,2,2,0,0,100,163500,3050,56
77214,2024,6,6,0,0,100,331150,2325,144
77215,2024,86,48,38,44,56,235866,3244,76
77216,2024,9,8,1,11,89,280389,2900,100
77217,2024,33,26,7,21,79,298565,3740,86
77218,2024,4,4,0,0,100,138695,1370,105
77219,2024,34,34,0,0,100,305118,3047,102
77220,2024,4,4,0,0,100,259118,1786,143
77221,2024,12,12,0,0,100,429018,3481,124
77222,2024,53,26,27,51,49,199360,2677,77
77223,2024,3,3,0,0,100,166667,1865,90
77225,2024,3,3,0,0,100,284097,2541,125
77226,2024,24,23,1,4,96,254258,2952,92
77227,2024,7,7,0,0,100,133311,1563,84
77228,2024,5,5,0,0,100,193330,1576,131
77229,2024,19,17,2,11,89,300314,2900,111
77230,2024,3,3,0,0,100,207688,1869,111
77231,2024,7,7,0,0,100,214565,2434,92
77232,2024,11,8,3,27,73,263288,2824,93
77233,2024,3,3,0,0,100,255000,2327,112
77234,2024,3,3,0,0,100,497233,2786,184
77235,2024,5,5,0,0,100,219600,2232,126
77236,2024,5,5,0,0,100,181600,1900,97
77237,2024,6,6,0,0,100,317667,4230,78
77238,2024,32,25,7,22,78,185342,1920,101
77239,2024,11,10,1,9,91,192755,1979,106
77240,2024,19,19,0,0,100,181474,2102,95
77241,2024,13,12,1,8,92,240192,3027,80
77242,2024,8,8,0,0,100,225092,1722,132
77243,2024,240,89,151,63,37,278828,3814,75
77244,2024,7,6,1,14,86,192929,2231,94
77245,2024,4,4,0,0,100,300075,2184,138
77246,2024,4,4,0,0,100,177500,1724,110
77247,2024,4,4,0,0,100,143594,1378,114
77248,2024,7,7,0,0,100,379829,3386,107
77249,2024,79,73,6,8,92,381409,3474,111
77250,2024,1,1,0,0,100,147000,1289,114
77251,2024,114,39,75,66,34,227245,3316,70
77252,2024,9,9,0,0,100,410039,2968,138
77253,2024,4,4,0,0,100,244850,1996,122
77254,2024,11,11,0,0,100,337493,2959,116
77255,2024,12,12,0,0,100,266433,2658,102
77256,2024,5,5,0,0,100,192630,1813,104
77257,2024,36,24,12,33,67,165376,2161,79
77258,2024,87,11,76,87,13,224632,3543,67
77259,2024,26,18,8,31,69,226853,3292,77
77260,2024,10,9,1,10,90,169500,1933,90
77261,2024,19,19,0,0,100,176581,1771,99
77262,2024,4,4,0,0,100,199500,1440,140
77263,2024,6,6,0,0,100,184017,1673,112
77264,2024,22,22,0,0,100,290176,2463,125
77265,2024,10,10,0,0,100,200455,2056,106
77266,2024,5,4,1,20,80,243940,2957,91
77267,2024,2,2,0,0,100,197480,1976,101
77268,2024,73,34,39,53,47,404943,4788,85
77269,2024,20,15,5,25,75,222811,2966,78
77270,2024,7,7,0,0,100,254764,2707,103
77272,2024,7,7,0,0,100,170817,1764,101
77273,2024,8,8,0,0,100,292169,3086,99
77274,2024,6,5,1,17,83,191167,2522,76
77275,2024,3,3,0,0,100,164000,1395,123
77276,2024,29,22,7,24,76,255046,2973,95
77277,2024,14,11,3,21,79,267850,2773,101
77278,2024,6,6,0,0,100,288567,2459,128
77279,2024,7,7,0,0,100,333284,3008,105
77280,2024,12,11,1,8,92,224367,2318,106
77281,2024,7,7,0,0,100,323429,2649,123
77283,2024,7,7,0,0,100,203589,2495,82
77284,2024,484,80,404,83,17,178644,2912,65
77285,2024,125,45,80,64,36,173943,2122,83
77286,2024,3,3,0,0,100,231000,1734,130
77287,2024,2,2,0,0,100,174500,1602,112
77288,2024,396,70,326,82,18,157000,2743,60
77289,2024,4,4,0,0,100,138375,1152,131
77290,2024,10,10,0,0,100,143799,2652,55
77291,2024,8,8,0,0,100,195625,2834,70
77292,2024,11,8,3,27,73,299959,3456,90
77293,2024,10,10,0,0,100,234284,3048,83
77294,2024,136,109,27,20,80,272403,3638,81
77295,2024,12,11,1,8,92,237466,2719,91
77296,2024,136,70,66,49,51,219856,3122,72
77297,2024,1,1,0,0,100,130000,929,140
77298,2024,3,3,0,0,100,164000,1524,113
77300,2024,5,5,0,0,100,228023,2686,91
77301,2024,3,3,0,0,100,86000,1262,86
77302,2024,25,25,0,0,100,248117,2630,95
77303,2024,2,2,0,0,100,185000,1265,146
77305,2024,116,27,89,77,23,122026,2106,60
77306,2024,2,2,0,0,100,347625,2668,131
77307,2024,170,34,136,80,20,264260,4410,64
77308,2024,12,11,1,8,92,294820,2968,99
77309,2024,14,14,0,0,100,229393,2933,80
77310,2024,4,4,0,0,100,193125,1826,109
77311,2024,19,19,0,0,100,166517,1899,86
77312,2024,34,31,3,9,91,287267,2893,103
77313,2024,6,6,0,0,100,210000,1769,128
77315,2024,50,43,7,14,86,313089,3620,91
77316,2024,142,114,28,20,80,233279,2773,87
77317,2024,45,28,17,38,62,193989,2404,82
77318,2024,13,11,2,15,85,232169,2930,87
77320,2024,57,53,4,7,93,236522,2624,94
77321,2024,8,8,0,0,100,166521,1968,86
77322,2024,28,25,3,11,89,305820,2932,108
77323,2024,11,6,5,45,55,302630,2981,98
77325,2024,3,3,0,0,100,113000,1304,90
77326,2024,63,44,19,30,70,243708,2993,84
77327,2024,67,56,11,16,84,188699,2340,85
77328,2024,2,2,0,0,100,228000,2309,106
77329,2024,7,7,0,0,100,259679,2074,130
77330,2024,56,49,7,12,88,265298,2882,99
77331,2024,6,3,3,50,50,126167,1799,68
77332,2024,2,2,0,0,100,202000,2604,81
77333,2024,117,71,46,39,61,166936,2241,77
77335,2024,28,26,2,7,93,270440,2710,104
77336,2024,9,7,2,22,78,294223,3154,99
77337,2024,78,31,47,60,40,251925,3394,77
77338,2024,5,5,0,0,100,221800,2279,103
77339,2024,19,15,4,21,79,364886,3547,121
77340,2024,5,5,0,0,100,250560,2372,109
77341,2024,3,3,0,0,100,141510,1621,90
77342,2024,1,1,0,0,100,170000,1417,120
77343,2024,4,4,0,0,100,160600,2173,74
77344,2024,16,12,4,25,75,252750,2807,93
77345,2024,10,10,0,0,100,125539,1510,88
77347,2024,6,6,0,0,100,185317,2266,85
77348,2024,2,2,0,0,100,130000,2196,60
77349,2024,46,40,6,13,87,277215,3048,94
77350,2024,169,112,57,34,66,319278,3886,88
77352,2024,27,25,2,7,93,249398,3122,87
77353,2024,4,4,0,0,100,204775,1744,116
77354,2024,9,9,0,0,100,228403,2858,79
77357,2024,7,7,0,0,100,252750,2338,113
77358,2024,8,8,0,0,100,258120,2752,97
77359,2024,17,16,1,6,94,322391,3200,101
77360,2024,4,3,1,25,75,259300,2215,118
77361,2024,4,4,0,0,100,190250,2285,96
77363,2024,16,13,3,19,81,347215,4162,90
77364,2024,1,1,0,0,100,350000,6034,58
77365,2024,4,4,0,0,100,217375,2044,114
77366,2024,4,4,0,0,100,352750,3593,98
77367,2024,2,2,0,0,100,228250,1506,165
77368,2024,5,5,0,0,100,160600,1755,91
77369,2024,3,3,0,0,100,273333,1827,160
77370,2024,11,11,0,0,100,226774,2294,108
77371,2024,40,39,1,2,98,248758,2757,99
77372,2024,35,18,17,49,51,349907,4060,84
77373,2024,287,139,148,52,48,266502,3911,73
77374,2024,32,26,6,19,81,310149,3700,87
77376,2024,7,7,0,0,100,308264,2812,116
77377,2024,20,18,2,10,90,485084,3728,122
77378,2024,35,23,12,34,66,296045,3256,94
77379,2024,122,56,66,54,46,160892,2049,80
77380,2024,4,4,0,0,100,213788,2349,99
77381,2024,3,3,0,0,100,223353,1992,115
77382,2024,51,46,5,10,90,296488,3176,100
77383,2024,1,1,0,0,100,340000,2012,169
77384,2024,10,8,2,20,80,233473,4007,60
77385,2024,24,23,1,4,96,173897,1892,92
77386,2024,6,6,0,0,100,220833,2564,95
77387,2024,2,2,0,0,100,178000,1195,148
77388,2024,5,5,0,0,100,220510,2552,91
77389,2024,45,26,19,42,58,266429,2969,88
77390,2024,160,101,59,37,63,274134,3400,83
77391,2024,8,8,0,0,100,172230,2242,89
77392,2024,10,10,0,0,100,308837,3466,89
77393,2024,23,19,4,17,83,244130,2780,94
77394,2024,15,13,2,13,87,330242,2939,116
77397,2024,21,19,2,10,90,180552,2111,93
77398,2024,4,4,0,0,100,148292,1812,81
77400,2024,22,22,0,0,100,270103,2748,102
77401,2024,12,12,0,0,100,186583,2171,85
77402,2024,1,1,0,0,100,75000,605,124
77403,2024,11,11,0,0,100,181659,1801,103
77404,2024,16,16,0,0,100,196112,2028,98
77405,2024,19,18,1,5,95,191142,1924,96
77406,2024,12,12,0,0,100,212967,1832,115
77407,2024,173,115,58,34,66,271051,2994,92
77408,2024,4,4,0,0,100,214500,2102,98
77409,2024,20,20,0,0,100,197672,2335,89
77411,2024,7,7,0,0,100,232604,2021,116
77412,2024,2,2,0,0,100,340600,3434,103
77413,2024,53,39,14,26,74,302707,3567,88
77414,2024,3,3,0,0,100,123500,1455,84
77415,2024,16,16,0,0,100,263498,2627,99
77416,2024,6,6,0,0,100,208383,2071,99
77417,2024,5,5,0,0,100,240080,2015,131
77418,2024,9,9,0,0,100,172756,1954,86
77419,2024,36,32,4,11,89,219824,2609,87
77420,2024,43,30,13,30,70,255549,3334,80
77421,2024,2,2,0,0,100,192500,1874,103
77423,2024,9,9,0,0,100,199428,2071,97
77424,2024,3,3,0,0,100,190409,1350,146
77425,2024,4,4,0,0,100,473425,3412,146
77426,2024,5,5,0,0,100,228000,3198,83
77427,2024,2,2,0,0,100,285980,2407,121
77428,2024,7,7,0,0,100,253681,2569,103
77429,2024,8,8,0,0,100,259742,1729,154
77430,2024,52,44,8,15,85,262886,2670,100
77431,2024,52,46,6,12,88,214998,2383,93
77432,2024,10,10,0,0,100,212910,1978,109
77433,2024,11,11,0,0,100,250234,2814,99
77434,2024,10,10,0,0,100,204893,2638,85
77435,2024,9,9,0,0,100,412152,3046,147
77436,2024,11,10,1,9,91,168561,1740,101
77437,2024,37,32,5,14,86,239889,2768,90
77438,2024,42,29,13,31,69,367516,3818,100
77439,2024,10,10,0,0,100,185800,1979,101
77440,2024,10,9,1,10,90,245700,2800,88
77441,2024,28,28,0,0,100,524259,3907,137
77442,2024,26,26,0,0,100,314808,3032,106
77443,2024,1,1,0,0,100,282000,4209,67
77444,2024,4,4,0,0,100,157800,1977,100
77445,2024,187,99,88,47,53,210377,2722,79
77446,2024,9,9,0,0,100,205481,1939,114
77447,2024,22,19,3,14,86,431279,3672,123
77448,2024,1,0,1,100,0,128000,2098,61
77449,2024,99,19,80,81,19,314107,4747,68
77450,2024,34,30,4,12,88,340207,3719,97
77451,2024,5,5,0,0,100,201990,1823,121
77452,2024,1,1,0,0,100,320000,2462,130
77453,2024,7,7,0,0,100,263914,3444,84
77454,2024,8,8,0,0,100,269975,2008,138
77455,2024,20,15,5,25,75,233722,3089,78
77456,2024,11,11,0,0,100,191598,2242,90
77457,2024,13,10,3,23,77,255731,2856,94
77458,2024,45,42,3,7,93,159063,1797,94
77459,2024,15,15,0,0,100,169397,1785,99
77460,2024,3,3,0,0,100,130000,1724,73
77461,2024,2,2,0,0,100,150590,1910,86
77462,2024,6,5,1,17,83,310597,3604,86
77463,2024,25,22,3,12,88,301052,3774,97
77464,2024,88,39,49,56,44,253408,3527,76
77465,2024,13,13,0,0,100,205193,2219,96
77466,2024,4,4,0,0,100,278924,2798,112
77467,2024,6,6,0,0,100,125500,1622,78
77468,2024,176,49,127,72,28,235911,3374,73
77469,2024,11,11,0,0,100,236843,2024,132
77470,2024,61,39,22,36,64,264448,3328,87
77471,2024,4,4,0,0,100,348200,2675,125
77472,2024,3,3,0,0,100,151667,1620,93
77473,2024,5,5,0,0,100,361382,2571,115
77474,2024,10,8,2,20,80,205087,2201,102
77475,2024,55,50,5,9,91,243433,2919,84
77476,2024,2,2,0,0,100,170000,1688,101
77477,2024,10,10,0,0,100,274990,2226,123
77478,2024,5,5,0,0,100,198800,1697,107
77479,2024,105,64,41,39,61,301357,4003,77
77480,2024,7,7,0,0,100,207014,2236,99
77481,2024,2,2,0,0,100,125000,1880,66
77482,2024,25,24,1,4,96,167368,2504,71
77483,2024,19,19,0,0,100,262739,2960,96
77484,2024,2,2,0,0,100,350000,2106,166
77485,2024,10,10,0,0,100,484623,4605,113
77486,2024,7,7,0,0,100,267157,2050,138
77487,2024,109,62,47,43,57,240048,2746,88
77489,2024,3,3,0,0,100,221667,2089,114
77490,2024,8,7,1,12,88,209940,2145,98
77492,2024,11,11,0,0,100,164905,1452,110
77493,2024,21,18,3,14,86,273017,2746,102
77494,2024,24,23,1,4,96,232589,2557,96
77495,2024,77,68,9,12,88,261689,2949,93
77496,2024,2,2,0,0,100,172750,2321,73
77498,2024,6,3,3,50,50,293108,3189,91
77500,2024,5,5,0,0,100,238760,2084,123
77501,2024,14,14,0,0,100,224429,2335,111
77504,2024,8,8,0,0,100,167625,1962,84
77505,2024,5,5,0,0,100,282250,2665,106
77506,2024,3,3,0,0,100,235500,1805,118
77507,2024,8,8,0,0,100,128350,2015,78
77508,2024,23,22,1,4,96,322727,3252,105
77509,2024,7,7,0,0,100,220000,2368,95
77510,2024,4,0,4,100,0,202250,3665,57
77511,2024,2,2,0,0,100,198000,2434,82
77512,2024,13,13,0,0,100,177385,1728,107
77513,2024,50,26,24,48,52,227706,3556,71
77514,2024,228,115,113,50,50,234272,3374,72
77515,2024,7,7,0,0,100,263193,2993,91
77516,2024,8,8,0,0,100,183038,2063,88
77517,2024,12,11,1,8,92,299538,3219,99
77518,2024,1,1,0,0,100,338000,3045,111
77519,2024,14,14,0,0,100,152329,1578,100
77520,2024,6,5,1,17,83,162192,1984,89
77521,2024,21,21,0,0,100,276433,3375,86
77522,2024,2,2,0,0,100,127000,1194,112
77523,2024,5,5,0,0,100,177600,1471,130
77524,2024,3,3,0,0,100,187800,2109,112
77525,2024,4,4,0,0,100,254125,2268,124
77526,2024,3,3,0,0,100,220333,2066,110
77527,2024,4,4,0,0,100,200702,1966,108
77528,2024,6,6,0,0,100,326320,3534,93
77529,2024,14,14,0,0,100,274780,2667,103
77530,2024,5,5,0,0,100,187980,1639,122
77531,2024,23,20,3,13,87,157220,1974,84
77532,2024,1,1,0,0,100,144000,1714,84
77533,2024,25,24,1,4,96,315240,3044,106
77534,2024,9,9,0,0,100,279922,2699,109
78003,2024,35,31,4,11,89,263381,2764,97
78005,2024,156,67,89,57,43,264430,3787,72
78006,2024,7,7,0,0,100,487071,4133,119
78007,2024,9,9,0,0,100,850750,5191,163
78009,2024,3,3,0,0,100,194743,1812,103
78010,2024,7,7,0,0,100,526254,4422,122
78013,2024,4,4,0,0,100,309894,3184,101
78015,2024,162,73,89,55,45,284740,3472,85
78020,2024,2,2,0,0,100,309500,3165,104
78029,2024,98,48,50,51,49,205245,2639,78
78030,2024,15,14,1,7,93,367859,3100,129
78031,2024,3,3,0,0,100,303040,2484,123
78033,2024,9,9,0,0,100,300094,3153,96
78034,2024,7,7,0,0,100,456371,4281,106
78043,2024,39,15,24,62,38,470974,4381,104
78048,2024,17,15,2,12,88,456637,3845,116
78049,2024,15,14,1,7,93,374829,3615,109
78050,2024,6,6,0,0,100,545235,5763,126
78053,2024,2,2,0,0,100,408500,3472,118
78057,2024,14,11,3,21,79,169721,1954,88
78062,2024,76,50,26,34,66,282043,3387,84
78068,2024,5,5,0,0,100,234200,2646,89
78070,2024,1,1,0,0,100,264040,4801,55
78071,2024,4,4,0,0,100,243925,2434,105
78072,2024,3,3,0,0,100,298067,2311,130
78073,2024,185,40,145,78,22,234334,3438,69
78076,2024,2,2,0,0,100,233230,2651,86
78077,2024,1,1,0,0,100,220000,1880,117
78082,2024,1,0,1,100,0,260000,2080,125
78084,2024,5,5,0,0,100,411620,3694,110
78087,2024,19,14,5,26,74,322058,3526,96
78089,2024,39,27,12,31,69,204920,2590,86
78090,2024,9,8,1,11,89,325221,2840,116
78092,2024,82,20,62,76,24,420907,4805,83
78096,2024,10,10,0,0,100,464564,3608,130
78104,2024,9,7,2,22,78,195833,2588,91
78107,2024,22,19,3,14,86,239099,2730,94
78108,2024,12,8,4,33,67,363248,3215,122
78113,2024,3,3,0,0,100,263050,2829,97
78117,2024,52,25,27,52,48,447423,5257,85
78118,2024,17,14,3,18,82,242582,2751,90
78120,2024,9,8,1,11,89,363429,3159,122
78123,2024,162,56,106,65,35,235778,3658,67
78124,2024,124,64,60,48,52,434551,5114,85
78125,2024,6,6,0,0,100,378650,3352,113
78126,2024,158,54,104,66,34,519214,5180,94
78128,2024,19,18,1,5,95,325156,3556,106
78133,2024,38,14,24,63,37,411671,4708,85
78138,2024,56,32,24,43,57,223144,3106,72
78140,2024,7,7,0,0,100,326500,3417,110
78143,2024,15,11,4,27,73,465763,4553,103
78146,2024,299,86,213,71,29,434935,5626,76
78147,2024,1,1,0,0,100,270100,2701,100
78152,2024,12,12,0,0,100,655129,4368,155
78158,2024,154,48,106,69,31,572016,5976,88
78160,2024,55,40,15,27,73,426529,4372,105
78162,2024,3,3,0,0,100,519917,4418,118
78163,2024,2,2,0,0,100,341800,4163,82
78164,2024,5,4,1,20,80,446300,3557,123
78165,2024,136,61,75,55,45,276533,3616,77
78168,2024,27,16,11,41,59,248442,3519,73
78171,2024,11,10,1,9,91,359676,3288,109
78172,2024,340,184,156,46,54,289922,3879,76
78185,2024,3,3,0,0,100,327833,3684,102
78188,2024,6,6,0,0,100,304833,2405,132
78189,2024,13,12,1,8,92,689166,4565,154
78190,2024,94,34,60,64,36,566204,6130,87
78192,2024,12,12,0,0,100,305935,2894,116
78193,2024,4,4,0,0,100,877165,5357,159
78194,2024,1,1,0,0,100,271930,3276,83
78196,2024,1,1,0,0,100,616350,3713,166
78202,2024,6,6,0,0,100,351885,3152,113
78206,2024,39,26,13,33,67,257827,3056,84
78208,2024,293,103,190,65,35,234851,2903,83
78209,2024,5,5,0,0,100,402821,3260,142
78217,2024,54,42,12,22,78,258659,3049,86
78220,2024,71,46,25,35,65,296419,3248,96
78224,2024,48,29,19,40,60,572617,5364,107
78227,2024,8,8,0,0,100,332956,3210,110
78230,2024,6,6,0,0,100,277748,2863,96
78231,2024,3,3,0,0,100,253667,2412,112
78233,2024,32,30,2,6,94,722986,4531,158
78236,2024,4,4,0,0,100,388592,2680,162
78237,2024,2,2,0,0,100,320500,2592,154
78238,2024,20,15,5,25,75,221975,3064,74
78239,2024,12,10,2,17,83,190600,2480,87
78242,2024,109,28,81,74,26,234375,3601,66
78245,2024,2,2,0,0,100,266150,2604,102
78246,2024,16,16,0,0,100,257016,2445,106
78255,2024,39,34,5,13,87,206208,2318,91
78261,2024,7,6,1,14,86,235721,2810,83
78262,2024,12,8,4,33,67,351097,3588,97
78263,2024,21,20,1,5,95,427016,3368,126
78265,2024,19,19,0,0,100,325169,3229,105
78267,2024,55,48,7,13,87,247985,3040,84
78269,2024,13,12,1,8,92,368436,3278,118
78276,2024,3,3,0,0,100,191680,1900,102
78278,2024,4,4,0,0,100,650075,3666,183
78281,2024,12,11,1,8,92,318097,3268,100
78283,2024,7,7,0,0,100,527957,3447,143
78285,2024,9,8,1,11,89,421591,3073,141
78289,2024,8,8,0,0,100,1250388,5457,226
78290,2024,7,7,0,0,100,226950,2463,92
78291,2024,17,16,1,6,94,252470,2704,102
78296,2024,4,4,0,0,100,276916,2285,128
78297,2024,146,40,106,73,27,287600,3885,75
78299,2024,27,20,7,26,74,273267,3744,79
78300,2024,2,2,0,0,100,297125,2656,110
78302,2024,3,3,0,0,100,735000,5193,137
78305,2024,1,1,0,0,100,422500,3225,131
78307,2024,10,10,0,0,100,416350,3092,137
78310,2024,38,14,24,63,37,237666,3380,75
78311,2024,352,146,206,59,41,345368,4979,70
78314,2024,41,36,5,12,88,285913,3290,86
78317,2024,6,6,0,0,100,325833,2858,117
78320,2024,2,2,0,0,100,380950,2959,132
78321,2024,67,58,9,13,87,398084,3540,117
78322,2024,42,18,24,57,43,410562,4780,89
78324,2024,5,5,0,0,100,360151,2931,124
78325,2024,5,5,0,0,100,381520,3144,115
78327,2024,44,32,12,27,73,235612,2833,84
78329,2024,11,11,0,0,100,270780,2263,120
78334,2024,16,16,0,0,100,335045,4035,86
78335,2024,114,80,34,30,70,230104,2876,81
78337,2024,21,19,2,10,90,227663,2456,98
78343,2024,9,9,0,0,100,632871,6079,117
78344,2024,4,4,0,0,100,208862,2629,81
78346,2024,23,18,5,22,78,257675,2603,107
78349,2024,5,5,0,0,100,299960,2838,111
78350,2024,69,17,52,75,25,524884,4517,114
78354,2024,46,42,4,9,91,235340,2547,94
78356,2024,61,42,19,31,69,373320,3807,101
78358,2024,263,68,195,74,26,567282,6213,87
78361,2024,274,53,221,81,19,163399,2552,65
78362,2024,154,92,62,40,60,198309,2773,75
78364,2024,8,8,0,0,100,367891,3810,102
78366,2024,3,3,0,0,100,368083,3319,118
78367,2024,36,27,9,25,75,660772,5840,117
78368,2024,13,11,2,15,85,448296,3236,143
78372,2024,173,29,144,83,17,326790,4151,79
78380,2024,53,48,5,9,91,334819,3343,103
78381,2024,8,7,1,12,88,349927,3389,103
78382,2024,40,31,9,22,78,325608,4006,86
78383,2024,198,93,105,53,47,244314,3014,83
78384,2024,11,10,1,9,91,578123,5970,107
78385,2024,1,1,0,0,100,236000,3471,68
78389,2024,19,17,2,11,89,487514,4053,117
78391,2024,2,2,0,0,100,177500,2189,58
78396,2024,49,29,20,41,59,639623,5274,121
78397,2024,71,51,20,28,72,360517,3751,101
78398,2024,7,7,0,0,100,557889,5286,106
78401,2024,106,29,77,73,27,163832,2661,64
78402,2024,35,28,7,20,80,356425,4119,91
78403,2024,20,17,3,15,85,248402,3185,85
78404,2024,2,2,0,0,100,658095,3845,168
78407,2024,3,3,0,0,100,304783,2083,153
78410,2024,13,12,1,8,92,232850,2482,97
78415,2024,4,4,0,0,100,361172,2988,118
78416,2024,5,2,3,60,40,256800,2825,86
78417,2024,2,1,1,50,50,280450,2198,126
78418,2024,123,51,72,59,41,371854,4675,79
78420,2024,29,20,9,31,69,446267,4856,92
78423,2024,236,73,163,69,31,314739,3971,80
78431,2024,23,23,0,0,100,478635,3619,134
78437,2024,10,10,0,0,100,213674,2220,106
78440,2024,142,64,78,55,45,184416,2397,77
78442,2024,43,20,23,53,47,353314,3749,91
78443,2024,9,6,3,33,67,271944,3199,90
78444,2024,9,9,0,0,100,245496,2152,120
78451,2024,10,8,2,20,80,293438,3545,86
78455,2024,60,37,23,38,62,612292,5244,116
78460,2024,9,9,0,0,100,533738,3410,136
78464,2024,8,8,0,0,100,280719,2984,104
78465,2024,26,25,1,4,96,342516,3632,99
78466,2024,76,56,20,26,74,515092,4328,119
78470,2024,6,4,2,33,67,268650,2480,110
78472,2024,2,2,0,0,100,178500,3018,62
78474,2024,10,10,0,0,100,359055,3526,107
78475,2024,1,1,0,0,100,291000,2670,109
78481,2024,160,30,130,81,19,391160,4836,80
78484,2024,4,4,0,0,100,273094,2756,98
78486,2024,73,50,23,32,68,282344,3462,85
78490,2024,252,88,164,65,35,241755,3120,78
78497,2024,10,10,0,0,100,599093,3416,168
78498,2024,336,58,278,83,17,253050,3849,67
78499,2024,8,8,0,0,100,319670,3058,108
78501,2024,23,22,1,4,96,258319,2843,102
78502,2024,46,5,41,89,11,316864,4639,67
78505,2024,4,4,0,0,100,306928,2687,116
78506,2024,10,10,0,0,100,358673,2582,142
78513,2024,23,15,8,35,65,357607,3857,94
78516,2024,12,12,0,0,100,299644,3323,96
78517,2024,304,111,193,63,37,295830,3869,79
78518,2024,1,1,0,0,100,1090000,4258,256
78520,2024,16,16,0,0,100,382664,3007,130
78522,2024,10,8,2,20,80,342934,2963,122
78528,2024,2,2,0,0,100,173050,2154,80
78530,2024,5,4,1,20,80,294100,4710,81
78531,2024,33,27,6,18,82,220155,2725,84
78536,2024,4,4,0,0,100,268262,3432,89
78537,2024,71,56,15,21,79,289931,3035,98
78545,2024,156,29,127,81,19,283528,4077,70
78548,2024,2,2,0,0,100,732852,4707,149
78550,2024,14,14,0,0,100,339601,2985,121
78551,2024,451,66,385,85,15,552779,6589,82
78557,2024,10,8,2,20,80,225829,2759,80
78558,2024,2,2,0,0,100,257500,2380,109
78559,2024,1,0,1,100,0,108108,1802,60
78561,2024,1,0,1,100,0,140000,3111,45
78562,2024,9,7,2,22,78,270242,3364,87
78564,2024,6,5,1,17,83,185800,2100,93
78567,2024,6,6,0,0,100,348502,2611,127
78569,2024,7,6,1,14,86,200143,2310,92
78571,2024,47,40,7,15,85,734055,5152,153
78575,2024,57,48,9,16,84,392849,4617,93
78576,2024,16,11,5,31,69,389475,3684,110
78586,2024,482,212,270,56,44,325476,4528,73
78588,2024,7,7,0,0,100,478635,4021,125
78590,2024,4,3,1,25,75,494959,4142,132
78591,2024,26,20,6,23,77,237379,2815,86
78597,2024,8,8,0,0,100,432994,2814,152
78601,2024,12,11,1,8,92,313297,3193,105
78605,2024,10,10,0,0,100,302316,3601,91
78606,2024,1,1,0,0,100,373000,2608,143
78608,2024,1,1,0,0,100,303000,2886,105
78609,2024,12,12,0,0,100,273018,2840,97
78615,2024,9,7,2,22,78,446336,4789,93
78616,2024,17,13,4,24,76,357162,3513,103
78618,2024,6,6,0,0,100,404592,2490,156
78620,2024,8,5,3,38,62,481794,5631,87
78621,2024,146,35,111,76,24,189125,2936,66
78623,2024,5,4,1,20,80,366240,3905,96
78624,2024,110,70,40,36,64,317421,3531,90
78638,2024,49,42,7,14,86,327020,3380,101
78640,2024,161,34,127,79,21,340360,4863,71
78642,2024,161,70,91,57,43,307657,3554,87
78643,2024,62,48,14,23,77,449002,4256,106
78644,2024,13,11,2,15,85,294826,4130,77
78646,2024,801,74,727,91,9,516522,6898,73
78647,2024,6,6,0,0,100,239221,3342,71
78650,2024,174,62,112,64,36,711039,6891,96
78653,2024,2,2,0,0,100,290000,6588,41
78655,2024,3,3,0,0,100,355975,2781,130
78668,2024,8,8,0,0,100,254027,2570,104
78672,2024,49,29,20,41,59,521677,4955,103
78674,2024,87,61,26,30,70,313549,3934,81
78677,2024,5,5,0,0,100,387200,2847,137
78681,2024,2,2,0,0,100,168700,2989,62
78683,2024,24,21,3,12,88,407586,3780,113
78686,2024,171,39,132,77,23,424678,6026,69
78688,2024,87,51,36,41,59,413166,4320,98
79001,2024,13,13,0,0,100,106698,1014,107
79002,2024,3,3,0,0,100,137000,1254,108
79003,2024,50,50,0,0,100,190522,1931,101
79005,2024,33,32,1,3,97,114658,1140,97
79007,2024,5,5,0,0,100,126712,1188,109
79008,2024,4,4,0,0,100,93452,1040,94
79009,2024,6,6,0,0,100,167000,1695,109
79010,2024,6,6,0,0,100,262825,1624,137
79012,2024,11,11,0,0,100,158545,1247,133
79013,2024,41,40,1,2,98,104846,1044,104
79014,2024,36,36,0,0,100,103193,1115,94
79015,2024,3,3,0,0,100,121667,1010,119
79016,2024,8,8,0,0,100,100865,937,112
79018,2024,4,4,0,0,100,83275,712,123
79019,2024,3,3,0,0,100,62667,798,89
79020,2024,10,10,0,0,100,152830,1388,117
79022,2024,4,4,0,0,100,102162,937,112
79024,2024,11,11,0,0,100,154864,1308,118
79025,2024,8,8,0,0,100,92875,964,104
79029,2024,8,8,0,0,100,136475,1398,99
79030,2024,11,11,0,0,100,114727,1015,114
79031,2024,30,29,1,3,97,150559,1592,98
79032,2024,11,11,0,0,100,122912,1269,98
79034,2024,14,14,0,0,100,239481,2036,114
79038,2024,14,14,0,0,100,124940,1203,102
79040,2024,4,4,0,0,100,178409,1352,116
79042,2024,2,2,0,0,100,50000,778,66
79046,2024,5,5,0,0,100,171000,1812,91
79047,2024,12,11,1,8,92,110127,1156,101
79048,2024,64,64,0,0,100,178593,1740,104
79049,2024,198,176,22,11,89,146118,1510,98
79050,2024,10,10,0,0,100,128316,1315,96
79055,2024,1,1,0,0,100,154000,1974,78
79056,2024,3,3,0,0,100,195333,1985,111
79057,2024,16,16,0,0,100,111293,1168,95
79058,2024,5,5,0,0,100,169822,1135,138
79059,2024,9,9,0,0,100,119411,1094,113
79061,2024,42,41,1,2,98,136198,1347,101
79062,2024,61,58,3,5,95,138969,1382,100
79063,2024,19,19,0,0,100,108388,1188,90
79064,2024,13,13,0,0,100,171626,1459,125
79066,2024,13,13,0,0,100,144856,1469,101
79069,2024,11,11,0,0,100,118138,1122,106
79070,2024,3,3,0,0,100,128667,1281,100
79071,2024,8,8,0,0,100,177104,1362,138
79074,2024,3,3,0,0,100,82857,766,107
79076,2024,27,27,0,0,100,129170,1335,98
79077,2024,14,14,0,0,100,98594,1023,98
79078,2024,9,9,0,0,100,156894,1275,130
79079,2024,85,85,0,0,100,151238,1455,106
79080,2024,39,39,0,0,100,126394,1412,90
79081,2024,80,67,13,16,84,186505,2077,92
79083,2024,29,29,0,0,100,110669,1160,105
79084,2024,12,12,0,0,100,92981,724,129
79085,2024,2,2,0,0,100,67272,736,85
79086,2024,18,18,0,0,100,200570,1591,126
79087,2024,6,6,0,0,100,146356,1192,110
79088,2024,25,25,0,0,100,133168,1176,108
79089,2024,6,6,0,0,100,104133,1074,101
79090,2024,16,16,0,0,100,119566,1121,119
79091,2024,9,9,0,0,100,127934,1347,97
79092,2024,5,5,0,0,100,64600,659,108
79094,2024,11,11,0,0,100,102433,967,108
79095,2024,11,11,0,0,100,126999,1007,125
79096,2024,12,12,0,0,100,108238,1145,95
79100,2024,33,32,1,3,97,171031,1846,91
79101,2024,29,29,0,0,100,111655,1323,86
79102,2024,6,6,0,0,100,92811,944,95
79103,2024,39,39,0,0,100,116762,1106,100
79104,2024,3,3,0,0,100,213333,1476,152
79105,2024,7,7,0,0,100,123171,1147,102
79106,2024,2,2,0,0,100,199195,1313,132
79108,2024,1,1,0,0,100,69990,737,95
79109,2024,40,40,0,0,100,231713,1983,118
79111,2024,6,6,0,0,100,84742,869,97
79112,2024,5,5,0,0,100,210736,1869,114
79114,2024,17,12,5,29,71,117747,1339,87
79115,2024,10,10,0,0,100,107774,1165,98
79116,2024,15,15,0,0,100,122281,1169,102
79117,2024,4,4,0,0,100,136188,1454,102
79118,2024,5,5,0,0,100,160151,1255,126
79119,2024,9,9,0,0,100,104717,1010,94
79120,2024,12,12,0,0,100,96621,1253,85
79121,2024,1,1,0,0,100,181300,1498,121
79122,2024,6,6,0,0,100,116200,1142,102
79123,2024,19,19,0,0,100,114946,1008,115
79124,2024,16,12,4,25,75,114109,1355,85
79125,2024,20,20,0,0,100,177999,1624,107
79126,2024,4,4,0,0,100,176550,1624,108
79127,2024,8,8,0,0,100,129625,1051,123
79128,2024,9,9,0,0,100,196822,1913,102
79129,2024,14,14,0,0,100,228636,1858,121
79130,2024,44,41,3,7,93,168058,1651,104
79131,2024,9,9,0,0,100,94103,963,99
79132,2024,3,3,0,0,100,88667,1083,81
79133,2024,12,12,0,0,100,241932,1819,149
79134,2024,8,8,0,0,100,95814,877,110
79135,2024,16,16,0,0,100,140250,1310,108
79136,2024,16,16,0,0,100,123583,1245,102
79137,2024,13,13,0,0,100,189627,1916,101
79140,2024,11,11,0,0,100,154941,1115,148
79141,2024,2,2,0,0,100,83500,1091,80
79144,2024,4,4,0,0,100,153012,1279,118
79145,2024,5,5,0,0,100,106170,1104,95
79147,2024,8,8,0,0,100,100315,1052,92
79148,2024,24,24,0,0,100,107747,986,113
79149,2024,1,1,0,0,100,146000,1825,80
79150,2024,10,10,0,0,100,138984,1178,115
79152,2024,5,5,0,0,100,118830,982,112
79153,2024,3,3,0,0,100,69625,848,83
79154,2024,3,3,0,0,100,88187,636,123
79156,2024,4,4,0,0,100,70088,934,84
79157,2024,12,12,0,0,100,98213,1170,86
79158,2024,3,3,0,0,100,106667,866,123
79159,2024,1,1,0,0,100,170000,1910,89
79160,2024,2,2,0,0,100,202552,1214,171
79161,2024,6,6,0,0,100,136633,1189,109
79162,2024,33,33,0,0,100,181764,1922,103
79163,2024,11,11,0,0,100,105692,1111,106
79164,2024,3,3,0,0,100,122922,1254,99
79165,2024,4,4,0,0,100,91648,823,103
79166,2024,5,5,0,0,100,123552,1187,101
79170,2024,34,33,1,3,97,171506,1940,89
79172,2024,13,13,0,0,100,101214,936,106
79174,2024,60,59,1,2,98,123058,1153,110
79175,2024,3,3,0,0,100,131067,1381,92
79176,2024,14,14,0,0,100,100850,1012,102
79179,2024,53,53,0,0,100,122366,1243,103
79180,2024,1,1,0,0,100,30000,395,76
79183,2024,6,6,0,0,100,143218,1299,110
79184,2024,27,27,0,0,100,99322,978,107
79185,2024,42,42,0,0,100,171012,1531,116
79189,2024,22,22,0,0,100,133417,1396,101
79190,2024,3,3,0,0,100,126837,1018,127
79191,2024,929,619,310,33,67,164266,2076,80
79195,2024,53,52,1,2,98,134409,1302,106
79196,2024,36,36,0,0,100,100584,990,102
79197,2024,1,1,0,0,100,35400,708,50
79198,2024,2,2,0,0,100,82500,998,81
79200,2024,5,5,0,0,100,119740,1057,119
79201,2024,16,16,0,0,100,96454,1036,96
79202,2024,177,129,48,27,73,110316,1324,85
79203,2024,8,8,0,0,100,92750,834,117
79204,2024,7,7,0,0,100,138572,1053,134
79205,2024,3,3,0,0,100,79333,794,120
79207,2024,5,5,0,0,100,142142,1434,101
79208,2024,10,10,0,0,100,129648,1319,104
79209,2024,3,3,0,0,100,88800,939,94
79210,2024,7,7,0,0,100,153844,1442,110
79212,2024,2,2,0,0,100,80556,1230,60
79213,2024,20,20,0,0,100,151640,1522,100
79215,2024,9,9,0,0,100,118962,883,138
79216,2024,22,22,0,0,100,180771,1922,98
79217,2024,7,7,0,0,100,159376,1352,119
79218,2024,4,4,0,0,100,107112,925,115
79220,2024,6,6,0,0,100,247410,1870,138
79223,2024,1,1,0,0,100,220000,1222,180
79225,2024,10,10,0,0,100,91775,970,94
79226,2024,3,3,0,0,100,82333,902,88
79229,2024,9,9,0,0,100,160889,1378,119
79230,2024,6,6,0,0,100,86650,938,94
79231,2024,12,12,0,0,100,153105,1352,115
79235,2024,9,9,0,0,100,141823,1375,97
79236,2024,5,5,0,0,100,166000,1223,132
79238,2024,7,7,0,0,100,70493,900,83
79239,2024,27,27,0,0,100,118399,1257,94
79241,2024,3,3,0,0,100,200089,1366,140
79242,2024,11,11,0,0,100,134168,1185,109
79243,2024,6,6,0,0,100,81125,747,124
79244,2024,4,4,0,0,100,140562,1258,106
79246,2024,6,6,0,0,100,114277,1106,102
79249,2024,23,22,1,4,96,218468,1989,110
79250,2024,2,2,0,0,100,166280,1434,117
79251,2024,13,13,0,0,100,138515,1184,123
79252,2024,2,2,0,0,100,115000,1096,100
79253,2024,4,4,0,0,100,163875,1174,144
79254,2024,8,8,0,0,100,161403,1400,112
79255,2024,3,3,0,0,100,124667,933,150
79256,2024,4,4,0,0,100,109650,1006,114
79257,2024,18,18,0,0,100,164066,1534,109
79258,2024,6,6,0,0,100,102108,953,97
79259,2024,20,20,0,0,100,108919,1210,91
79263,2024,13,13,0,0,100,130615,1124,119
79265,2024,7,7,0,0,100,126179,1024,123
79267,2024,7,7,0,0,100,236268,2425,105
79268,2024,13,13,0,0,100,98121,986,102
79269,2024,2,2,0,0,100,199000,2204,89
79270,2024,86,83,3,3,97,120534,1265,101
79271,2024,3,3,0,0,100,128483,1853,69
79273,2024,5,5,0,0,100,131500,1233,110
79274,2024,1,1,0,0,100,45000,536,84
79276,2024,7,7,0,0,100,207579,1800,107
79277,2024,10,10,0,0,100,138373,1344,101
79278,2024,4,4,0,0,100,88690,984,84
79280,2024,11,11,0,0,100,109715,1132,98
79281,2024,19,19,0,0,100,231970,2058,111
79283,2024,17,17,0,0,100,252800,1935,129
79284,2024,11,11,0,0,100,168082,1540,115
79285,2024,19,19,0,0,100,130621,1247,110
79286,2024,4,4,0,0,100,157794,1334,122
79289,2024,13,13,0,0,100,183996,1759,106
79290,2024,12,12,0,0,100,177975,1568,113
79293,2024,9,9,0,0,100,231044,1994,133
79294,2024,1,1,0,0,100,62000,689,90
79295,2024,4,4,0,0,100,129250,1359,98
79297,2024,7,7,0,0,100,106243,846,135
79298,2024,7,7,0,0,100,179810,1756,104
79299,2024,26,26,0,0,100,106513,1074,102
79300,2024,9,9,0,0,100,127444,1416,84
79301,2024,12,12,0,0,100,99251,1008,104
79302,2024,18,18,0,0,100,144176,1254,116
79303,2024,2,2,0,0,100,34200,468,72
79304,2024,4,4,0,0,100,112625,1294,84
79306,2024,3,3,0,0,100,125000,1739,84
79307,2024,27,27,0,0,100,90309,932,94
79308,2024,5,5,0,0,100,188300,1891,98
79309,2024,3,3,0,0,100,200603,1844,109
79311,2024,45,45,0,0,100,114733,1176,98
79312,2024,2,2,0,0,100,85000,746,104
79313,2024,4,4,0,0,100,70500,658,112
79316,2024,3,3,0,0,100,57333,740,80
79319,2024,8,8,0,0,100,125538,1422,100
79320,2024,7,7,0,0,100,141643,1147,121
79322,2024,16,16,0,0,100,164250,1655,105
79326,2024,16,16,0,0,100,96107,1061,98
79329,2024,232,219,13,6,94,110447,1224,91
79331,2024,2,2,0,0,100,78000,698,103
79332,2024,1,1,0,0,100,199680,1280,156
79334,2024,14,14,0,0,100,183116,1457,124
79335,2024,9,9,0,0,100,199657,1396,145
79336,2024,4,4,0,0,100,77625,876,87
79337,2024,10,10,0,0,100,157006,1638,96
79338,2024,4,4,0,0,100,139882,1036,128
79339,2024,32,32,0,0,100,136089,1296,104
79340,2024,4,4,0,0,100,156250,1608,100
79342,2024,7,7,0,0,100,150579,1405,111
79343,2024,1,1,0,0,100,142000,1291,110
79345,2024,9,9,0,0,100,118594,1142,103
79346,2024,4,4,0,0,100,160242,1380,116
79347,2024,6,6,0,0,100,160050,1546,106
79348,2024,2,2,0,0,100,47500,625,80
79349,2024,7,7,0,0,100,90019,804,101
79351,2024,16,16,0,0,100,163730,1432,121
79352,2024,2,2,0,0,100,113250,764,149
79354,2024,3,3,0,0,100,140367,1195,118
79355,2024,38,38,0,0,100,223935,2113,110
79357,2024,5,5,0,0,100,138000,1354,111
80001,2024,242,179,63,26,74,133111,1700,82
80002,2024,2,2,0,0,100,68500,1050,64
80003,2024,4,4,0,0,100,155000,1295,122
80004,2024,3,3,0,0,100,90067,1097,88
80006,2024,4,4,0,0,100,144250,1645,86
80008,2024,5,5,0,0,100,108991,922,122
80009,2024,9,9,0,0,100,180300,1731,108
80010,2024,25,25,0,0,100,155954,1819,92
80011,2024,30,30,0,0,100,162022,2100,81
80013,2024,14,14,0,0,100,119411,1286,90
80016,2024,132,114,18,14,86,109136,1399,80
80017,2024,4,4,0,0,100,128250,1265,101
80018,2024,1,1,0,0,100,104100,2539,41
80019,2024,8,8,0,0,100,126931,1467,103
80020,2024,2,2,0,0,100,368000,2393,153
80021,2024,1388,731,657,47,53,170251,2459,71
80022,2024,3,3,0,0,100,156733,1902,83
80023,2024,3,3,0,0,100,174167,1801,100
80024,2024,3,3,0,0,100,304667,3133,99
80025,2024,5,5,0,0,100,116440,1407,81
80027,2024,1,1,0,0,100,173832,1348,129
80028,2024,1,1,0,0,100,194700,1391,140
80029,2024,8,8,0,0,100,167125,2218,77
80030,2024,2,2,0,0,100,132000,2216,60
80031,2024,9,9,0,0,100,110500,1290,84
80033,2024,2,2,0,0,100,270798,1430,193
80034,2024,5,5,0,0,100,111480,1161,110
80035,2024,3,3,0,0,100,168450,1635,103
80036,2024,5,5,0,0,100,170530,1713,97
80037,2024,2,2,0,0,100,147000,1706,86
80039,2024,67,40,27,40,60,153908,2690,59
80040,2024,2,2,0,0,100,54000,476,112
80041,2024,1,1,0,0,100,75000,1500,50
80042,2024,1,1,0,0,100,60000,968,62
80043,2024,3,3,0,0,100,131000,1174,124
80044,2024,1,1,0,0,100,70000,946,74
80045,2024,1,1,0,0,100,90000,1385,65
80047,2024,2,2,0,0,100,126850,1542,88
80048,2024,1,1,0,0,100,88000,1956,45
80049,2024,2,2,0,0,100,131000,1242,100
80050,2024,2,2,0,0,100,238500,1558,154
80051,2024,2,2,0,0,100,124916,1062,110
80052,2024,1,1,0,0,100,104500,1900,55
80053,2024,1,1,0,0,100,87990,1173,75
80054,2024,3,3,0,0,100,143333,986,144
80055,2024,2,2,0,0,100,60000,1214,58
80057,2024,1,1,0,0,100,90000,811,111
80058,2024,1,1,0,0,100,160700,1362,118
80059,2024,2,2,0,0,100,110000,1130,130
80060,2024,2,2,0,0,100,149000,1858,103
80062,2024,6,6,0,0,100,94833,1234,76
80063,2024,11,11,0,0,100,133557,1465,96
80064,2024,3,3,0,0,100,203333,1747,118
80066,2024,5,5,0,0,100,104800,1089,94
80067,2024,3,3,0,0,100,113940,1357,85
80068,2024,1,1,0,0,100,325000,2600,125
80069,2024,1,1,0,0,100,147150,1472,100
80070,2024,11,11,0,0,100,137632,1517,92
80071,2024,24,24,0,0,100,133630,1438,92
80073,2024,1,1,0,0,100,213000,2173,98
80076,2024,5,5,0,0,100,180858,1588,115
80077,2024,2,2,0,0,100,286938,1930,142
80078,2024,2,2,0,0,100,222500,1710,132
80079,2024,6,6,0,0,100,164767,1587,100
80080,2024,1,1,0,0,100,149190,1344,111
80082,2024,8,8,0,0,100,139092,1508,98
80083,2024,1,1,0,0,100,120000,1263,95
80084,2024,2,2,0,0,100,126000,1266,100
80086,2024,10,10,0,0,100,160607,1360,110
80087,2024,1,1,0,0,100,163700,1364,120
80088,2024,6,6,0,0,100,145077,1292,115
80089,2024,3,3,0,0,100,174968,1587,116
80090,2024,2,2,0,0,100,82750,790,92
80092,2024,4,4,0,0,100,307875,2212,122
80093,2024,13,13,0,0,100,131074,1374,93
80094,2024,4,4,0,0,100,214625,2390,89
80095,2024,3,3,0,0,100,89000,789,115
80096,2024,10,10,0,0,100,140870,1463,95
80098,2024,3,3,0,0,100,84667,1279,64
80099,2024,1,1,0,0,100,135900,1416,96
80100,2024,1,1,0,0,100,187680,1277,147
80101,2024,14,14,0,0,100,136893,1448,100
80102,2024,6,6,0,0,100,91367,1222,79
80103,2024,1,1,0,0,100,47000,495,95
80105,2024,6,6,0,0,100,126500,1378,87
80106,2024,4,4,0,0,100,148750,1439,103
80107,2024,8,8,0,0,100,211912,2414,84
80108,2024,2,2,0,0,100,116500,877,132
80109,2024,7,7,0,0,100,109429,1217,91
80110,2024,2,2,0,0,100,205000,2870,74
80112,2024,4,4,0,0,100,153025,1546,94
80113,2024,2,2,0,0,100,120000,1546,76
80114,2024,5,5,0,0,100,175300,1489,110
80115,2024,2,2,0,0,100,121000,1339,90
80116,2024,3,3,0,0,100,139797,1279,130
80117,2024,2,2,0,0,100,100000,1303,89
80118,2024,1,1,0,0,100,90000,909,99
80119,2024,5,5,0,0,100,154750,2150,87
80120,2024,6,6,0,0,100,146995,1584,97
80121,2024,1,1,0,0,100,155000,969,160
80122,2024,6,6,0,0,100,117183,1310,90
80123,2024,2,2,0,0,100,172500,1618,102
80124,2024,10,10,0,0,100,167860,1754,96
80125,2024,1,1,0,0,100,168500,1204,140
80126,2024,8,8,0,0,100,123025,1386,89
80127,2024,6,6,0,0,100,136908,1634,85
80128,2024,1,1,0,0,100,132500,1325,100
80129,2024,5,5,0,0,100,184360,1201,151
80130,2024,5,5,0,0,100,247390,1969,129
80131,2024,41,38,3,7,93,198010,2135,92
80133,2024,1,1,0,0,100,250000,2841,88
80135,2024,3,3,0,0,100,79333,1562,44
80136,2024,9,9,0,0,100,104333,1415,75
80137,2024,9,9,0,0,100,162261,1720,97
80138,2024,2,2,0,0,100,225000,1805,125
80139,2024,1,1,0,0,100,139250,1352,103
80140,2024,1,1,0,0,100,40000,381,105
80141,2024,2,2,0,0,100,169900,1253,120
80142,2024,7,7,0,0,100,218929,1951,119
80143,2024,2,2,0,0,100,58750,554,100
80144,2024,5,5,0,0,100,98140,929,103
80145,2024,2,2,0,0,100,78928,830,82
80146,2024,1,1,0,0,100,253000,1961,129
80147,2024,3,3,0,0,100,152917,1469,102
80148,2024,3,3,0,0,100,110067,1473,73
80149,2024,5,5,0,0,100,248400,1932,141
80150,2024,4,4,0,0,100,168400,1235,135
80151,2024,1,1,0,0,100,254534,1497,170
80152,2024,1,1,0,0,100,70192,585,120
80153,2024,1,1,0,0,100,90000,750,120
80154,2024,3,3,0,0,100,45667,472,87
80155,2024,3,3,0,0,100,216067,1549,139
80156,2024,2,2,0,0,100,250000,2206,109
80157,2024,1,1,0,0,100,235000,1399,168
80159,2024,1,1,0,0,100,276450,2737,101
80160,2024,8,8,0,0,100,248500,2341,103
80161,2024,2,2,0,0,100,116150,1654,68
80162,2024,12,12,0,0,100,137129,1688,82
80163,2024,4,4,0,0,100,163145,1558,100
80164,2024,31,31,0,0,100,212564,2122,100
80166,2024,8,8,0,0,100,130588,1478,89
80167,2024,6,6,0,0,100,116083,1269,84
80168,2024,9,9,0,0,100,134372,1517,91
80170,2024,2,2,0,0,100,56000,720,79
80171,2024,4,4,0,0,100,239606,1951,134
80172,2024,6,6,0,0,100,90850,1169,82
80173,2024,3,3,0,0,100,239417,1911,127
80176,2024,2,2,0,0,100,164995,1540,106
80177,2024,12,12,0,0,100,98267,1105,88
80179,2024,2,2,0,0,100,89252,1146,89
80182,2024,102,71,31,30,70,155048,2891,56
80183,2024,1,1,0,0,100,140000,1818,77
80184,2024,5,5,0,0,100,191807,1987,99
80185,2024,2,2,0,0,100,192900,1682,114
80186,2024,17,17,0,0,100,122988,1231,102
80187,2024,7,7,0,0,100,222974,2078,106
80188,2024,1,1,0,0,100,80000,1159,69
80190,2024,7,7,0,0,100,178829,1815,102
80191,2024,1,1,0,0,100,116000,1275,91
80192,2024,1,1,0,0,100,24000,857,28
80193,2024,1,1,0,0,100,95000,1267,75
80194,2024,2,2,0,0,100,128000,1282,100
80196,2024,1,1,0,0,100,82000,1065,77
80197,2024,2,2,0,0,100,101000,1286,82
80198,2024,2,2,0,0,100,252000,2092,118
80199,2024,6,6,0,0,100,117592,1407,88
80202,2024,3,3,0,0,100,282500,1841,148
80204,2024,11,11,0,0,100,107479,1160,100
80205,2024,9,9,0,0,100,121789,1289,100
80206,2024,1,1,0,0,100,115000,719,160
80207,2024,3,3,0,0,100,94233,984,106
80208,2024,2,2,0,0,100,84375,669,126
80210,2024,1,1,0,0,100,56000,767,73
80211,2024,14,13,1,7,93,115919,1399,86
80212,2024,65,56,9,14,86,158424,2009,81
80213,2024,1,1,0,0,100,236700,1807,131
80214,2024,4,4,0,0,100,134250,1064,124
80216,2024,2,2,0,0,100,106945,1054,110
80217,2024,1,1,0,0,100,30000,417,72
80218,2024,1,1,0,0,100,115000,1278,90
80220,2024,1,1,0,0,100,110000,1447,76
80221,2024,5,5,0,0,100,175140,1641,115
80222,2024,22,22,0,0,100,135600,1427,105
80224,2024,2,2,0,0,100,95995,1118,87
80226,2024,5,5,0,0,100,68632,1129,61
80228,2024,69,45,24,35,65,248587,4501,57
80229,2024,7,6,1,14,86,177314,1485,135
80230,2024,2,2,0,0,100,79500,1103,74
80231,2024,2,2,0,0,100,134500,1089,122
80233,2024,1,1,0,0,100,92000,681,135
80234,2024,6,6,0,0,100,180325,1781,104
80235,2024,20,20,0,0,100,123668,1659,74
80236,2024,9,9,0,0,100,95017,1278,74
80237,2024,7,7,0,0,100,165903,1664,97
80238,2024,6,6,0,0,100,140483,1430,96
80240,2024,14,14,0,0,100,155211,1442,107
80241,2024,11,11,0,0,100,121328,1192,111
80242,2024,3,3,0,0,100,169850,1724,108
80243,2024,1,1,0,0,100,60000,556,108
80245,2024,5,5,0,0,100,140400,1115,124
80246,2024,3,3,0,0,100,134333,1413,89
80247,2024,11,11,0,0,100,100055,1063,103
80248,2024,10,10,0,0,100,97080,1238,88
80249,2024,3,3,0,0,100,98000,1013,103
80250,2024,4,4,0,0,100,108912,1217,94
80251,2024,2,2,0,0,100,236500,1670,138
80252,2024,4,4,0,0,100,92500,1132,79
80253,2024,55,51,4,7,93,107377,1503,79
80256,2024,23,15,8,35,65,147829,1951,77
80258,2024,2,2,0,0,100,116596,1055,116
80260,2024,7,7,0,0,100,193050,1881,105
80261,2024,9,9,0,0,100,464907,3254,138
80264,2024,2,2,0,0,100,86500,1173,84
80265,2024,12,12,0,0,100,125855,1441,100
80267,2024,3,3,0,0,100,82667,1155,67
80268,2024,7,7,0,0,100,194457,1949,99
80269,2024,2,2,0,0,100,77500,837,87
80271,2024,13,13,0,0,100,81527,1057,79
80272,2024,3,3,0,0,100,122179,879,134
80273,2024,2,2,0,0,100,205950,1842,120
80274,2024,17,16,1,6,94,99059,1113,89
80275,2024,3,3,0,0,100,70000,687,103
80276,2024,3,3,0,0,100,149667,2234,71
80278,2024,2,2,0,0,100,64700,1273,51
80279,2024,2,2,0,0,100,105000,1360,82
80281,2024,2,2,0,0,100,210000,2628,82
80282,2024,13,13,0,0,100,157767,1651,96
80283,2024,2,2,0,0,100,201100,1592,130
80284,2024,7,6,1,14,86,101404,1233,83
80285,2024,3,3,0,0,100,159125,1781,99
80288,2024,4,4,0,0,100,140075,1881,94
80290,2024,1,1,0,0,100,105000,847,124
80291,2024,1,1,0,0,100,307900,2483,124
80292,2024,4,4,0,0,100,89685,1063,81
80293,2024,3,3,0,0,100,173167,1786,101
80295,2024,6,6,0,0,100,82500,1189,70
80296,2024,13,13,0,0,100,98677,968,98
80298,2024,4,4,0,0,100,93350,1336,68
80299,2024,7,7,0,0,100,108907,1085,104
80300,2024,1,1,0,0,100,58000,1018,57
80301,2024,2,2,0,0,100,72500,668,111
80303,2024,8,8,0,0,100,273669,2409,118
80305,2024,4,4,0,0,100,318312,2036,155
80306,2024,4,4,0,0,100,143982,1665,85
80307,2024,1,1,0,0,100,165000,1000,165
80308,2024,19,19,0,0,100,119433,1458,88
80310,2024,5,5,0,0,100,108850,1284,96
80312,2024,1,1,0,0,100,55000,655,84
80313,2024,2,2,0,0,100,95000,1030,100
80314,2024,2,2,0,0,100,123750,1250,104
80315,2024,4,4,0,0,100,232250,2289,104
80316,2024,15,15,0,0,100,195700,2115,94
80317,2024,1,1,0,0,100,110000,1236,89
80318,2024,38,38,0,0,100,116504,1321,87
80319,2024,3,3,0,0,100,190120,2548,75
80321,2024,1,1,0,0,100,142000,1257,113
80322,2024,5,5,0,0,100,109998,1354,85
80324,2024,1,1,0,0,100,101000,1804,56
80326,2024,1,1,0,0,100,150000,1429,105
80327,2024,2,2,0,0,100,198750,1310,156
80328,2024,6,6,0,0,100,90925,1106,82
80329,2024,2,2,0,0,100,140130,1130,124
80330,2024,1,1,0,0,100,72000,973,74
80331,2024,10,10,0,0,100,135675,1376,100
80332,2024,3,3,0,0,100,106667,1396,86
80333,2024,133,60,73,55,45,184411,4024,50
80335,2024,4,4,0,0,100,115375,851,118
80337,2024,1,1,0,0,100,214800,2285,94
80338,2024,23,21,2,9,91,129722,1676,79
80339,2024,2,2,0,0,100,145750,1762,76
80341,2024,3,3,0,0,100,96667,1223,80
80342,2024,7,7,0,0,100,145764,1161,117
80343,2024,1,1,0,0,100,106700,2371,45
80344,2024,2,2,0,0,100,227925,2140,114
80345,2024,2,2,0,0,100,88000,1138,75
80347,2024,2,2,0,0,100,57500,1644,54
80350,2024,4,4,0,0,100,200800,1832,113
80351,2024,2,2,0,0,100,403800,1488,273
80352,2024,1,1,0,0,100,109000,1267,86
80353,2024,2,2,0,0,100,89500,1004,93
80356,2024,3,3,0,0,100,119167,1186,100
80357,2024,3,3,0,0,100,216933,1899,131
80358,2024,1,1,0,0,100,50000,625,80
80359,2024,2,2,0,0,100,169000,806,210
80360,2024,21,21,0,0,100,128091,1574,84
80361,2024,1,1,0,0,100,150000,1471,102
80362,2024,1,1,0,0,100,235000,2527,93
80364,2024,10,10,0,0,100,107066,1331,82
80365,2024,2,2,0,0,100,115000,1168,106
80366,2024,3,3,0,0,100,72717,908,74
80367,2024,10,10,0,0,100,95992,1221,77
80368,2024,43,38,5,12,88,129809,1595,84
80369,2024,2,2,0,0,100,125100,1582,78
80371,2024,1,1,0,0,100,199450,2849,70
80372,2024,1,1,0,0,100,110000,932,118
80373,2024,23,23,0,0,100,114085,1464,77
80374,2024,1,1,0,0,100,170000,1977,86
80375,2024,1,1,0,0,100,157000,1784,88
80376,2024,5,5,0,0,100,177100,1872,92
80377,2024,5,5,0,0,100,104700,1038,94
80378,2024,2,2,0,0,100,69950,857,84
80379,2024,4,4,0,0,100,410838,2855,148
80380,2024,3,3,0,0,100,78333,952,84
80381,2024,1,1,0,0,100,168000,1244,135
80383,2024,1,1,0,0,100,175000,1842,95
80384,2024,4,4,0,0,100,109250,1463,76
80385,2024,7,7,0,0,100,207148,2079,97
80386,2024,2,2,0,0,100,140500,2575,52
80387,2024,4,4,0,0,100,288125,2311,124
80388,2024,2,2,0,0,100,141000,1438,96
80390,2024,3,3,0,0,100,146867,1355,107
80391,2024,3,3,0,0,100,106000,1180,86
80392,2024,3,3,0,0,100,71167,818,78
80393,2024,5,5,0,0,100,217902,1987,116
80395,2024,7,7,0,0,100,111314,1184,99
80396,2024,4,4,0,0,100,137650,1519,93
80397,2024,2,2,0,0,100,138950,1230,113
80399,2024,4,4,0,0,100,324462,2057,145
80400,2024,5,5,0,0,100,135200,1486,91
80401,2024,1,1,0,0,100,115000,1420,81
80403,2024,1,1,0,0,100,114000,1629,70
80404,2024,2,2,0,0,100,167303,1881,90
80405,2024,2,2,0,0,100,221500,1585,138
80406,2024,12,12,0,0,100,140721,1225,111
80407,2024,1,1,0,0,100,40000,741,54
80408,2024,2,2,0,0,100,254050,2560,100
80409,2024,1,1,0,0,100,38000,776,49
80410,2024,55,55,0,0,100,102996,1128,95
80411,2024,6,6,0,0,100,125833,2002,62
80412,2024,7,7,0,0,100,221729,1954,117
80413,2024,1,1,0,0,100,142000,1711,83
80414,2024,2,2,0,0,100,132500,1886,70
80415,2024,7,7,0,0,100,142400,1712,87
80416,2024,9,9,0,0,100,127611,1718,73
80417,2024,10,10,0,0,100,103895,1029,91
80418,2024,1,1,0,0,100,125500,1141,110
80420,2024,2,2,0,0,100,150000,1340,108
80421,2024,5,5,0,0,100,200640,1661,119
80422,2024,6,6,0,0,100,116500,1846,66
80423,2024,6,6,0,0,100,184167,2084,98
80424,2024,4,4,0,0,100,298400,3102,103
80425,2024,3,3,0,0,100,119817,1162,101
80426,2024,3,3,0,0,100,112800,1545,70
80427,2024,3,3,0,0,100,152300,1546,99
80428,2024,1,1,0,0,100,36000,643,56
80429,2024,3,3,0,0,100,171333,1835,93
80430,2024,1,1,0,0,100,335000,1580,212
80431,2024,8,8,0,0,100,152094,1195,122
80432,2024,2,2,0,0,100,118500,898,110
80434,2024,1,1,0,0,100,288200,1947,148
80436,2024,6,6,0,0,100,123534,1284,99
80438,2024,7,7,0,0,100,143423,1364,97
80439,2024,2,2,0,0,100,120000,1293,111
80440,2024,3,3,0,0,100,132024,1338,102
80442,2024,17,17,0,0,100,119688,1392,87
80443,2024,19,19,0,0,100,148754,1346,118
80444,2024,5,5,0,0,100,161840,1258,120
80445,2024,2,2,0,0,100,81000,811,108
80446,2024,7,7,0,0,100,154714,1772,96
80450,2024,1,1,0,0,100,80000,952,84
80452,2024,4,4,0,0,100,202250,1794,110
80455,2024,1,1,0,0,100,163000,2508,65
80456,2024,6,6,0,0,100,126483,1338,117
80458,2024,1,1,0,0,100,232000,2275,102
80459,2024,1,1,0,0,100,75000,701,107
80461,2024,1,1,0,0,100,382000,3183,120
80462,2024,3,3,0,0,100,242500,1991,115
80463,2024,11,11,0,0,100,166665,1278,126
80464,2024,19,19,0,0,100,147168,2226,75
80467,2024,1,1,0,0,100,80000,941,85
80468,2024,1,1,0,0,100,106000,1019,104
80469,2024,3,3,0,0,100,226250,1623,143
80472,2024,2,2,0,0,100,80750,760,108
80473,2024,5,5,0,0,100,121080,1370,86
80474,2024,5,5,0,0,100,135300,1232,110
80475,2024,6,6,0,0,100,118827,1265,91
80476,2024,6,6,0,0,100,129167,1264,95
80477,2024,2,2,0,0,100,165000,1907,84
80478,2024,4,4,0,0,100,179500,1302,148
80479,2024,3,3,0,0,100,89267,1016,102
80480,2024,1,1,0,0,100,90000,968,93
80481,2024,6,6,0,0,100,128482,1432,96
80482,2024,2,2,0,0,100,201500,1268,159
80484,2024,5,5,0,0,100,73500,694,102
80485,2024,3,3,0,0,100,300400,1977,140
80486,2024,11,11,0,0,100,79595,1347,70
80487,2024,4,4,0,0,100,109936,1324,96
80488,2024,22,22,0,0,100,103554,2046,62
80489,2024,63,51,12,19,81,155346,1948,81
80490,2024,1,1,0,0,100,198000,1692,117
80493,2024,3,3,0,0,100,169950,1256,142
80494,2024,1,1,0,0,100,139000,1219,114
80495,2024,3,3,0,0,100,78950,941,89
80496,2024,4,4,0,0,100,224875,1430,150
80497,2024,5,5,0,0,100,144794,1440,105
80498,2024,8,8,0,0,100,103600,1065,101
80499,2024,1,1,0,0,100,110000,1467,75
80500,2024,4,4,0,0,100,156810,1895,83
80501,2024,4,4,0,0,100,108278,1099,101
80502,2024,3,3,0,0,100,133833,1242,111
80503,2024,2,2,0,0,100,123000,1328,104
80504,2024,1,1,0,0,100,70000,1029,68
80505,2024,2,2,0,0,100,218000,2562,90
80507,2024,11,11,0,0,100,183232,1932,94
80508,2024,1,1,0,0,100,72000,1161,62
80509,2024,3,3,0,0,100,101000,1138,88
80511,2024,1,1,0,0,100,139000,1363,102
80512,2024,9,9,0,0,100,128667,1638,85
80513,2024,3,3,0,0,100,120054,1330,97
80514,2024,2,2,0,0,100,102450,713,125
80515,2024,2,2,0,0,100,100100,1018,91
80518,2024,4,4,0,0,100,166725,1573,111
80519,2024,1,1,0,0,100,40000,667,60
80520,2024,3,3,0,0,100,83000,1044,72
80521,2024,4,4,0,0,100,117500,966,114
80523,2024,14,14,0,0,100,162974,1688,96
80524,2024,6,6,0,0,100,115250,1276,93
80525,2024,1,1,0,0,100,279000,3444,81
80526,2024,2,2,0,0,100,92500,890,104
80527,2024,2,2,0,0,100,108000,1690,64
80530,2024,9,9,0,0,100,156547,1502,108
80533,2024,86,38,48,56,44,138808,2478,60
80535,2024,1,1,0,0,100,55900,2150,26
80536,2024,3,3,0,0,100,53667,882,59
80538,2024,3,3,0,0,100,361000,4334,70
80540,2024,2,2,0,0,100,292938,1310,223
80541,2024,3,3,0,0,100,183333,1172,159
80542,2024,8,8,0,0,100,107042,1177,95
80543,2024,1,1,0,0,100,292580,7314,40
80544,2024,3,3,0,0,100,94000,917,90
80545,2024,3,3,0,0,100,161667,1324,125
80546,2024,5,5,0,0,100,129500,1396,106
80547,2024,2,2,0,0,100,230000,2227,104
80549,2024,4,4,0,0,100,209088,2052,99
80550,2024,2,2,0,0,100,143750,1343,112
80552,2024,10,10,0,0,100,98150,1223,93
80553,2024,4,4,0,0,100,242250,2604,102
80554,2024,6,6,0,0,100,198900,1640,116
80555,2024,4,4,0,0,100,91962,1046,89
80556,2024,6,6,0,0,100,117422,1265,94
80557,2024,7,7,0,0,100,98029,1149,81
80558,2024,4,4,0,0,100,90925,1107,83
80559,2024,1,1,0,0,100,70000,778,90
80560,2024,3,3,0,0,100,121833,1291,95
80561,2024,53,50,3,6,94,127480,1416,96
80566,2024,5,5,0,0,100,130000,1306,115
80568,2024,8,8,0,0,100,96330,1107,86
80569,2024,3,3,0,0,100,154390,1116,139
80570,2024,39,39,0,0,100,140672,1588,95
80571,2024,3,3,0,0,100,67667,944,72
80572,2024,5,5,0,0,100,157950,1642,96
80573,2024,6,6,0,0,100,101667,1054,114
80574,2024,2,2,0,0,100,123500,1018,118
80576,2024,5,5,0,0,100,107280,1128,92
80577,2024,1,1,0,0,100,236650,2058,115
80578,2024,5,5,0,0,100,158356,1615,94
80579,2024,10,10,0,0,100,98188,1006,97
80580,2024,1,1,0,0,100,120000,1600,75
80582,2024,9,9,0,0,100,196028,1677,118
80583,2024,1,1,0,0,100,298700,3144,95
80584,2024,9,9,0,0,100,192250,1612,126
80585,2024,25,25,0,0,100,96096,1194,83
80586,2024,1,1,0,0,100,42000,700,60
80588,2024,2,2,0,0,100,136500,1275,107
80589,2024,1,1,0,0,100,150000,1456,103
80590,2024,7,7,0,0,100,160643,1856,81
80591,2024,1,1,0,0,100,140000,1373,102
80592,2024,9,9,0,0,100,106481,1367,87
80593,2024,5,5,0,0,100,109607,1377,86
80595,2024,3,3,0,0,100,133840,1819,72
80596,2024,5,5,0,0,100,138600,1647,88
80597,2024,3,3,0,0,100,158759,1556,95
80598,2024,10,10,0,0,100,204300,1882,110
80599,2024,2,2,0,0,100,116750,1803,64
80600,2024,13,13,0,0,100,170051,2207,79
80601,2024,6,6,0,0,100,79950,1095,79
80602,2024,2,2,0,0,100,112434,1549,65
80603,2024,3,3,0,0,100,108377,1434,83
80604,2024,2,2,0,0,100,127500,1202,102
80605,2024,1,1,0,0,100,75000,806,93
80606,2024,10,10,0,0,100,123500,1281,91
80607,2024,3,3,0,0,100,150047,1439,95
80609,2024,3,3,0,0,100,199667,1693,121
80611,2024,8,7,1,12,88,229531,2138,112
80613,2024,2,2,0,0,100,125000,1610,78
80615,2024,1,1,0,0,100,166000,982,169
80616,2024,2,2,0,0,100,121875,1332,96
80617,2024,1,1,0,0,100,150000,2239,67
80618,2024,14,14,0,0,100,206329,2390,100
80619,2024,6,6,0,0,100,166433,2206,92
80620,2024,77,67,10,13,87,112834,1388,83
80621,2024,10,10,0,0,100,101899,1124,95
80622,2024,13,13,0,0,100,131554,1502,87
80623,2024,3,3,0,0,100,114667,1389,97
80624,2024,2,2,0,0,100,141250,1228,114
80625,2024,15,15,0,0,100,159748,1648,97
80626,2024,3,3,0,0,100,212617,1989,109
80627,2024,8,8,0,0,100,257631,2425,110
80628,2024,8,8,0,0,100,182552,1590,117
80630,2024,17,17,0,0,100,152773,1592,96
80631,2024,2,2,0,0,100,167000,1950,112
80632,2024,21,13,8,38,62,192020,2417,82
80633,2024,3,3,0,0,100,237500,1989,102
80634,2024,1,1,0,0,100,151300,2073,73
80635,2024,14,14,0,0,100,106236,1511,72
80637,2024,1,1,0,0,100,65000,722,90
80639,2024,18,18,0,0,100,201587,2038,100
80640,2024,3,3,0,0,100,157167,1478,108
80642,2024,4,4,0,0,100,137375,1418,105
80643,2024,4,4,0,0,100,226212,2179,106
80644,2024,7,7,0,0,100,117079,1499,77
80645,2024,6,6,0,0,100,97333,1197,88
80646,2024,1,1,0,0,100,64500,2016,32
80647,2024,1,1,0,0,100,147000,1500,98
80649,2024,57,42,15,26,74,192907,3141,66
80650,2024,4,4,0,0,100,211088,2094,105
80651,2024,5,5,0,0,100,105460,1121,93
80652,2024,14,14,0,0,100,163946,1849,92
80654,2024,6,6,0,0,100,148500,1536,96
80655,2024,7,7,0,0,100,125893,1169,108
80656,2024,9,8,1,11,89,233656,2462,109
80657,2024,1,1,0,0,100,459500,2089,220
80658,2024,1,1,0,0,100,95000,766,124
80659,2024,5,5,0,0,100,121200,1309,90
80661,2024,9,9,0,0,100,277332,2420,117
80662,2024,1,1,0,0,100,170000,1318,129
80663,2024,2,2,0,0,100,163500,3322,53
80664,2024,2,2,0,0,100,187500,1816,101
80665,2024,2,2,0,0,100,62500,693,87
80666,2024,1,1,0,0,100,60000,759,79
80667,2024,1,1,0,0,100,240000,1143,210
80668,2024,2,2,0,0,100,232500,2270,107
80669,2024,5,5,0,0,100,158338,1673,91
80670,2024,2,2,0,0,100,208940,2064,100
80671,2024,3,3,0,0,100,110000,981,107
80672,2024,6,6,0,0,100,131950,1370,100
80673,2024,3,3,0,0,100,175542,2126,95
80674,2024,41,37,4,10,90,172894,2191,79
80675,2024,3,3,0,0,100,194367,2789,75
80677,2024,17,17,0,0,100,96555,1164,85
80678,2024,10,10,0,0,100,162480,2059,98
80679,2024,8,8,0,0,100,101750,1297,90
80680,2024,25,24,1,4,96,116941,1377,87
80682,2024,4,4,0,0,100,177625,1903,106
80683,2024,1,1,0,0,100,83000,624,133
80684,2024,2,2,0,0,100,223750,1525,156
80685,2024,64,54,10,16,84,103660,1305,79
80686,2024,6,6,0,0,100,224250,1760,136
80687,2024,1,1,0,0,100,130000,1733,75
80688,2024,46,45,1,2,98,177519,2158,88
80690,2024,7,7,0,0,100,232129,2264,103
80691,2024,4,4,0,0,100,140118,1602,86
80692,2024,15,15,0,0,100,149929,2033,77
80693,2024,2,2,0,0,100,286760,2254,159
80694,2024,2,2,0,0,100,94500,1192,76
80695,2024,5,5,0,0,100,88200,904,91
80696,2024,10,10,0,0,100,290450,2313,120
80698,2024,2,2,0,0,100,120000,1806,68
80700,2024,3,3,0,0,100,116667,1584,76
80701,2024,4,4,0,0,100,120150,1170,102
80702,2024,16,16,0,0,100,422113,3075,147
80703,2024,1,1,0,0,100,110000,1310,84
80704,2024,2,2,0,0,100,309800,2040,146
80705,2024,1,1,0,0,100,156750,3562,44
80706,2024,13,13,0,0,100,130423,1328,98
80707,2024,1,1,0,0,100,176300,2026,87
80708,2024,1,1,0,0,100,101600,1239,82
80709,2024,3,3,0,0,100,131100,1804,80
80710,2024,4,4,0,0,100,81250,1436,70
80711,2024,30,30,0,0,100,80857,1012,82
80713,2024,7,7,0,0,100,265014,2902,89
80714,2024,18,18,0,0,100,132346,1656,83
80716,2024,8,8,0,0,100,136082,1536,88
80717,2024,10,10,0,0,100,203735,2207,95
80718,2024,8,8,0,0,100,146598,1784,88
80721,2024,41,33,8,20,80,238934,3819,67
80722,2024,5,5,0,0,100,173109,1819,98
80724,2024,31,27,4,13,87,245515,2297,105
80725,2024,41,24,17,41,59,204318,2476,82
80726,2024,4,4,0,0,100,80375,957,88
80730,2024,10,9,1,10,90,239697,2400,102
80732,2024,4,4,0,0,100,65775,1104,60
80733,2024,3,3,0,0,100,95167,844,112
80734,2024,1,1,0,0,100,162400,1624,100
80735,2024,2,2,0,0,100,174285,1743,100
80736,2024,1,1,0,0,100,214600,1626,132
80737,2024,3,3,0,0,100,146667,1274,116
80740,2024,2,2,0,0,100,152600,1620,98
80742,2024,1,1,0,0,100,87200,793,110
80743,2024,2,2,0,0,100,77529,2156,36
80746,2024,6,6,0,0,100,237564,2080,114
80747,2024,1,1,0,0,100,140000,1022,137
80748,2024,1,1,0,0,100,197000,1313,150
80749,2024,3,3,0,0,100,86243,690,114
80750,2024,1,1,0,0,100,185000,1259,147
80751,2024,8,8,0,0,100,220011,2062,110
80752,2024,3,3,0,0,100,179867,2061,92
80753,2024,2,2,0,0,100,178710,1478,132
80754,2024,8,8,0,0,100,109312,1277,83
80755,2024,1,1,0,0,100,181000,1052,172
80757,2024,2,2,0,0,100,49000,622,74
80758,2024,2,2,0,0,100,199000,2036,100
80759,2024,5,5,0,0,100,102628,1029,91
80760,2024,1,1,0,0,100,55000,902,61
80762,2024,7,7,0,0,100,101357,1522,64
80763,2024,4,4,0,0,100,154550,1863,82
80764,2024,1,1,0,0,100,144450,4012,36
80765,2024,6,6,0,0,100,140617,1972,80
80766,2024,4,4,0,0,100,142162,1752,100
80767,2024,3,3,0,0,100,148850,1215,122
80769,2024,2,2,0,0,100,95092,974,104
80770,2024,5,5,0,0,100,86600,1207,69
80774,2024,4,4,0,0,100,173550,1712,112
80775,2024,4,4,0,0,100,112150,1336,85
80776,2024,1,1,0,0,100,300000,2222,135
80777,2024,1,1,0,0,100,40000,615,65
80778,2024,2,2,0,0,100,110750,1004,98
80779,2024,13,13,0,0,100,166577,1863,92
80780,2024,5,5,0,0,100,146164,1780,83
80781,2024,3,3,0,0,100,101557,981,101
80782,2024,3,3,0,0,100,282683,2393,120
80783,2024,1,1,0,0,100,127575,1402,91
80784,2024,2,2,0,0,100,161900,1679,95
80785,2024,6,6,0,0,100,147642,1625,87
80786,2024,2,2,0,0,100,150000,1279,121
80787,2024,1,1,0,0,100,119900,2141,56
80788,2024,2,2,0,0,100,223650,2440,90
80789,2024,2,2,0,0,100,89000,948,92
80791,2024,5,5,0,0,100,198760,2359,82
80793,2024,21,21,0,0,100,136650,1610,88
80795,2024,5,5,0,0,100,140940,1623,85
80796,2024,2,2,0,0,100,124663,1519,82
80798,2024,18,18,0,0,100,229750,1914,121
80799,2024,43,42,1,2,98,171537,1833,96
80801,2024,4,4,0,0,100,105950,1018,100
80802,2024,8,8,0,0,100,84649,958,86
80803,2024,3,3,0,0,100,173417,1688,102
80804,2024,2,2,0,0,100,149010,1354,110
80805,2024,1,1,0,0,100,280000,1556,180
80806,2024,4,4,0,0,100,298125,2600,129
80807,2024,8,8,0,0,100,127176,2316,56
80808,2024,4,4,0,0,100,101750,1102,92
80809,2024,2,2,0,0,100,154000,1536,100
80810,2024,1,1,0,0,100,207500,2255,92
80811,2024,5,5,0,0,100,103800,1013,96
80812,2024,1,1,0,0,100,192000,1371,140
80814,2024,4,4,0,0,100,97862,1455,74
80815,2024,8,8,0,0,100,183050,2181,85
80820,2024,3,3,0,0,100,250633,1884,134
80821,2024,3,3,0,0,100,112333,1238,95
80823,2024,2,2,0,0,100,144750,1503,100
80824,2024,3,3,0,0,100,122233,1271,95
80826,2024,10,9,1,10,90,139336,2721,65
80827,2024,10,10,0,0,100,143800,1689,83
80829,2024,2,2,0,0,100,75000,894,86
80830,2024,2,2,0,0,100,161000,1573,96
80832,2024,3,3,0,0,100,132760,1517,87
80833,2024,3,3,0,0,100,161267,1689,95
80834,2024,5,5,0,0,100,140716,1705,79
80835,2024,2,2,0,0,100,220000,1039,232
80836,2024,2,2,0,0,100,229100,1464,141
81002,2024,34,34,0,0,100,149292,1520,105
81003,2024,7,7,0,0,100,114747,1015,116
81004,2024,671,354,317,47,53,180416,2293,83
81005,2024,5,5,0,0,100,72858,975,72
81007,2024,2,2,0,0,100,214655,2036,111
81008,2024,3,3,0,0,100,191700,2068,95
81009,2024,1,1,0,0,100,1194500,4177,286
81010,2024,2,2,0,0,100,112800,1178,90
81011,2024,4,4,0,0,100,281750,2013,152
81013,2024,4,4,0,0,100,239000,1805,152
81014,2024,13,13,0,0,100,156161,1902,81
81016,2024,6,6,0,0,100,96683,1196,91
81017,2024,1,1,0,0,100,27585,424,65
81018,2024,25,24,1,4,96,198040,1819,108
81019,2024,2,2,0,0,100,70000,957,72
81020,2024,3,3,0,0,100,260890,2153,121
81021,2024,76,76,0,0,100,130079,1297,102
81023,2024,4,4,0,0,100,74992,1644,57
81024,2024,4,4,0,0,100,234485,2525,92
81026,2024,6,6,0,0,100,163717,1546,99
81030,2024,3,3,0,0,100,191167,1955,98
81031,2024,9,9,0,0,100,134690,1690,84
81032,2024,3,3,0,0,100,188333,1869,101
81033,2024,38,36,2,5,95,113459,1257,91
81034,2024,6,5,1,17,83,84750,1130,86
81035,2024,4,4,0,0,100,223125,2257,117
81036,2024,7,7,0,0,100,152207,1535,101
81037,2024,13,13,0,0,100,107973,1284,85
81038,2024,24,24,0,0,100,224015,2069,110
81039,2024,26,26,0,0,100,176158,1732,107
81040,2024,6,6,0,0,100,200622,1518,144
81041,2024,1,1,0,0,100,232000,2343,99
81042,2024,17,17,0,0,100,240940,1701,128
81043,2024,9,9,0,0,100,216034,2043,101
81044,2024,1,1,0,0,100,392000,3015,130
81045,2024,1,1,0,0,100,57200,506,113
81046,2024,9,9,0,0,100,235063,2215,111
81047,2024,2,2,0,0,100,100000,1310,72
81048,2024,31,29,2,6,94,145722,1571,94
81049,2024,4,4,0,0,100,255938,2112,124
81050,2024,6,6,0,0,100,236192,2026,146
81051,2024,16,15,1,6,94,181239,1754,107
81052,2024,15,15,0,0,100,223897,1971,117
81053,2024,3,3,0,0,100,52167,559,93
81054,2024,9,9,0,0,100,128828,1302,103
81055,2024,7,7,0,0,100,106929,1208,88
81056,2024,2,2,0,0,100,403900,2526,140
81059,2024,3,3,0,0,100,247433,2090,121
81060,2024,107,98,9,8,92,112873,1197,97
81061,2024,1,1,0,0,100,405240,3242,125
81062,2024,26,25,1,4,96,109616,1454,86
81063,2024,16,16,0,0,100,237400,2107,112
81064,2024,14,14,0,0,100,269620,2212,121
81065,2024,492,351,141,29,71,144982,1670,89
81066,2024,3,3,0,0,100,329167,2878,92
81067,2024,6,6,0,0,100,172631,1534,118
81068,2024,1,1,0,0,100,56750,1384,41
81069,2024,19,19,0,0,100,216714,1858,112
81070,2024,19,19,0,0,100,244382,2299,112
81071,2024,1,1,0,0,100,47500,792,60
81072,2024,2,2,0,0,100,162665,1184,133
81074,2024,11,11,0,0,100,187043,1588,112
81075,2024,1,1,0,0,100,239000,1897,126
81076,2024,8,8,0,0,100,266385,1824,148
81077,2024,6,6,0,0,100,116000,1524,80
81078,2024,7,7,0,0,100,224963,2165,104
81079,2024,2,2,0,0,100,95000,1374,81
81081,2024,10,10,0,0,100,143280,1331,118
81082,2024,2,2,0,0,100,93250,836,118
81083,2024,4,4,0,0,100,164965,1602,105
81084,2024,5,5,0,0,100,115096,1238,98
81086,2024,1,1,0,0,100,42000,700,60
81087,2024,3,3,0,0,100,203000,1161,164
81088,2024,5,5,0,0,100,226020,1925,128
81090,2024,4,4,0,0,100,189750,1607,115
81092,2024,12,12,0,0,100,195787,2036,95
81093,2024,3,3,0,0,100,255087,2116,119
81094,2024,1,1,0,0,100,140000,1414,99
81095,2024,1,1,0,0,100,222777,1826,122
81096,2024,5,5,0,0,100,165610,1854,86
81097,2024,5,5,0,0,100,277314,2228,125
81098,2024,2,2,0,0,100,196750,1900,104
81099,2024,173,144,29,17,83,194208,2023,96
81100,2024,3,3,0,0,100,179734,1475,113
81101,2024,13,13,0,0,100,147622,1581,101
81102,2024,2,2,0,0,100,213300,2431,90
81103,2024,1,1,0,0,100,40000,800,50
81104,2024,18,18,0,0,100,233952,2769,107
81105,2024,173,146,27,16,84,125709,1432,90
81106,2024,4,4,0,0,100,227199,1946,121
81109,2024,1,1,0,0,100,90000,947,95
81110,2024,1,1,0,0,100,400080,3201,125
81111,2024,1,1,0,0,100,230000,1917,120
81112,2024,8,8,0,0,100,277671,2123,135
81114,2024,5,5,0,0,100,263800,2112,116
81115,2024,35,34,1,3,97,72506,938,83
81116,2024,10,10,0,0,100,266817,2441,112
81117,2024,10,9,1,10,90,197449,1709,112
81119,2024,3,3,0,0,100,109333,1176,90
81120,2024,74,68,6,8,92,149697,1563,94
81121,2024,3,3,0,0,100,35460,537,66
81122,2024,1,1,0,0,100,135000,1534,88
81123,2024,1,1,0,0,100,120000,1071,112
81124,2024,21,18,3,14,86,114654,1354,82
81125,2024,7,7,0,0,100,167268,1315,128
81126,2024,2,2,0,0,100,234700,2181,107
81128,2024,14,14,0,0,100,93390,1036,88
81129,2024,1,1,0,0,100,120000,876,137
81130,2024,26,16,10,38,62,141776,1662,90
81131,2024,20,20,0,0,100,269851,2216,122
81132,2024,10,10,0,0,100,134050,1391,97
81133,2024,2,2,0,0,100,201000,1653,131
81134,2024,1,1,0,0,100,67500,422,160
81135,2024,1,1,0,0,100,108346,677,160
81136,2024,3,3,0,0,100,97920,984,111
81137,2024,1,1,0,0,100,150000,1596,94
81138,2024,6,6,0,0,100,242092,1868,137
81139,2024,10,10,0,0,100,166045,1603,103
81140,2024,145,114,31,21,79,199036,2150,93
81142,2024,6,6,0,0,100,117367,1134,103
81143,2024,2,2,0,0,100,247240,2314,108
81144,2024,47,46,1,2,98,198224,1904,106
81145,2024,62,54,8,13,87,174891,1878,94
81146,2024,2,2,0,0,100,510000,3622,170
81147,2024,5,5,0,0,100,176800,1356,133
81150,2024,5,5,0,0,100,241250,1805,135
81151,2024,1,1,0,0,100,231000,1100,210
81152,2024,4,4,0,0,100,173525,1393,138
81156,2024,30,29,1,3,97,222315,2297,96
81157,2024,1,1,0,0,100,290000,2990,97
81158,2024,3,3,0,0,100,353083,1919,169
81159,2024,4,4,0,0,100,293232,2391,124
81160,2024,8,8,0,0,100,174866,1472,124
81161,2024,3,3,0,0,100,91350,907,100
81162,2024,3,3,0,0,100,469067,3769,174
81163,2024,136,118,18,13,87,104752,1211,94
81164,2024,3,3,0,0,100,76853,659,116
81165,2024,8,8,0,0,100,164754,1644,102
81166,2024,1,1,0,0,100,99900,1753,57
81167,2024,4,4,0,0,100,62688,1371,48
81168,2024,18,18,0,0,100,160784,1390,115
81169,2024,1,1,0,0,100,229360,1067,215
81170,2024,10,10,0,0,100,155921,1732,100
81171,2024,11,10,1,9,91,228765,1886,123
81172,2024,1,1,0,0,100,58600,666,88
81174,2024,4,4,0,0,100,156925,1616,100
81175,2024,1,1,0,0,100,171820,859,200
81177,2024,4,4,0,0,100,172000,1894,93
81178,2024,3,3,0,0,100,243733,2231,113
81179,2024,3,3,0,0,100,183533,2002,94
81180,2024,3,3,0,0,100,106667,1070,97
81181,2024,1,1,0,0,100,320000,2667,120
81182,2024,28,27,1,4,96,187395,1602,121
81183,2024,3,3,0,0,100,118620,979,106
81184,2024,1,1,0,0,100,110000,1375,80
81185,2024,1,1,0,0,100,344185,2151,160
81186,2024,2,2,0,0,100,166180,1088,154
81187,2024,2,2,0,0,100,161682,1515,105
81188,2024,5,5,0,0,100,120780,1252,109
81190,2024,3,3,0,0,100,229300,1687,145
81192,2024,16,16,0,0,100,95706,1279,80
81193,2024,13,13,0,0,100,131562,1771,78
81195,2024,6,6,0,0,100,206933,1860,108
81196,2024,14,14,0,0,100,160493,1575,95
81197,2024,2,2,0,0,100,151250,1912,78
81198,2024,2,2,0,0,100,345225,2014,154
81200,2024,1,1,0,0,100,188000,2112,89
81201,2024,17,17,0,0,100,107144,1108,101
81202,2024,4,4,0,0,100,403605,2242,185
81203,2024,7,7,0,0,100,151571,1729,88
81204,2024,16,16,0,0,100,188053,1961,95
81206,2024,8,8,0,0,100,179234,1533,112
81207,2024,3,3,0,0,100,248333,1803,168
81208,2024,6,6,0,0,100,196492,1672,119
81209,2024,27,27,0,0,100,141560,1402,99
81210,2024,4,4,0,0,100,225000,1971,111
81211,2024,4,4,0,0,100,261650,2002,138
81214,2024,1,1,0,0,100,140000,1129,124
81215,2024,3,3,0,0,100,261533,2562,106
81216,2024,2,2,0,0,100,192905,1896,98
81217,2024,7,6,1,14,86,198375,2103,101
81218,2024,25,25,0,0,100,288715,2253,127
81219,2024,37,37,0,0,100,189307,1746,121
81220,2024,57,52,5,9,91,226304,2059,111
81221,2024,3,3,0,0,100,71333,574,120
81222,2024,30,25,5,17,83,133578,1472,93
81223,2024,1,1,0,0,100,62460,822,76
81224,2024,3,3,0,0,100,136000,1415,83
81225,2024,10,10,0,0,100,206280,2041,108
81227,2024,18,17,1,6,94,120622,1389,86
81230,2024,2,2,0,0,100,118725,1430,81
81231,2024,2,2,0,0,100,175500,2065,85
81232,2024,1,1,0,0,100,645000,5864,110
81233,2024,16,16,0,0,100,212876,1598,126
81234,2024,1,1,0,0,100,88000,2750,32
81235,2024,3,3,0,0,100,117000,1158,104
81236,2024,3,3,0,0,100,245333,2497,100
81237,2024,3,3,0,0,100,130000,1695,76
81238,2024,21,20,1,5,95,133717,1275,111
81239,2024,10,10,0,0,100,111905,1077,109
81240,2024,1,1,0,0,100,220000,1375,160
81242,2024,2,2,0,0,100,133000,1367,83
81244,2024,15,15,0,0,100,119994,1238,98
81245,2024,1,1,0,0,100,197500,1212,163
81247,2024,3,3,0,0,100,103333,1278,89
81248,2024,6,6,0,0,100,214883,2074,108
81249,2024,9,9,0,0,100,135528,1341,108
81250,2024,2,2,0,0,100,135000,1208,118
81251,2024,9,9,0,0,100,176324,1371,127
81252,2024,3,3,0,0,100,286710,2027,142
81253,2024,4,4,0,0,100,156460,1893,85
81254,2024,4,4,0,0,100,180325,1421,137
81255,2024,2,2,0,0,100,468544,2816,162
81257,2024,53,41,12,23,77,154792,1728,96
81258,2024,3,3,0,0,100,155107,1506,104
81259,2024,2,2,0,0,100,275000,2126,132
81261,2024,6,6,0,0,100,261150,1962,131
81262,2024,2,2,0,0,100,434400,2678,162
81263,2024,5,5,0,0,100,103820,1299,97
81264,2024,1,1,0,0,100,50000,407,123
81265,2024,1,1,0,0,100,40000,1333,30
81266,2024,8,8,0,0,100,141566,1584,103
81267,2024,13,13,0,0,100,85392,1009,95
81268,2024,1,1,0,0,100,127950,2206,58
81269,2024,8,8,0,0,100,112804,1173,94
81270,2024,2,2,0,0,100,392600,1596,247
81271,2024,87,83,4,5,95,245162,2574,98
81272,2024,1,1,0,0,100,192000,1324,145
81273,2024,30,29,1,3,97,176994,1815,96
81274,2024,4,4,0,0,100,268232,2453,111
81275,2024,5,5,0,0,100,152400,1431,114
81276,2024,9,9,0,0,100,243415,1957,136
81277,2024,3,3,0,0,100,203973,1804,112
81278,2024,1,1,0,0,100,115000,1533,75
81279,2024,4,4,0,0,100,193000,1775,110
81280,2024,2,2,0,0,100,166500,1206,115
81281,2024,23,23,0,0,100,159943,1546,111
81283,2024,10,10,0,0,100,244244,2395,117
81284,2024,17,15,2,12,88,201360,2341,89
81285,2024,4,4,0,0,100,158875,1602,107
81286,2024,7,6,1,14,86,128429,1401,106
81288,2024,31,27,4,13,87,171107,1671,106
81289,2024,18,18,0,0,100,166361,1654,106
81290,2024,2,2,0,0,100,103865,1160,100
81291,2024,3,3,0,0,100,199333,1609,130
81292,2024,12,12,0,0,100,151667,1423,118
81293,2024,3,3,0,0,100,221497,2021,110
81294,2024,3,3,0,0,100,258417,2089,122
81295,2024,5,5,0,0,100,103800,1095,101
81297,2024,8,8,0,0,100,331431,2509,126
81298,2024,2,2,0,0,100,342550,3584,103
81302,2024,1,1,0,0,100,80000,482,166
81303,2024,3,3,0,0,100,101667,799,113
81304,2024,4,4,0,0,100,181850,1471,128
81305,2024,15,14,1,7,93,83989,1015,92
81306,2024,4,4,0,0,100,118750,1427,87
81307,2024,12,12,0,0,100,148138,1527,105
81308,2024,7,7,0,0,100,129429,1137,131
81309,2024,4,4,0,0,100,156550,1310,115
81311,2024,5,5,0,0,100,193420,2294,115
81312,2024,6,6,0,0,100,99825,1241,94
81313,2024,3,3,0,0,100,260333,2594,97
81314,2024,10,10,0,0,100,76954,969,85
81315,2024,11,11,0,0,100,144773,1430,108
81316,2024,4,4,0,0,100,242750,1687,114
81317,2024,10,9,1,10,90,120222,1431,87
81318,2024,1,1,0,0,100,250000,2358,106
81319,2024,8,8,0,0,100,302931,2112,150
81320,2024,6,6,0,0,100,289800,2134,121
81322,2024,3,3,0,0,100,179750,2210,96
81323,2024,3,3,0,0,100,172333,1558,111
81325,2024,11,11,0,0,100,189660,1609,116
81326,2024,1,1,0,0,100,88000,1294,68
82001,2024,4,4,0,0,100,214750,1518,154
82002,2024,35,32,3,9,91,180257,1855,100
82004,2024,1,1,0,0,100,480000,3692,130
82005,2024,11,11,0,0,100,231646,2272,104
82006,2024,3,3,0,0,100,239967,1774,119
82008,2024,13,13,0,0,100,152172,1351,130
82010,2024,3,3,0,0,100,343400,2856,125
82011,2024,2,2,0,0,100,188050,1254,150
82012,2024,2,2,0,0,100,121500,1841,66
82013,2024,47,46,1,2,98,141707,1327,105
82014,2024,4,4,0,0,100,257935,2026,138
82016,2024,2,2,0,0,100,311250,1981,151
82017,2024,15,15,0,0,100,186576,1762,113
82018,2024,10,10,0,0,100,341096,3304,114
82019,2024,7,7,0,0,100,157829,1580,112
82020,2024,8,8,0,0,100,209894,1886,113
82021,2024,3,3,0,0,100,238333,3176,82
82022,2024,3,3,0,0,100,216667,1453,144
82023,2024,9,9,0,0,100,193021,1722,120
82024,2024,2,2,0,0,100,115850,1342,83
82025,2024,47,43,4,9,91,239723,2498,100
82026,2024,8,8,0,0,100,143104,1264,141
82027,2024,11,11,0,0,100,200717,2029,102
82028,2024,4,4,0,0,100,211936,1472,144
82029,2024,2,2,0,0,100,68500,1007,69
82030,2024,6,6,0,0,100,286218,2824,101
82031,2024,7,7,0,0,100,150257,1422,109
82032,2024,6,6,0,0,100,174488,1529,127
82033,2024,159,132,27,17,83,151571,1583,98
82035,2024,1,1,0,0,100,105000,1105,95
82036,2024,1,1,0,0,100,80884,879,92
82037,2024,69,53,16,23,77,144147,1639,93
82038,2024,29,27,2,7,93,130850,1331,101
82039,2024,3,3,0,0,100,208000,2152,97
82040,2024,2,2,0,0,100,117000,1572,108
82041,2024,3,3,0,0,100,246752,1962,121
82042,2024,10,9,1,10,90,150301,1463,110
82043,2024,3,3,0,0,100,182664,1527,136
82044,2024,18,15,3,17,83,192972,2103,89
82045,2024,3,3,0,0,100,168067,1855,91
82048,2024,22,19,3,14,86,210029,2199,97
82049,2024,10,10,0,0,100,173654,1437,121
82050,2024,17,17,0,0,100,153479,1427,113
82051,2024,11,11,0,0,100,221303,1547,131
82052,2024,12,12,0,0,100,227658,1691,133
82053,2024,4,4,0,0,100,131625,1310,103
82054,2024,2,2,0,0,100,60000,1880,50
82055,2024,2,2,0,0,100,238500,1132,217
82056,2024,4,4,0,0,100,221180,1576,140
82057,2024,4,4,0,0,100,172698,1287,142
82058,2024,2,2,0,0,100,113000,1026,109
82059,2024,3,3,0,0,100,268767,2197,126
82060,2024,4,4,0,0,100,241569,1698,137
82061,2024,3,3,0,0,100,256333,2194,105
82062,2024,15,15,0,0,100,139907,1772,81
82063,2024,11,11,0,0,100,160288,1630,106
82064,2024,2,2,0,0,100,152282,1398,101
82065,2024,1,1,0,0,100,133500,1451,92
82066,2024,5,5,0,0,100,233784,2276,105
82067,2024,1,1,0,0,100,150000,1007,149
82069,2024,3,3,0,0,100,202907,2123,105
82072,2024,5,5,0,0,100,181000,1474,129
82073,2024,10,10,0,0,100,197864,1709,121
82075,2024,38,32,6,16,84,204632,2212,95
82076,2024,9,9,0,0,100,195483,2187,99
82078,2024,2,2,0,0,100,129400,1682,77
82079,2024,26,23,3,12,88,202267,2208,94
82080,2024,11,11,0,0,100,215118,1845,118
82081,2024,5,5,0,0,100,89134,1024,101
82082,2024,4,4,0,0,100,109500,1216,94
82084,2024,2,2,0,0,100,268650,1882,142
82085,2024,8,8,0,0,100,213225,2397,115
82086,2024,1,1,0,0,100,141570,2247,63
82087,2024,18,18,0,0,100,206578,1877,109
82088,2024,10,10,0,0,100,164762,1497,112
82089,2024,13,12,1,8,92,125200,947,130
82090,2024,7,7,0,0,100,164571,1800,91
82091,2024,1,1,0,0,100,135600,1937,70
82092,2024,2,2,0,0,100,180835,1556,108
82093,2024,4,4,0,0,100,115375,1010,106
82094,2024,23,22,1,4,96,149538,1490,103
82095,2024,4,4,0,0,100,256742,3273,89
82096,2024,30,24,6,20,80,160254,1702,96
82097,2024,13,12,1,8,92,187600,1696,113
82098,2024,6,6,0,0,100,235903,2289,104
82099,2024,3,3,0,0,100,161181,1681,100
82100,2024,1,1,0,0,100,245000,1885,130
82101,2024,11,10,1,9,91,169919,1672,100
82102,2024,4,4,0,0,100,122425,1140,103
82103,2024,1,1,0,0,100,194470,1925,101
82104,2024,2,2,0,0,100,449190,1779,245
82105,2024,11,11,0,0,100,165237,1735,104
82106,2024,1,1,0,0,100,60000,652,92
82108,2024,13,13,0,0,100,185808,1629,124
82109,2024,2,2,0,0,100,145000,1734,96
82110,2024,10,10,0,0,100,191231,1741,110
82111,2024,4,4,0,0,100,133809,1462,99
82112,2024,127,104,23,18,82,139821,1549,93
82113,2024,18,17,1,6,94,137623,2026,89
82114,2024,5,5,0,0,100,216756,1775,124
82115,2024,15,14,1,7,93,157057,1485,113
82116,2024,4,4,0,0,100,163870,1300,129
82117,2024,24,23,1,4,96,200134,1821,122
82119,2024,7,7,0,0,100,144161,1377,101
82120,2024,2,2,0,0,100,157475,1912,81
82121,2024,772,386,386,50,50,185184,2159,86
82122,2024,1,1,0,0,100,283200,1953,145
82123,2024,20,15,5,25,75,176286,1936,90
82124,2024,48,37,11,23,77,194862,2086,92
82125,2024,65,54,11,17,83,188699,2027,96
82126,2024,13,13,0,0,100,191611,2001,96
82127,2024,6,6,0,0,100,198467,1543,127
82128,2024,1,1,0,0,100,280000,2154,130
82130,2024,2,2,0,0,100,239500,1732,134
82131,2024,11,10,1,9,91,171486,1727,97
82132,2024,29,29,0,0,100,147237,1701,94
82133,2024,2,2,0,0,100,106500,1998,54
82134,2024,46,39,7,15,85,196126,1919,98
82135,2024,9,9,0,0,100,211967,2322,98
82136,2024,7,7,0,0,100,236316,2058,120
82137,2024,4,4,0,0,100,128556,1582,80
82138,2024,1,1,0,0,100,816000,3151,259
82139,2024,1,1,0,0,100,320000,1720,186
82140,2024,5,5,0,0,100,133034,1228,110
82141,2024,8,7,1,12,88,117865,1214,108
82142,2024,23,23,0,0,100,222453,2318,102
82143,2024,1,1,0,0,100,170000,1889,90
82144,2024,5,5,0,0,100,234530,1234,185
82145,2024,4,4,0,0,100,107500,1312,92
82147,2024,3,3,0,0,100,46667,675,72
82148,2024,13,13,0,0,100,175588,1783,97
82149,2024,12,12,0,0,100,168908,1874,96
82150,2024,8,8,0,0,100,258716,2279,116
82151,2024,8,8,0,0,100,188378,1326,127
82152,2024,3,3,0,0,100,192633,1233,156
82153,2024,5,5,0,0,100,145060,1295,119
82154,2024,1,1,0,0,100,163605,2098,78
82155,2024,41,39,2,5,95,206925,2156,100
82156,2024,2,2,0,0,100,189000,1442,124
82157,2024,3,3,0,0,100,458533,2055,255
82158,2024,1,1,0,0,100,90000,703,128
82159,2024,3,3,0,0,100,170500,1685,102
82160,2024,1,1,0,0,100,390000,2653,147
82161,2024,35,32,3,9,91,239643,2389,103
82162,2024,5,5,0,0,100,279770,2345,116
82164,2024,1,1,0,0,100,332140,2888,115
82165,2024,3,3,0,0,100,118333,1284,97
82166,2024,4,4,0,0,100,152166,1539,99
82167,2024,12,12,0,0,100,255582,2320,110
82168,2024,5,5,0,0,100,108720,1260,83
82169,2024,19,19,0,0,100,150516,1369,109
82170,2024,3,3,0,0,100,96000,818,113
82171,2024,7,7,0,0,100,188886,1392,148
82172,2024,6,6,0,0,100,146483,1547,78
82173,2024,16,14,2,12,88,156813,1690,91
82174,2024,1,1,0,0,100,135000,1000,135
82175,2024,3,3,0,0,100,359756,1914,167
82176,2024,2,2,0,0,100,284525,2462,118
82177,2024,2,2,0,0,100,248575,3050,84
82178,2024,7,7,0,0,100,219954,1773,127
82179,2024,25,24,1,4,96,115310,1463,79
82180,2024,4,4,0,0,100,166605,1326,143
82182,2024,6,6,0,0,100,176488,1244,156
82183,2024,3,3,0,0,100,360983,1268,247
82184,2024,5,5,0,0,100,239064,2196,114
82185,2024,3,3,0,0,100,186007,1610,120
82186,2024,65,56,9,14,86,135395,1561,87
82187,2024,16,16,0,0,100,127950,1314,98
82188,2024,2,2,0,0,100,398445,2091,186
82189,2024,7,7,0,0,100,144861,1334,108
82190,2024,66,52,14,21,79,170828,1797,97
82191,2024,6,6,0,0,100,153820,1554,90
82192,2024,4,4,0,0,100,153680,1446,113
82194,2024,19,18,1,5,95,160370,1697,102
82195,2024,6,6,0,0,100,234333,2269,102
83001,2024,32,28,4,12,88,688196,5240,133
83002,2024,3,2,1,33,67,135683,933,160
83003,2024,17,16,1,6,94,201513,2365,79
83004,2024,105,64,41,39,61,299770,3332,89
83005,2024,7,5,2,29,71,216869,2949,84
83006,2024,4,4,0,0,100,297512,2947,100
83007,2024,40,31,9,22,78,193423,2468,78
83008,2024,61,44,17,28,72,352969,3913,91
83009,2024,313,52,261,83,17,404465,6762,61
83010,2024,2,2,0,0,100,192500,3050,64
83011,2024,29,16,13,45,55,339234,3304,83
83012,2024,58,27,31,53,47,173523,2382,73
83013,2024,8,8,0,0,100,150578,2432,63
83014,2024,8,8,0,0,100,553312,3459,135
83015,2024,6,6,0,0,100,312875,5158,77
83016,2024,137,67,70,51,49,369411,4248,81
83017,2024,20,14,6,30,70,296847,3519,87
83018,2024,42,36,6,14,86,278717,2812,106
83019,2024,289,99,190,66,34,380057,5998,61
83021,2024,40,33,7,18,82,269520,2857,92
83023,2024,220,99,121,55,45,195918,2588,76
83025,2024,15,7,8,53,47,132242,2228,58
83026,2024,26,22,4,15,85,240752,2710,93
83027,2024,63,51,12,19,81,634741,6024,101
83028,2024,34,22,12,35,65,206910,2741,69
83029,2024,40,28,12,30,70,400273,4148,95
83030,2024,20,18,2,10,90,258545,2796,90
83031,2024,50,38,12,24,76,258329,2995,86
83032,2024,58,48,10,17,83,264704,3152,86
83033,2024,45,36,9,20,80,248994,2888,91
83034,2024,158,62,96,61,39,562203,6396,81
83035,2024,63,55,8,13,87,364911,4692,76
83036,2024,348,85,263,76,24,368570,6172,58
83037,2024,14,12,2,14,86,236606,2806,88
83038,2024,6,4,2,33,67,187080,4343,63
83039,2024,3,3,0,0,100,610383,5436,83
83040,2024,5,4,1,20,80,120952,1694,77
83041,2024,20,14,6,30,70,167555,2568,75
83042,2024,181,51,130,72,28,306465,4689,63
83043,2024,38,29,9,24,76,259226,2824,90
83044,2024,1,1,0,0,100,17500,473,37
83045,2024,12,12,0,0,100,176368,2321,82
83046,2024,65,51,14,22,78,381719,3436,106
83047,2024,170,119,51,30,70,385901,4350,88
83048,2024,153,67,86,56,44,621707,7922,70
83049,2024,139,83,56,40,60,288906,3472,81
83050,2024,566,195,371,66,34,196050,2539,74
83051,2024,31,28,3,10,90,285300,2840,94
83052,2024,8,7,1,12,88,116894,3078,54
83053,2024,20,18,2,10,90,393437,4309,92
83054,2024,93,51,42,45,55,317344,3925,80
83055,2024,104,78,26,25,75,394896,4024,98
83056,2024,42,38,4,10,90,329720,3231,102
83057,2024,43,33,10,23,77,350644,3175,110
83058,2024,78,58,20,26,74,343489,3393,96
83059,2024,45,34,11,24,76,293577,3567,90
83060,2024,10,10,0,0,100,327476,2931,109
83061,2024,1283,231,1052,82,18,271922,4419,62
83062,2024,292,99,193,66,34,291035,3749,76
83063,2024,44,31,13,30,70,458438,5116,90
83064,2024,68,62,6,9,91,332656,3365,101
83065,2024,59,42,17,29,71,901867,8761,91
83066,2024,14,13,1,7,93,224477,2795,81
83067,2024,59,50,9,15,85,237102,2666,85
83068,2024,229,120,109,48,52,783743,8489,89
83069,2024,922,186,736,80,20,282582,4431,64
83070,2024,298,52,246,83,17,373382,6626,53
83071,2024,278,113,165,59,41,325148,5774,60
83072,2024,190,137,53,28,72,337845,3320,96
83073,2024,158,94,64,41,59,208045,2795,75
83074,2024,4,3,1,25,75,195666,2530,86
83075,2024,8,7,1,12,88,207496,2593,78
83076,2024,14,12,2,14,86,219191,2745,77
83077,2024,16,14,2,12,88,296357,3033,94
83078,2024,7,7,0,0,100,318711,2960,121
83079,2024,28,17,11,39,61,494378,5724,88
83080,2024,17,15,2,12,88,244653,3191,76
83081,2024,96,74,22,23,77,429634,4315,100
83082,2024,12,7,5,42,58,125054,1717,70
83083,2024,19,16,3,16,84,225984,2797,83
83084,2024,12,12,0,0,100,164738,2267,83
83085,2024,63,51,12,19,81,347449,4115,86
83086,2024,106,61,45,42,58,243683,3040,75
83087,2024,35,29,6,17,83,332322,3891,84
83088,2024,27,26,1,4,96,319585,3074,103
83089,2024,5,4,1,20,80,420424,3213,116
83090,2024,111,57,54,49,51,395216,4602,81
83091,2024,75,55,20,27,73,313929,3632,83
83092,2024,60,43,17,28,72,234582,3127,83
83093,2024,36,28,8,22,78,316766,3757,91
83094,2024,72,50,22,31,69,440074,4760,94
83095,2024,10,10,0,0,100,229195,2646,85
83096,2024,15,12,3,20,80,292528,3451,84
83097,2024,59,45,14,24,76,357261,3670,97
83098,2024,140,50,90,64,36,356315,4944,72
83099,2024,120,61,59,49,51,310624,3767,80
83100,2024,45,36,9,20,80,290638,3257,88
83101,2024,33,19,14,42,58,1140505,10472,101
83102,2024,58,51,7,12,88,283817,3100,93
83103,2024,29,24,5,17,83,379986,4194,94
83104,2024,42,29,13,31,69,206031,2510,84
83106,2024,69,56,13,19,81,325053,3404,97
83107,2024,372,214,158,42,58,474911,5242,86
83108,2024,28,25,3,11,89,282426,3141,89
83109,2024,3,3,0,0,100,158000,2047,76
83110,2024,21,15,6,29,71,240772,3082,75
83111,2024,27,25,2,7,93,293819,2957,98
83112,2024,251,80,171,68,32,392132,6147,65
83113,2024,39,37,2,5,95,228212,2769,85
83114,2024,9,9,0,0,100,187989,2676,70
83115,2024,477,145,332,70,30,532933,6463,76
83116,2024,165,132,33,20,80,335448,3872,89
83117,2024,18,18,0,0,100,436868,3694,115
83118,2024,1127,230,897,80,20,368961,5222,70
83119,2024,147,17,130,88,12,675308,10870,61
83120,2024,53,27,26,49,51,345541,4126,87
83121,2024,72,37,35,49,51,212924,2601,82
83122,2024,17,9,8,47,53,169626,2449,73
83123,2024,397,108,289,73,27,450986,6529,67
83124,2024,51,43,8,16,84,500829,4292,112
83125,2024,30,29,1,3,97,325650,3559,97
83126,2024,933,210,723,77,23,227782,3662,63
83127,2024,33,30,3,9,91,303837,3534,86
83128,2024,15,14,1,7,93,303768,2972,98
83129,2024,708,237,471,67,33,348576,5367,66
83130,2024,117,76,41,35,65,309446,3677,84
83131,2024,64,49,15,23,77,317874,3529,88
83132,2024,13,9,4,31,69,467896,4098,110
83133,2024,16,12,4,25,75,517724,4884,116
83134,2024,46,41,5,11,89,371572,3825,99
83135,2024,31,29,2,6,94,225234,2777,82
83136,2024,28,27,1,4,96,318724,3315,108
83137,2024,2623,393,2230,85,15,211708,3183,64
83138,2024,63,56,7,11,89,309155,4844,75
83139,2024,18,13,5,28,72,295647,3032,94
83140,2024,54,48,6,11,89,284981,3410,91
83141,2024,73,52,21,29,71,281580,2885,94
83142,2024,1,0,1,100,0,175000,3125,56
83143,2024,54,46,8,15,85,254205,2800,93
83144,2024,352,80,272,77,23,241518,3469,69
83145,2024,33,26,7,21,79,201110,2992,73
83146,2024,43,39,4,9,91,226174,2551,85
83148,2024,188,127,61,32,68,272262,3259,82
83149,2024,23,19,4,17,83,285874,2990,95
83150,2024,32,25,7,22,78,231052,2825,82
83151,2024,12,9,3,25,75,163227,2052,77
83152,2024,31,23,8,26,74,1422029,10106,132
83153,2024,150,20,130,87,13,224840,4847,45
83154,2024,9,8,1,11,89,339778,3169,111
84001,2024,29,20,9,31,69,326610,3220,99
84002,2024,8,8,0,0,100,305830,3144,85
84003,2024,97,52,45,46,54,174268,2192,78
84004,2024,61,51,10,16,84,238530,2773,84
84005,2024,4,4,0,0,100,213669,2286,96
84006,2024,1,1,0,0,100,559000,3250,172
84007,2024,1304,365,939,72,28,153516,2425,66
84008,2024,5,5,0,0,100,448667,5515,91
84009,2024,22,20,2,9,91,271422,3026,88
84010,2024,14,10,4,29,71,382626,3873,96
84011,2024,5,3,2,40,60,415178,4224,89
84012,2024,20,17,3,15,85,346802,3160,103
84013,2024,3,1,2,67,33,278137,3918,52
84014,2024,15,14,1,7,93,256341,2520,101
84015,2024,1,1,0,0,100,909000,2597,350
84016,2024,42,36,6,14,86,237499,2650,92
84017,2024,50,47,3,6,94,277101,3555,81
84018,2024,4,4,0,0,100,496250,3826,126
84019,2024,136,108,28,21,79,178098,1953,91
84020,2024,27,26,1,4,96,801946,5349,131
84021,2024,1,1,0,0,100,345000,5000,69
84022,2024,3,3,0,0,100,291250,3381,85
84024,2024,12,9,3,25,75,340190,4350,89
84025,2024,26,21,5,19,81,401888,4011,91
84026,2024,60,50,10,17,83,316586,3592,90
84027,2024,14,13,1,7,93,176711,2126,87
84028,2024,5,5,0,0,100,263338,3028,94
84029,2024,46,44,2,4,96,275180,2798,99
84030,2024,44,42,2,5,95,325224,3095,107
84031,2024,290,162,128,44,56,185443,2230,80
84032,2024,3,3,0,0,100,360000,3340,102
84033,2024,6,6,0,0,100,261247,2777,90
84034,2024,37,33,4,11,89,287419,2983,96
84035,2024,280,123,157,56,44,193807,2540,76
84036,2024,34,28,6,18,82,306537,3038,109
84037,2024,13,11,2,15,85,276782,3150,93
84038,2024,32,28,4,12,88,316483,3099,103
84039,2024,50,38,12,24,76,222693,2442,91
84040,2024,5,5,0,0,100,296488,2555,117
84041,2024,6,6,0,0,100,576910,4246,120
84042,2024,26,23,3,12,88,486721,4222,105
84043,2024,76,51,25,33,67,224099,2807,79
84044,2024,17,16,1,6,94,246388,2851,88
84045,2024,1,1,0,0,100,224180,3029,74
84046,2024,5,5,0,0,100,451010,3153,116
84047,2024,25,25,0,0,100,252026,2738,93
84048,2024,1,1,0,0,100,315020,2625,120
84049,2024,5,4,1,20,80,420224,3911,102
84050,2024,29,27,2,7,93,1156699,7186,161
84051,2024,12,12,0,0,100,431838,3504,118
84052,2024,13,13,0,0,100,372432,3636,106
84053,2024,18,17,1,6,94,281640,2623,103
84054,2024,256,147,109,43,57,335985,3948,84
84055,2024,14,12,2,14,86,292787,3271,93
84056,2024,47,40,7,15,85,245855,2781,92
84057,2024,4,4,0,0,100,358750,3045,113
84058,2024,8,8,0,0,100,377156,4086,107
84059,2024,3,3,0,0,100,640433,4635,135
84061,2024,1,1,0,0,100,274000,2491,110
84062,2024,12,11,1,8,92,557316,4044,128
84063,2024,2,2,0,0,100,252500,3402,75
84064,2024,33,24,9,27,73,167214,1696,95
84065,2024,46,38,8,17,83,326422,3477,94
84066,2024,5,5,0,0,100,539703,4199,124
84067,2024,26,26,0,0,100,259909,2917,89
84068,2024,21,14,7,33,67,573194,6062,84
84069,2024,40,34,6,15,85,258674,2627,101
84070,2024,19,19,0,0,100,265878,2779,94
84071,2024,24,21,3,12,88,388500,4443,91
84072,2024,65,60,5,8,92,283251,2921,102
84073,2024,13,9,4,31,69,735305,5595,126
84074,2024,31,27,4,13,87,312396,3504,95
84075,2024,6,5,1,17,83,490558,3302,110
84076,2024,23,22,1,4,96,383827,3345,108
84077,2024,4,4,0,0,100,355155,3218,113
84078,2024,37,23,14,38,62,174783,1922,86
84079,2024,4,4,0,0,100,91500,1296,70
84080,2024,102,70,32,31,69,241762,2830,84
84081,2024,80,62,18,22,78,275301,2963,93
84082,2024,28,21,7,25,75,337882,3188,104
84083,2024,22,22,0,0,100,224895,2265,97
84084,2024,16,13,3,19,81,394458,3728,104
84085,2024,5,5,0,0,100,516682,4800,108
84086,2024,12,11,1,8,92,529392,5382,96
84087,2024,327,175,152,46,54,188145,2325,81
84088,2024,97,83,14,14,86,348053,3399,102
84089,2024,232,138,94,41,59,260534,3364,78
84090,2024,6,6,0,0,100,420240,3222,130
84091,2024,54,49,5,9,91,263485,2655,98
84092,2024,187,85,102,55,45,149040,1944,76
84093,2024,13,12,1,8,92,441789,3717,117
84094,2024,6,5,1,17,83,456917,4181,122
84095,2024,11,11,0,0,100,425972,3998,111
84096,2024,7,6,1,14,86,224810,2525,85
84097,2024,7,7,0,0,100,446073,2688,143
84098,2024,4,4,0,0,100,353825,3162,112
84099,2024,53,46,7,13,87,408965,3832,106
84100,2024,3,3,0,0,100,488333,3386,146
84101,2024,5,5,0,0,100,505520,4743,106
84102,2024,17,17,0,0,100,583466,5003,113
84103,2024,11,7,4,36,64,164289,2314,74
84104,2024,19,19,0,0,100,344115,3101,111
84105,2024,13,12,1,8,92,248500,2666,97
84106,2024,29,23,6,21,79,227967,2423,94
84107,2024,11,11,0,0,100,200231,2006,91
84108,2024,24,18,6,25,75,345978,3541,95
84109,2024,2,2,0,0,100,250000,3936,58
84111,2024,4,4,0,0,100,396250,3399,110
84112,2024,11,11,0,0,100,319877,3455,90
84113,2024,8,8,0,0,100,205000,2458,89
84114,2024,2,2,0,0,100,170000,1760,104
84115,2024,5,5,0,0,100,306821,3106,96
84116,2024,7,7,0,0,100,339934,3042,110
84117,2024,3,3,0,0,100,415747,2355,138
84118,2024,45,41,4,9,91,478188,3982,116
84119,2024,50,30,20,40,60,215769,2748,78
84120,2024,7,7,0,0,100,173838,2410,78
84121,2024,1,1,0,0,100,850000,5667,150
84122,2024,43,40,3,7,93,246149,2365,105
84123,2024,19,19,0,0,100,293179,2404,111
84124,2024,27,10,17,63,37,300366,3875,70
84125,2024,1,1,0,0,100,160000,1778,90
84126,2024,6,6,0,0,100,560892,3509,176
84127,2024,30,28,2,7,93,268102,2716,97
84129,2024,170,101,69,41,59,182413,2254,81
84131,2024,16,16,0,0,100,430180,3798,124
84132,2024,86,69,17,20,80,316227,3149,100
84133,2024,40,22,18,45,55,247065,3060,79
84134,2024,6,5,1,17,83,264692,2397,113
84135,2024,14,14,0,0,100,406198,3671,120
84136,2024,11,10,1,9,91,414090,3292,117
84137,2024,92,63,29,32,68,293366,3396,88
84138,2024,102,75,27,26,74,155023,1868,83
84139,2024,4,4,0,0,100,385268,5237,66
84140,2024,9,9,0,0,100,598414,4765,120
84141,2024,87,73,14,16,84,244288,2828,88
84142,2024,39,35,4,10,90,303524,3437,95
84143,2024,17,17,0,0,100,521383,4769,116
84144,2024,10,6,4,40,60,169244,2221,75
84145,2024,8,8,0,0,100,340757,3410,125
84146,2024,8,8,0,0,100,374179,3099,127
84147,2024,30,25,5,17,83,297698,3322,92
84148,2024,26,25,1,4,96,182106,2526,79
84149,2024,18,17,1,6,94,252854,2941,90
84150,2024,18,17,1,6,94,270975,2447,105
84151,2024,1,1,0,0,100,600000,4615,130
85001,2024,103,98,5,5,95,187624,2917,68
85002,2024,42,42,0,0,100,212454,2758,78
85003,2024,96,93,3,3,97,235762,2507,96
85004,2024,62,62,0,0,100,240459,2884,85
85005,2024,8,8,0,0,100,120764,1096,115
85006,2024,31,31,0,0,100,191670,2217,88
85008,2024,64,64,0,0,100,225568,2406,94
85009,2024,11,11,0,0,100,157064,1339,118
85010,2024,25,24,1,4,96,217292,2380,88
85011,2024,49,46,3,6,94,303595,4303,76
85012,2024,61,46,15,25,75,207640,2933,75
85013,2024,10,10,0,0,100,180113,1824,98
85014,2024,13,13,0,0,100,123808,1148,113
85015,2024,13,13,0,0,100,202277,2046,101
85016,2024,22,22,0,0,100,172052,1807,100
85017,2024,15,15,0,0,100,171270,1815,95
85018,2024,68,67,1,1,99,193172,2454,81
85019,2024,57,57,0,0,100,208999,2065,105
85020,2024,46,46,0,0,100,188652,1801,112
85021,2024,1,1,0,0,100,325322,1459,223
85022,2024,19,19,0,0,100,211127,2578,84
85023,2024,5,5,0,0,100,152431,1417,112
85024,2024,26,24,2,8,92,175441,1891,99
85025,2024,17,17,0,0,100,169894,1714,103
85026,2024,21,21,0,0,100,198979,2034,101
85028,2024,4,4,0,0,100,100000,1249,90
85029,2024,39,39,0,0,100,178929,2334,80
85031,2024,34,34,0,0,100,147705,1715,89
85033,2024,9,9,0,0,100,131702,1473,93
85034,2024,32,32,0,0,100,143280,1802,84
85035,2024,166,141,25,15,85,258276,4045,70
85036,2024,8,8,0,0,100,141380,1877,79
85038,2024,42,42,0,0,100,185211,1892,99
85039,2024,33,33,0,0,100,155043,2055,80
85040,2024,8,8,0,0,100,129562,1249,105
85042,2024,23,23,0,0,100,142138,1511,101
85045,2024,23,23,0,0,100,173289,2254,77
85046,2024,34,33,1,3,97,197284,2067,98
85047,2024,286,225,61,21,79,232858,2659,87
85049,2024,18,18,0,0,100,168888,1862,95
85050,2024,30,30,0,0,100,162095,2114,88
85051,2024,113,104,9,8,92,172883,1807,96
85054,2024,17,17,0,0,100,216578,2308,94
85055,2024,17,17,0,0,100,153689,1817,91
85056,2024,6,6,0,0,100,158092,1978,105
85058,2024,16,16,0,0,100,247338,2094,120
85059,2024,29,28,1,3,97,128853,1315,101
85061,2024,20,19,1,5,95,161723,1666,98
85062,2024,10,10,0,0,100,248640,2495,101
85064,2024,17,17,0,0,100,171441,1731,101
85065,2024,32,32,0,0,100,161789,1625,102
85066,2024,13,13,0,0,100,126335,1359,96
85067,2024,14,14,0,0,100,132115,1352,101
85070,2024,42,41,1,2,98,203341,2226,91
85071,2024,50,50,0,0,100,235585,2562,93
85072,2024,15,15,0,0,100,208222,2467,89
85073,2024,8,8,0,0,100,323781,2427,126
85074,2024,4,4,0,0,100,95000,1149,79
85076,2024,33,33,0,0,100,232166,2534,95
85077,2024,8,8,0,0,100,175875,2284,79
85078,2024,11,11,0,0,100,146288,1593,100
85080,2024,14,14,0,0,100,161036,1348,134
85081,2024,43,43,0,0,100,238011,2310,108
85082,2024,31,30,1,3,97,170468,1885,88
85083,2024,43,43,0,0,100,412855,4866,89
85084,2024,59,59,0,0,100,193001,2127,94
85086,2024,13,13,0,0,100,182890,2023,89
85087,2024,8,8,0,0,100,69558,840,92
85088,2024,69,67,2,3,97,293869,3145,95
85089,2024,55,53,2,4,96,221999,2241,98
85090,2024,55,55,0,0,100,158041,1769,95
85092,2024,197,165,32,16,84,149718,1655,91
85093,2024,12,12,0,0,100,190000,1809,104
85094,2024,28,28,0,0,100,108169,1206,94
85095,2024,27,27,0,0,100,200714,2086,102
85096,2024,67,67,0,0,100,233850,2308,102
85097,2024,21,21,0,0,100,204719,2094,97
85098,2024,17,17,0,0,100,210352,2058,101
85099,2024,11,11,0,0,100,248280,2497,100
85100,2024,27,26,1,4,96,277692,3317,84
85101,2024,8,8,0,0,100,201191,2120,95
85102,2024,10,10,0,0,100,178332,1699,102
85103,2024,22,22,0,0,100,199405,1968,102
85104,2024,25,24,1,4,96,175058,2123,86
85105,2024,9,9,0,0,100,183000,1802,108
85106,2024,41,38,3,7,93,320432,4121,80
85108,2024,38,38,0,0,100,221992,2279,100
85109,2024,150,142,8,5,95,223803,2339,96
85110,2024,15,15,0,0,100,164620,1515,111
85111,2024,23,23,0,0,100,154199,1522,101
85112,2024,39,39,0,0,100,306244,3047,100
85113,2024,80,79,1,1,99,576944,7091,87
85114,2024,107,88,19,18,82,269973,3722,76
85115,2024,12,11,1,8,92,135675,1325,104
85116,2024,9,9,0,0,100,202856,2316,88
85117,2024,9,9,0,0,100,171644,2074,88
85118,2024,24,24,0,0,100,245974,2355,103
85119,2024,18,18,0,0,100,217050,1884,111
85120,2024,17,17,0,0,100,257067,2459,105
85121,2024,15,15,0,0,100,154422,1534,103
85123,2024,2,2,0,0,100,183000,1210,148
85125,2024,3,3,0,0,100,155000,1393,114
85126,2024,10,10,0,0,100,190210,1756,110
85127,2024,80,68,12,15,85,223429,3178,75
85128,2024,134,116,18,13,87,180125,1939,93
85129,2024,41,41,0,0,100,209644,1910,110
85130,2024,17,17,0,0,100,177682,1938,97
85131,2024,14,14,0,0,100,189988,1776,100
85132,2024,11,11,0,0,100,143373,1418,125
85133,2024,10,10,0,0,100,161300,1382,116
85134,2024,6,6,0,0,100,142833,1761,81
85135,2024,44,42,2,5,95,141370,1608,87
85136,2024,2,2,0,0,100,162500,1476,111
85137,2024,11,11,0,0,100,136858,1253,113
85138,2024,7,7,0,0,100,199684,2279,92
85140,2024,17,17,0,0,100,121118,1403,87
85141,2024,7,7,0,0,100,127694,1226,112
85142,2024,12,12,0,0,100,177083,1734,99
85143,2024,18,18,0,0,100,122946,1507,82
85144,2024,8,8,0,0,100,183000,2006,93
85145,2024,11,11,0,0,100,127000,1254,100
85146,2024,194,169,25,13,87,214373,2383,95
85147,2024,22,22,0,0,100,133855,1455,95
85148,2024,12,12,0,0,100,136612,1448,94
85149,2024,5,5,0,0,100,139200,1501,95
85151,2024,50,50,0,0,100,190326,2161,90
85152,2024,70,69,1,1,99,227732,2323,102
85153,2024,29,29,0,0,100,176080,1915,100
85154,2024,19,19,0,0,100,137379,1453,97
85155,2024,55,55,0,0,100,266192,2445,108
85156,2024,33,33,0,0,100,220104,2299,98
85157,2024,11,11,0,0,100,130181,1364,98
85158,2024,18,18,0,0,100,170341,1642,107
85159,2024,31,31,0,0,100,169989,1574,106
85160,2024,31,28,3,10,90,201611,2159,93
85161,2024,19,19,0,0,100,179319,2139,86
85162,2024,19,18,1,5,95,138742,1387,105
85163,2024,115,99,16,14,86,448102,5744,79
85164,2024,66,43,23,35,65,216686,3538,67
85165,2024,3,3,0,0,100,84333,1322,62
85167,2024,5,5,0,0,100,174800,1649,104
85169,2024,5,5,0,0,100,154840,1648,102
85171,2024,8,8,0,0,100,135750,1582,86
85172,2024,25,25,0,0,100,216422,2125,107
85174,2024,8,8,0,0,100,172525,1658,103
85175,2024,10,10,0,0,100,178759,1649,108
85176,2024,9,9,0,0,100,128833,1410,95
85177,2024,16,16,0,0,100,136828,1309,106
85178,2024,84,82,2,2,98,221605,2194,103
85179,2024,3,3,0,0,100,197000,2010,95
85181,2024,8,8,0,0,100,165280,1442,113
85182,2024,89,77,12,13,87,148614,1538,99
85184,2024,14,14,0,0,100,109225,997,110
85185,2024,8,8,0,0,100,227792,1864,131
85186,2024,6,6,0,0,100,200500,1792,111
85187,2024,8,8,0,0,100,151525,1383,115
85188,2024,6,6,0,0,100,88917,960,100
85189,2024,26,26,0,0,100,197122,2536,84
85190,2024,33,32,1,3,97,209317,2261,95
85191,2024,729,396,333,46,54,188376,2443,79
85192,2024,8,7,1,12,88,144888,1491,94
85193,2024,8,8,0,0,100,193288,1573,120
85194,2024,1043,634,409,39,61,314325,4488,74
85196,2024,26,26,0,0,100,169285,1758,101
85197,2024,42,42,0,0,100,168269,1817,96
85198,2024,14,14,0,0,100,223929,2174,109
85199,2024,2,2,0,0,100,150000,1602,107
85200,2024,16,16,0,0,100,208175,2280,94
85201,2024,10,10,0,0,100,206870,1959,125
85202,2024,17,17,0,0,100,158645,1509,102
85204,2024,32,32,0,0,100,188831,1996,100
85205,2024,8,8,0,0,100,158100,1749,92
85206,2024,11,11,0,0,100,147989,1506,94
85207,2024,3,3,0,0,100,223333,2269,100
85208,2024,18,18,0,0,100,221675,2095,106
85209,2024,8,8,0,0,100,171444,1452,117
85210,2024,26,26,0,0,100,208098,1931,112
85211,2024,29,29,0,0,100,218657,2254,101
85212,2024,2,2,0,0,100,201800,2033,100
85213,2024,50,50,0,0,100,191354,1950,104
85214,2024,25,25,0,0,100,297542,3100,95
85215,2024,40,39,1,2,98,194878,2121,92
85216,2024,20,20,0,0,100,194305,1815,108
85218,2024,19,19,0,0,100,222342,2384,97
85220,2024,23,23,0,0,100,152196,1576,96
85221,2024,39,39,0,0,100,204497,2508,90
85222,2024,270,159,111,41,59,318238,4452,74
85223,2024,45,44,1,2,98,182235,1605,108
85226,2024,502,278,224,45,55,212827,3524,62
85227,2024,16,16,0,0,100,161925,1453,112
85229,2024,9,9,0,0,100,156111,1420,106
85231,2024,11,11,0,0,100,225782,2705,84
85232,2024,8,8,0,0,100,172698,1686,102
85233,2024,2,2,0,0,100,307500,1810,176
85234,2024,354,166,188,53,47,190007,3386,59
85235,2024,10,10,0,0,100,128242,1498,87
85236,2024,21,21,0,0,100,214843,2633,83
85237,2024,12,12,0,0,100,138663,1120,118
85238,2024,41,41,0,0,100,198258,1865,106
85239,2024,15,15,0,0,100,248827,2462,104
85240,2024,14,14,0,0,100,183500,2026,93
85242,2024,3,3,0,0,100,292667,2089,136
85243,2024,52,52,0,0,100,272593,3227,88
85244,2024,2,2,0,0,100,145000,1420,135
85245,2024,5,5,0,0,100,123640,950,122
85246,2024,23,23,0,0,100,163581,1741,94
85247,2024,16,16,0,0,100,180979,1754,102
85248,2024,7,7,0,0,100,133797,1335,93
85250,2024,31,31,0,0,100,256188,2818,93
85251,2024,6,6,0,0,100,103397,1421,72
85252,2024,7,7,0,0,100,132000,1202,114
85254,2024,18,18,0,0,100,177600,1823,106
85255,2024,41,41,0,0,100,185504,2256,88
85256,2024,7,7,0,0,100,128936,1320,97
85259,2024,7,7,0,0,100,282643,2183,117
85260,2024,10,10,0,0,100,187563,2149,93
85261,2024,4,4,0,0,100,99384,1376,88
85262,2024,30,26,4,13,87,200893,2343,89
85264,2024,20,20,0,0,100,131500,1274,103
85265,2024,8,8,0,0,100,81688,810,98
85266,2024,15,15,0,0,100,166820,1594,104
85267,2024,15,15,0,0,100,172853,1698,106
85268,2024,26,26,0,0,100,259569,2591,102
85269,2024,8,8,0,0,100,142338,1312,118
85273,2024,21,21,0,0,100,230810,2282,105
85274,2024,5,5,0,0,100,152580,1387,121
85276,2024,9,9,0,0,100,119676,1383,86
85277,2024,15,15,0,0,100,204272,2200,94
85278,2024,57,49,8,14,86,251293,3703,74
85280,2024,47,46,1,2,98,237308,2539,94
85281,2024,11,11,0,0,100,202205,1497,138
85282,2024,8,7,1,12,88,156312,1786,88
85284,2024,42,42,0,0,100,202810,2245,93
85285,2024,9,9,0,0,100,183566,1869,98
85286,2024,2,2,0,0,100,110150,1304,84
85287,2024,6,6,0,0,100,112776,1045,108
85288,2024,205,152,53,26,74,276307,3546,79
85289,2024,29,29,0,0,100,129982,1385,103
85290,2024,8,8,0,0,100,177488,1689,105
85291,2024,15,14,1,7,93,138808,1630,80
85292,2024,12,12,0,0,100,149738,1319,126
85293,2024,14,14,0,0,100,214932,1833,112
85294,2024,169,144,25,15,85,256006,4080,67
85295,2024,37,37,0,0,100,200169,1873,108
85296,2024,9,9,0,0,100,173944,1874,97
85297,2024,19,19,0,0,100,136959,1766,91
85298,2024,22,21,1,5,95,254115,3024,86
85300,2024,40,40,0,0,100,227021,2237,103
85301,2024,12,12,0,0,100,171692,1928,88
85302,2024,35,35,0,0,100,205909,2041,106
85303,2024,21,21,0,0,100,183702,1445,127
85304,2024,7,7,0,0,100,143014,1323,104
85305,2024,17,15,2,12,88,120879,1728,71
85306,2024,6,6,0,0,100,177150,1915,109
86001,2024,9,9,0,0,100,76852,943,89
86002,2024,3,3,0,0,100,138000,913,151
86003,2024,6,6,0,0,100,96583,993,108
86004,2024,12,12,0,0,100,82145,1244,81
86005,2024,12,12,0,0,100,106083,1116,96
86006,2024,10,10,0,0,100,89014,1024,87
86007,2024,13,13,0,0,100,146866,1414,106
86008,2024,5,5,0,0,100,88860,948,90
86009,2024,11,11,0,0,100,135018,1269,108
86010,2024,10,10,0,0,100,196515,1681,119
86011,2024,2,2,0,0,100,43200,585,74
86013,2024,1,1,0,0,100,165000,3000,55
86014,2024,17,16,1,6,94,147261,1617,92
86015,2024,20,20,0,0,100,87890,958,90
86016,2024,21,21,0,0,100,219354,1964,112
86017,2024,10,10,0,0,100,132580,1204,116
86018,2024,2,2,0,0,100,95750,1264,75
86019,2024,31,31,0,0,100,156404,1571,105
86020,2024,1,1,0,0,100,70000,886,79
86022,2024,2,2,0,0,100,106750,1218,86
86023,2024,5,5,0,0,100,167930,1128,145
86024,2024,13,13,0,0,100,230592,1923,122
86025,2024,5,5,0,0,100,52394,815,63
86026,2024,11,11,0,0,100,112455,1082,105
86027,2024,19,19,0,0,100,195039,2420,89
86028,2024,14,14,0,0,100,200690,1816,113
86029,2024,15,15,0,0,100,121098,1001,125
86031,2024,25,25,0,0,100,116311,1405,85
86032,2024,25,25,0,0,100,147616,1532,103
86034,2024,7,7,0,0,100,123878,1349,103
86035,2024,3,3,0,0,100,133667,1132,107
86036,2024,4,4,0,0,100,120000,1670,68
86037,2024,10,10,0,0,100,87032,654,119
86038,2024,1,1,0,0,100,118000,1242,95
86039,2024,14,14,0,0,100,156828,1418,111
86040,2024,4,4,0,0,100,57625,944,61
86041,2024,133,89,44,33,67,177785,2120,85
86042,2024,7,7,0,0,100,76593,996,79
86044,2024,7,7,0,0,100,122071,1194,94
86045,2024,14,14,0,0,100,157500,1569,99
86046,2024,19,19,0,0,100,149936,1652,93
86047,2024,10,10,0,0,100,140436,1542,87
86048,2024,12,12,0,0,100,155433,1761,88
86049,2024,9,9,0,0,100,104052,1162,84
86050,2024,14,14,0,0,100,143102,1662,93
86051,2024,2,2,0,0,100,113000,1010,110
86052,2024,11,11,0,0,100,141818,886,151
86053,2024,33,33,0,0,100,152559,1586,96
86054,2024,8,8,0,0,100,100068,1046,100
86055,2024,6,6,0,0,100,82500,942,93
86058,2024,6,6,0,0,100,194383,2216,97
86059,2024,4,4,0,0,100,162000,1659,96
86061,2024,25,25,0,0,100,93037,849,107
86062,2024,36,27,9,25,75,171661,2222,90
86063,2024,7,7,0,0,100,129357,1183,106
86064,2024,11,11,0,0,100,113356,981,115
86065,2024,7,7,0,0,100,121652,1239,93
86066,2024,383,316,67,17,83,116837,1324,89
86068,2024,11,11,0,0,100,108351,939,130
86069,2024,3,3,0,0,100,76167,768,103
86070,2024,88,86,2,2,98,121718,1402,87
86072,2024,4,4,0,0,100,199450,1692,110
86073,2024,7,7,0,0,100,77786,1181,66
86074,2024,8,8,0,0,100,120340,1377,83
86075,2024,7,7,0,0,100,102198,1237,84
86076,2024,28,28,0,0,100,227255,1988,115
86077,2024,14,14,0,0,100,113143,1218,94
86078,2024,44,41,3,7,93,121122,1119,113
86079,2024,8,8,0,0,100,76921,1012,77
86080,2024,6,6,0,0,100,115367,1279,89
86081,2024,11,11,0,0,100,118823,1297,101
86082,2024,60,60,0,0,100,126461,1134,114
86083,2024,9,9,0,0,100,157822,1715,94
86084,2024,4,4,0,0,100,65858,600,105
86085,2024,2,2,0,0,100,185000,1506,122
86086,2024,8,8,0,0,100,116062,1162,106
86088,2024,13,10,3,23,77,202262,2123,96
86089,2024,4,4,0,0,100,175750,1398,129
86090,2024,3,3,0,0,100,116508,1125,106
86091,2024,5,5,0,0,100,82300,1022,89
86092,2024,30,30,0,0,100,114950,1306,88
86093,2024,4,4,0,0,100,144750,1099,132
86094,2024,1,1,0,0,100,189000,1118,169
86095,2024,25,25,0,0,100,169942,1770,104
86096,2024,7,7,0,0,100,97129,1256,72
86097,2024,2,2,0,0,100,171000,1892,94
86099,2024,7,7,0,0,100,142900,1782,82
86100,2024,30,30,0,0,100,240404,2222,107
86102,2024,7,7,0,0,100,222529,1936,114
86103,2024,19,19,0,0,100,119526,1352,86
86104,2024,9,9,0,0,100,147983,1251,117
86105,2024,2,2,0,0,100,117500,1036,122
86106,2024,1,1,0,0,100,133000,1330,100
86107,2024,10,10,0,0,100,70658,1044,70
86108,2024,3,3,0,0,100,113467,1095,105
86109,2024,5,5,0,0,100,75180,1127,77
86110,2024,3,3,0,0,100,207978,1074,177
86111,2024,14,14,0,0,100,185024,1583,108
86112,2024,26,26,0,0,100,98024,996,93
86113,2024,24,24,0,0,100,188488,2055,88
86114,2024,12,12,0,0,100,191216,1638,117
86115,2024,87,77,10,11,89,186539,1996,99
86116,2024,7,7,0,0,100,107714,992,107
86117,2024,5,5,0,0,100,84400,877,89
86118,2024,6,6,0,0,100,89989,1177,87
86119,2024,6,6,0,0,100,91750,945,110
86120,2024,16,16,0,0,100,64358,738,82
86121,2024,10,10,0,0,100,135645,1512,89
86123,2024,37,37,0,0,100,139425,1386,105
86124,2024,6,6,0,0,100,206655,1977,107
86125,2024,10,10,0,0,100,145004,1322,107
86126,2024,7,7,0,0,100,112571,1163,93
86127,2024,5,5,0,0,100,83300,1084,76
86128,2024,40,40,0,0,100,114046,1286,90
86129,2024,4,4,0,0,100,67750,825,78
86130,2024,7,7,0,0,100,67429,924,72
86131,2024,9,9,0,0,100,109556,1227,95
86132,2024,5,5,0,0,100,94031,839,112
86133,2024,33,32,1,3,97,211680,2103,101
86134,2024,3,3,0,0,100,145667,1604,97
86135,2024,10,10,0,0,100,175400,1650,110
86136,2024,6,6,0,0,100,144642,1349,102
86137,2024,96,91,5,5,95,109380,1211,96
86138,2024,3,3,0,0,100,74528,919,79
86139,2024,24,24,0,0,100,127573,1318,99
86140,2024,34,34,0,0,100,103769,1289,84
86141,2024,2,2,0,0,100,57000,868,66
86142,2024,6,6,0,0,100,133417,1412,99
86143,2024,1,1,0,0,100,100000,1000,100
86144,2024,4,4,0,0,100,106500,1520,73
86145,2024,7,7,0,0,100,173514,1702,106
86147,2024,8,8,0,0,100,153875,1784,87
86148,2024,6,6,0,0,100,165283,1580,105
86149,2024,2,2,0,0,100,57400,835,68
86150,2024,3,3,0,0,100,116717,834,133
86151,2024,2,2,0,0,100,85900,714,128
86152,2024,11,11,0,0,100,126682,1170,106
86153,2024,11,11,0,0,100,105435,1327,83
86154,2024,5,5,0,0,100,103000,924,115
86156,2024,2,2,0,0,100,76500,852,90
86157,2024,52,49,3,6,94,224574,2247,102
86158,2024,55,53,2,4,96,192973,1900,101
86159,2024,7,7,0,0,100,68462,936,69
86160,2024,22,22,0,0,100,116532,1263,89
86161,2024,12,12,0,0,100,83083,966,85
86162,2024,1,1,0,0,100,108000,1227,88
86163,2024,26,25,1,4,96,275048,2274,123
86164,2024,8,8,0,0,100,132962,1308,96
86165,2024,84,77,7,8,92,101375,1218,84
86167,2024,10,10,0,0,100,144437,1278,118
86169,2024,10,10,0,0,100,80925,953,85
86170,2024,5,5,0,0,100,102474,692,137
86171,2024,7,7,0,0,100,64671,1234,58
86172,2024,1,1,0,0,100,470000,4196,112
86173,2024,3,3,0,0,100,96388,693,118
86174,2024,52,52,0,0,100,163593,1607,101
86175,2024,4,4,0,0,100,68000,789,88
86176,2024,1,1,0,0,100,44400,822,54
86177,2024,61,56,5,8,92,176177,1879,97
86178,2024,20,20,0,0,100,206494,1790,119
86180,2024,23,22,1,4,96,225378,2110,107
86181,2024,1,1,0,0,100,96300,1070,90
86182,2024,5,5,0,0,100,119320,1173,108
86183,2024,26,26,0,0,100,116427,1088,108
86184,2024,15,15,0,0,100,151343,1371,107
86186,2024,6,6,0,0,100,173167,1496,120
86187,2024,3,3,0,0,100,60333,625,105
86190,2024,16,16,0,0,100,80165,876,93
86191,2024,5,5,0,0,100,117400,1322,97
86192,2024,1,1,0,0,100,62000,925,67
86193,2024,17,17,0,0,100,122420,1100,105
86194,2024,1219,427,792,65,35,140320,2237,67
86195,2024,4,4,0,0,100,114000,1293,88
86196,2024,2,1,1,50,50,287200,3050,96
86197,2024,2,2,0,0,100,193000,1192,142
86198,2024,4,4,0,0,100,200250,2011,103
86200,2024,6,6,0,0,100,100483,2550,54
86201,2024,3,3,0,0,100,67017,473,139
86202,2024,8,8,0,0,100,108144,978,102
86203,2024,11,11,0,0,100,89376,1171,95
86204,2024,11,11,0,0,100,235136,1941,124
86205,2024,9,9,0,0,100,93197,1099,86
86206,2024,2,2,0,0,100,225000,1210,186
86207,2024,25,18,7,28,72,119111,1659,82
86209,2024,29,29,0,0,100,193622,2029,98
86210,2024,3,3,0,0,100,144651,1090,132
86211,2024,9,9,0,0,100,160381,1055,141
86213,2024,23,23,0,0,100,108305,1143,95
86214,2024,90,64,26,29,71,195201,2159,90
86217,2024,4,4,0,0,100,136192,1399,98
86218,2024,3,3,0,0,100,59000,657,89
86220,2024,3,3,0,0,100,58827,684,85
86221,2024,8,8,0,0,100,115342,1119,105
86222,2024,29,29,0,0,100,198772,1930,103
86223,2024,21,21,0,0,100,107326,1038,100
86224,2024,12,12,0,0,100,127071,1226,96
86225,2024,15,15,0,0,100,93967,1013,99
86226,2024,22,21,1,5,95,216743,1881,118
86227,2024,1,1,0,0,100,87400,920,95
86228,2024,2,2,0,0,100,159350,1410,116
86229,2024,3,3,0,0,100,143300,1300,109
86230,2024,5,5,0,0,100,91180,919,96
86233,2024,35,35,0,0,100,135201,1321,104
86234,2024,5,5,0,0,100,184800,1412,113
86235,2024,20,20,0,0,100,152009,1532,107
86236,2024,9,9,0,0,100,48722,1062,55
86237,2024,6,6,0,0,100,129427,1339,92
86239,2024,4,4,0,0,100,120625,993,108
86241,2024,3,3,0,0,100,87333,933,89
86242,2024,9,9,0,0,100,81766,996,87
86244,2024,24,22,2,8,92,86048,1071,86
86245,2024,17,17,0,0,100,130059,1381,98
86246,2024,13,12,1,8,92,84995,1082,86
86247,2024,5,5,0,0,100,109360,762,156
86248,2024,5,5,0,0,100,89300,872,97
86250,2024,5,5,0,0,100,149700,1653,92
86252,2024,7,7,0,0,100,115093,1459,75
86253,2024,11,11,0,0,100,109742,919,116
86254,2024,13,13,0,0,100,117298,1170,92
86255,2024,23,23,0,0,100,95067,870,103
86256,2024,9,9,0,0,100,273108,1832,151
86257,2024,4,4,0,0,100,107150,1003,114
86258,2024,18,18,0,0,100,142121,1371,99
86260,2024,4,4,0,0,100,104900,1631,64
86261,2024,14,12,2,14,86,209427,1756,119
86262,2024,7,7,0,0,100,115643,1105,105
86263,2024,17,17,0,0,100,178456,1820,100
86264,2024,9,9,0,0,100,68980,846,89
86265,2024,7,7,0,0,100,119500,1304,91
86266,2024,5,5,0,0,100,133200,1088,113
86268,2024,9,9,0,0,100,181997,1575,110
86270,2024,3,3,0,0,100,168734,2065,71
86271,2024,7,7,0,0,100,136071,1239,107
86272,2024,30,30,0,0,100,136109,1393,99
86273,2024,12,12,0,0,100,65417,798,85
86274,2024,6,5,1,17,83,145410,1279,115
86275,2024,6,6,0,0,100,132640,1584,80
86276,2024,19,19,0,0,100,75097,855,91
86279,2024,3,3,0,0,100,144567,1425,103
86280,2024,3,3,0,0,100,126067,900,130
86281,2024,49,48,1,2,98,179024,1554,117
86284,2024,5,5,0,0,100,185100,1720,104
86285,2024,8,8,0,0,100,145862,1417,102
86286,2024,8,8,0,0,100,93412,1116,81
86287,2024,6,6,0,0,100,146500,1296,100
86288,2024,14,14,0,0,100,106000,970,98
86289,2024,10,10,0,0,100,95369,971,100
86290,2024,27,27,0,0,100,160438,1546,103
86291,2024,2,2,0,0,100,64000,834,73
86292,2024,5,5,0,0,100,199694,1561,125
86293,2024,40,39,1,2,98,158674,1759,92
86294,2024,40,40,0,0,100,183450,1714,109
86295,2024,5,5,0,0,100,120025,1200,100
86296,2024,3,3,0,0,100,100667,1228,79
86297,2024,58,56,2,3,97,206635,2164,97
86298,2024,17,17,0,0,100,135291,1505,95
86299,2024,2,2,0,0,100,76250,594,134
86300,2024,5,5,0,0,100,158200,1628,99
87001,2024,55,53,2,4,96,153451,1728,94
87002,2024,42,37,5,12,88,159126,1749,89
87003,2024,13,13,0,0,100,116455,1065,113
87004,2024,1,1,0,0,100,50000,625,80
87005,2024,11,11,0,0,100,174155,2012,92
87006,2024,3,3,0,0,100,70333,770,94
87007,2024,9,9,0,0,100,98363,1137,92
87009,2024,4,4,0,0,100,80500,1421,55
87011,2024,49,45,4,8,92,102151,1161,91
87012,2024,4,4,0,0,100,69412,906,84
87013,2024,7,7,0,0,100,100871,1238,78
87014,2024,22,20,2,9,91,91929,1026,89
87015,2024,5,5,0,0,100,112600,1188,97
87016,2024,7,7,0,0,100,84929,835,107
87017,2024,4,4,0,0,100,122000,1301,90
87018,2024,6,6,0,0,100,100815,1122,92
87019,2024,30,30,0,0,100,218399,2140,104
87020,2024,14,14,0,0,100,139907,1515,94
87021,2024,27,27,0,0,100,165786,1770,93
87022,2024,3,3,0,0,100,91950,1173,85
87023,2024,4,4,0,0,100,113627,1108,103
87024,2024,22,22,0,0,100,115250,1333,86
87025,2024,4,4,0,0,100,174500,1638,110
87027,2024,27,27,0,0,100,101976,1153,85
87028,2024,45,45,0,0,100,103347,1112,96
87029,2024,10,10,0,0,100,93080,910,108
87030,2024,6,6,0,0,100,159608,1632,94
87031,2024,4,4,0,0,100,128845,1718,86
87032,2024,17,15,2,12,88,85352,1246,68
87033,2024,6,6,0,0,100,161583,1377,117
87034,2024,5,5,0,0,100,95478,1170,90
87035,2024,7,7,0,0,100,121193,1131,113
87036,2024,10,10,0,0,100,128662,1516,97
87037,2024,5,5,0,0,100,143986,2592,84
87038,2024,18,18,0,0,100,193696,1836,110
87039,2024,5,5,0,0,100,94960,1101,99
87040,2024,18,18,0,0,100,110514,1253,87
87041,2024,30,30,0,0,100,109429,1270,92
87042,2024,4,4,0,0,100,204888,1483,119
87043,2024,6,6,0,0,100,154667,1798,85
87044,2024,6,6,0,0,100,132794,866,146
87045,2024,14,14,0,0,100,108315,1294,84
87046,2024,10,10,0,0,100,119370,1256,95
87047,2024,23,23,0,0,100,127930,1270,102
87048,2024,38,35,3,8,92,197797,2079,106
87049,2024,14,14,0,0,100,79918,1124,76
87050,2024,98,83,15,15,85,192266,1926,102
87051,2024,9,9,0,0,100,137081,1639,88
87052,2024,5,5,0,0,100,103000,934,108
87053,2024,7,7,0,0,100,86289,962,89
87054,2024,12,12,0,0,100,139806,1557,84
87056,2024,6,6,0,0,100,109287,945,98
87057,2024,5,5,0,0,100,62752,789,76
87058,2024,3,3,0,0,100,150512,1045,120
87059,2024,18,17,1,6,94,83221,862,91
87060,2024,14,14,0,0,100,112290,1085,102
87061,2024,10,10,0,0,100,68921,965,75
87062,2024,7,7,0,0,100,175857,1528,117
87063,2024,8,8,0,0,100,154150,1535,103
87064,2024,33,29,4,12,88,112860,1178,94
87065,2024,44,42,2,5,95,183246,2084,90
87066,2024,11,11,0,0,100,105421,1239,92
87067,2024,8,8,0,0,100,110594,1396,73
87068,2024,4,4,0,0,100,110705,1345,89
87069,2024,4,4,0,0,100,141852,1771,76
87070,2024,10,10,0,0,100,142829,1430,104
87071,2024,2,2,0,0,100,135000,1326,104
87072,2024,9,9,0,0,100,126778,1458,92
87073,2024,3,3,0,0,100,158450,1334,103
87074,2024,5,5,0,0,100,170500,1273,145
87075,2024,69,60,9,13,87,191064,1956,99
87076,2024,5,5,0,0,100,87327,1103,74
87077,2024,3,3,0,0,100,171564,1682,95
87078,2024,7,7,0,0,100,102209,1218,84
87079,2024,17,17,0,0,100,111215,1166,91
87080,2024,6,6,0,0,100,81167,916,93
87081,2024,6,6,0,0,100,133675,1546,87
87082,2024,21,21,0,0,100,95562,1123,95
87083,2024,13,13,0,0,100,93285,1024,95
87084,2024,2,2,0,0,100,182450,1908,96
87085,2024,1702,498,1204,71,29,116543,1727,68
87086,2024,11,11,0,0,100,108927,1271,87
87087,2024,17,17,0,0,100,87874,885,94
87088,2024,12,12,0,0,100,117933,1316,88
87089,2024,30,30,0,0,100,98816,1060,93
87090,2024,4,4,0,0,100,73000,790,87
87091,2024,5,5,0,0,100,108600,1033,99
87092,2024,8,8,0,0,100,184812,1492,125
87093,2024,3,3,0,0,100,93462,1025,98
87094,2024,3,3,0,0,100,191800,1537,124
87095,2024,8,7,1,12,88,139500,2628,72
87096,2024,9,9,0,0,100,112529,1236,92
87097,2024,18,18,0,0,100,92653,1034,94
87099,2024,5,5,0,0,100,177100,1388,135
87100,2024,5,5,0,0,100,83200,851,76
87101,2024,1,1,0,0,100,90000,818,110
87103,2024,19,18,1,5,95,100732,1300,79
87104,2024,12,12,0,0,100,72021,1147,70
87105,2024,9,9,0,0,100,96618,1076,90
87106,2024,26,26,0,0,100,138743,1495,94
87107,2024,10,10,0,0,100,178525,1549,116
87108,2024,7,7,0,0,100,96823,1060,100
87109,2024,6,6,0,0,100,61432,959,64
87110,2024,25,25,0,0,100,136426,1472,96
87111,2024,25,25,0,0,100,136328,1152,111
87112,2024,14,13,1,7,93,152383,1434,108
87113,2024,54,54,0,0,100,162051,1840,87
87114,2024,115,104,11,10,90,186664,1921,100
87115,2024,3,3,0,0,100,113333,1147,95
87116,2024,13,13,0,0,100,91719,1020,90
87117,2024,18,18,0,0,100,129569,1531,97
87118,2024,9,9,0,0,100,109236,1247,88
87119,2024,18,18,0,0,100,119830,1311,93
87120,2024,7,7,0,0,100,106843,1526,71
87121,2024,13,13,0,0,100,70219,878,78
87122,2024,13,13,0,0,100,85069,1059,85
87123,2024,1,1,0,0,100,87000,1403,62
87124,2024,6,6,0,0,100,168525,1698,107
87125,2024,41,41,0,0,100,181245,1830,100
87126,2024,52,51,1,2,98,120399,1328,90
87127,2024,7,6,1,14,86,92071,1493,76
87128,2024,15,15,0,0,100,120583,1399,88
87129,2024,12,12,0,0,100,173254,2004,92
87130,2024,2,2,0,0,100,89000,1012,88
87131,2024,12,12,0,0,100,92015,1332,74
87132,2024,3,3,0,0,100,126667,1168,103
87133,2024,4,4,0,0,100,127875,958,131
87134,2024,1,1,0,0,100,30000,476,63
87135,2024,13,13,0,0,100,115246,1328,98
87137,2024,1,1,0,0,100,90000,2093,43
87138,2024,7,7,0,0,100,196529,1819,111
87139,2024,11,11,0,0,100,94502,1210,83
87140,2024,16,16,0,0,100,160493,1825,90
87141,2024,14,14,0,0,100,100411,1137,88
87142,2024,5,5,0,0,100,117906,1426,115
87143,2024,16,16,0,0,100,194496,1755,113
87144,2024,4,4,0,0,100,180925,1264,148
87145,2024,2,2,0,0,100,58000,1172,60
87146,2024,15,15,0,0,100,121743,1170,101
87148,2024,5,5,0,0,100,186000,1886,100
87149,2024,6,6,0,0,100,101439,1087,91
87150,2024,13,13,0,0,100,138140,1293,102
87151,2024,1,1,0,0,100,105000,568,185
87152,2024,18,18,0,0,100,141520,1467,97
87153,2024,8,8,0,0,100,77562,1044,74
87154,2024,110,104,6,5,95,147951,1535,97
87155,2024,3,3,0,0,100,191000,1634,105
87156,2024,22,21,1,5,95,198796,1785,111
87157,2024,10,9,1,10,90,115337,1214,93
87158,2024,15,15,0,0,100,120043,1160,105
87159,2024,6,6,0,0,100,137683,1448,85
87160,2024,5,5,0,0,100,98474,801,123
87161,2024,41,38,3,7,93,120764,1376,91
87162,2024,1,1,0,0,100,143000,1644,87
87163,2024,4,4,0,0,100,144612,1725,89
87164,2024,3,3,0,0,100,151000,1567,97
87165,2024,4,4,0,0,100,97722,1292,78
87166,2024,10,10,0,0,100,164113,1625,106
87167,2024,11,11,0,0,100,152095,1421,105
87168,2024,17,17,0,0,100,101800,939,102
87169,2024,13,13,0,0,100,199672,1675,119
87170,2024,3,3,0,0,100,156145,1823,83
87172,2024,3,3,0,0,100,158440,1455,99
87174,2024,8,8,0,0,100,137177,1418,96
87176,2024,6,6,0,0,100,136850,1423,108
87177,2024,12,12,0,0,100,164149,1700,99
87178,2024,31,30,1,3,97,152085,1626,91
87179,2024,5,5,0,0,100,84060,936,92
87180,2024,10,10,0,0,100,119200,1047,112
87181,2024,13,13,0,0,100,75285,903,81
87182,2024,14,12,2,14,86,117341,1254,94
87183,2024,8,8,0,0,100,212525,1566,140
87185,2024,15,15,0,0,100,175379,1550,112
87186,2024,4,4,0,0,100,146750,1461,100
87187,2024,89,79,10,11,89,135948,1450,97
87188,2024,8,8,0,0,100,142699,1455,94
87189,2024,7,7,0,0,100,87149,1413,67
87190,2024,17,17,0,0,100,125177,1472,84
87191,2024,21,21,0,0,100,121578,1228,100
87192,2024,18,18,0,0,100,249727,2163,102
87194,2024,7,7,0,0,100,78786,1266,59
87195,2024,1,1,0,0,100,28000,412,68
87197,2024,8,8,0,0,100,119546,1668,92
87198,2024,4,4,0,0,100,146250,1612,91
87199,2024,15,15,0,0,100,84093,931,101
87201,2024,30,30,0,0,100,221394,1893,125
87202,2024,19,19,0,0,100,157984,1546,103
87203,2024,15,15,0,0,100,180377,1652,111
87204,2024,1,1,0,0,100,65000,1066,61
87205,2024,19,19,0,0,100,230345,1731,140
87206,2024,1,1,0,0,100,34000,486,70
88006,2024,1,1,0,0,100,175750,2585,68
88009,2024,24,22,2,8,92,152135,1706,88
88010,2024,2,2,0,0,100,72565,932,80
88011,2024,10,8,2,20,80,175805,1796,103
88012,2024,13,12,1,8,92,139115,1333,95
88013,2024,1,1,0,0,100,123500,515,240
88014,2024,1,1,0,0,100,110000,917,120
88015,2024,3,3,0,0,100,142253,992,144
88016,2024,3,3,0,0,100,87050,769,116
88017,2024,2,2,0,0,100,101000,634,130
88019,2024,2,2,0,0,100,98250,1133,88
88020,2024,1,1,0,0,100,199850,719,278
88021,2024,2,2,0,0,100,90875,916,100
88022,2024,3,3,0,0,100,84821,705,110
88023,2024,2,2,0,0,100,92000,1710,68
88025,2024,1,1,0,0,100,140000,1120,125
88026,2024,8,8,0,0,100,210731,2027,108
88027,2024,1,1,0,0,100,221000,1444,153
88028,2024,5,5,0,0,100,196490,1983,101
88029,2024,22,20,2,9,91,88602,964,101
88030,2024,3,3,0,0,100,139833,1033,105
88031,2024,1,1,0,0,100,182000,1492,122
88032,2024,15,14,1,7,93,218610,2107,107
88033,2024,2,2,0,0,100,172688,2380,86
88035,2024,2,2,0,0,100,57500,924,62
88036,2024,2,2,0,0,100,84000,851,110
88037,2024,11,9,2,18,82,201637,2330,93
88038,2024,2,2,0,0,100,42500,816,55
88039,2024,1,1,0,0,100,117500,1163,101
88040,2024,1,1,0,0,100,210250,1201,175
88041,2024,2,2,0,0,100,80000,917,84
88043,2024,3,3,0,0,100,65933,919,74
88044,2024,3,3,0,0,100,124400,1122,111
88047,2024,2,2,0,0,100,44750,664,79
88048,2024,6,5,1,17,83,156983,1286,120
88049,2024,1,1,0,0,100,120000,960,125
88050,2024,6,6,0,0,100,225717,2077,97
88051,2024,1,1,0,0,100,143300,1628,88
88052,2024,2,2,0,0,100,75000,688,110
88054,2024,4,4,0,0,100,351575,2299,150
88055,2024,2,2,0,0,100,200900,1545,130
88057,2024,1,1,0,0,100,89000,795,112
88059,2024,4,4,0,0,100,138000,880,158
88061,2024,6,6,0,0,100,108376,1094,109
88065,2024,3,3,0,0,100,116000,1265,88
88068,2024,8,7,1,12,88,120712,1551,80
88070,2024,2,2,0,0,100,74000,422,176
88071,2024,1,1,0,0,100,163050,1140,143
88073,2024,2,2,0,0,100,79500,848,98
88075,2024,113,49,64,57,43,154782,2387,69
88076,2024,2,2,0,0,100,147000,1590,91
88077,2024,4,4,0,0,100,159875,1206,144
88078,2024,34,23,11,32,68,112542,1115,102
88079,2024,10,10,0,0,100,116980,1172,113
88081,2024,29,20,9,31,69,132205,1612,86
88082,2024,8,8,0,0,100,80788,852,89
88083,2024,4,4,0,0,100,115125,1236,91
88084,2024,1,1,0,0,100,45000,562,80
88085,2024,4,4,0,0,100,132938,2278,60
88086,2024,4,4,0,0,100,122762,1291,99
88087,2024,49,33,16,33,67,171655,1827,90
88088,2024,7,7,0,0,100,99929,1018,113
88089,2024,11,10,1,9,91,129694,1313,108
88090,2024,44,34,10,23,77,125523,1451,86
88092,2024,6,6,0,0,100,139033,1314,105
88093,2024,1,1,0,0,100,30000,811,37
88094,2024,17,13,4,24,76,124404,1522,88
88095,2024,7,7,0,0,100,107419,981,107
88096,2024,2,2,0,0,100,112034,1012,120
88097,2024,1,1,0,0,100,179000,1279,140
88098,2024,10,7,3,30,70,176851,1986,94
88099,2024,21,19,2,10,90,190924,1740,112
88100,2024,1,1,0,0,100,115000,1045,110
88101,2024,15,14,1,7,93,133938,1217,113
88104,2024,1,0,1,100,0,320000,6957,46
88105,2024,1,1,0,0,100,72500,562,129
88106,2024,19,19,0,0,100,211944,2397,92
88108,2024,5,5,0,0,100,84300,1089,83
88109,2024,6,5,1,17,83,148583,2159,90
88110,2024,3,3,0,0,100,90667,746,126
88111,2024,2,2,0,0,100,100000,925,108
88113,2024,1,1,0,0,100,240000,2400,100
88114,2024,24,18,6,25,75,152487,1550,88
88115,2024,16,14,2,12,88,199688,2322,92
88116,2024,40,26,14,35,65,140282,1650,89
88117,2024,1,1,0,0,100,40000,471,85
88118,2024,2,2,0,0,100,162500,1790,90
88120,2024,6,5,1,17,83,148517,1416,118
88121,2024,1,1,0,0,100,48000,558,86
88122,2024,4,4,0,0,100,148275,978,156
88123,2024,7,7,0,0,100,48414,609,81
88124,2024,9,9,0,0,100,120137,1203,102
88126,2024,10,9,1,10,90,166260,1587,103
88127,2024,1,1,0,0,100,211000,1327,159
88128,2024,3,3,0,0,100,170300,1492,117
88129,2024,2,2,0,0,100,57562,475,121
88130,2024,1,1,0,0,100,28000,1750,16
88131,2024,2,2,0,0,100,111500,1410,82
88132,2024,12,9,3,25,75,154296,1567,104
88134,2024,3,3,0,0,100,167833,1385,129
88135,2024,9,8,1,11,89,124172,1015,124
88136,2024,9,9,0,0,100,201784,1640,112
88137,2024,1,1,0,0,100,40000,667,60
88138,2024,1,1,0,0,100,79500,874,91
88140,2024,3,3,0,0,100,117667,1254,93
88142,2024,7,6,1,14,86,161407,1626,94
88145,2024,1,1,0,0,100,209000,1742,120
88146,2024,3,3,0,0,100,104542,792,141
88147,2024,2,2,0,0,100,210825,2213,85
88148,2024,20,17,3,15,85,147232,1523,101
88150,2024,3,3,0,0,100,150500,1363,110
88151,2024,9,9,0,0,100,173100,1606,107
88153,2024,1,1,0,0,100,119500,996,120
88154,2024,1,1,0,0,100,28200,376,75
88155,2024,1,1,0,0,100,36500,462,79
88157,2024,10,10,0,0,100,161392,1883,81
88158,2024,21,17,4,19,81,170057,1588,112
88159,2024,7,7,0,0,100,180916,1910,96
88160,2024,425,152,273,64,36,129025,1551,81
88161,2024,4,4,0,0,100,107650,969,114
88162,2024,3,3,0,0,100,78167,830,100
88163,2024,7,7,0,0,100,165243,1430,121
88165,2024,22,21,1,5,95,160823,1599,107
88166,2024,5,5,0,0,100,159770,1552,101
88167,2024,1,1,0,0,100,285600,1731,165
88168,2024,1,1,0,0,100,40000,500,80
88170,2024,5,5,0,0,100,114240,1211,99
88172,2024,1,1,0,0,100,130000,929,140
88173,2024,5,5,0,0,100,115600,1306,84
88174,2024,1,1,0,0,100,182950,1307,140
88175,2024,6,6,0,0,100,205900,1619,120
88176,2024,13,13,0,0,100,86707,763,108
88177,2024,8,8,0,0,100,157688,1804,87
88178,2024,14,13,1,7,93,198137,1874,104
88179,2024,1,1,0,0,100,175000,1250,140
88181,2024,24,19,5,21,79,128521,1541,83
88182,2024,2,2,0,0,100,108250,974,124
88183,2024,1,1,0,0,100,51300,450,114
88184,2024,2,2,0,0,100,159115,2016,79
88185,2024,2,2,0,0,100,51500,438,114
88186,2024,1,1,0,0,100,266000,1064,250
88187,2024,3,3,0,0,100,96597,689,132
88188,2024,15,13,2,13,87,107877,1304,88
88189,2024,2,2,0,0,100,63445,674,90
88190,2024,1,1,0,0,100,170000,1156,147
88192,2024,3,3,0,0,100,172833,1041,163
88193,2024,1,1,0,0,100,194900,2564,76
88194,2024,2,2,0,0,100,56000,386,151
88196,2024,149,55,94,63,37,238111,3146,75
88197,2024,3,3,0,0,100,177187,1964,105
88198,2024,11,11,0,0,100,257328,2741,104
88201,2024,9,9,0,0,100,146444,1337,115
88202,2024,1,1,0,0,100,37000,370,100
88203,2024,2,2,0,0,100,253550,2011,125
88205,2024,5,5,0,0,100,165610,1817,92
88206,2024,15,14,1,7,93,107434,1067,101
88208,2024,2,2,0,0,100,43500,684,72
88209,2024,80,47,33,41,59,142096,1624,87
88212,2024,4,4,0,0,100,75188,723,98
88213,2024,1,1,0,0,100,386850,1488,260
88214,2024,1,1,0,0,100,53000,442,120
88215,2024,1,1,0,0,100,135000,1038,130
88216,2024,4,3,1,25,75,92950,1082,87
88218,2024,21,21,0,0,100,133023,1442,93
88221,2024,4,4,0,0,100,171375,1078,151
88222,2024,1,1,0,0,100,110000,1100,100
88223,2024,1,1,0,0,100,200000,1739,115
88224,2024,3,3,0,0,100,142217,1454,100
88225,2024,17,16,1,6,94,177400,1656,117
88226,2024,1,1,0,0,100,65000,833,78
88227,2024,2,2,0,0,100,85000,603,152
88228,2024,2,2,0,0,100,182225,1432,128
88231,2024,5,5,0,0,100,170920,1498,113
88233,2024,2,2,0,0,100,90750,756,120
88236,2024,2,2,0,0,100,52500,729,77
88237,2024,4,4,0,0,100,63350,964,66
88238,2024,2,2,0,0,100,154000,1320,116
88240,2024,1,1,0,0,100,67000,744,90
88241,2024,3,3,0,0,100,143930,1283,114
88243,2024,7,6,1,14,86,117286,1239,95
88244,2024,12,10,2,17,83,143042,1349,102
88245,2024,1,1,0,0,100,75000,1119,67
88246,2024,5,3,2,40,60,79500,978,82
88247,2024,10,10,0,0,100,192510,1750,116
88248,2024,4,4,0,0,100,56744,634,88
88249,2024,1,1,0,0,100,149000,1380,108
88250,2024,4,4,0,0,100,117750,1408,84
88251,2024,10,10,0,0,100,177788,1679,109
88252,2024,1,1,0,0,100,61000,642,95
88253,2024,3,3,0,0,100,202067,1590,125
88254,2024,1,1,0,0,100,69000,986,70
88255,2024,1,1,0,0,100,106650,762,140
88256,2024,2,2,0,0,100,110000,1424,80
88257,2024,2,2,0,0,100,82000,672,105
88258,2024,7,7,0,0,100,89889,909,107
88259,2024,2,2,0,0,100,71750,700,96
88260,2024,3,3,0,0,100,112333,1146,96
88261,2024,5,5,0,0,100,138200,1341,111
88262,2024,6,4,2,33,67,83417,792,99
88263,2024,3,3,0,0,100,344712,3465,103
88264,2024,1,1,0,0,100,75000,1136,66
88266,2024,5,1,4,80,20,53150,615,82
88267,2024,3,3,0,0,100,59500,763,79
88268,2024,1,1,0,0,100,240000,2000,120
88269,2024,3,3,0,0,100,349333,2702,126
88270,2024,21,20,1,5,95,78916,902,88
88271,2024,4,4,0,0,100,114125,987,128
88273,2024,3,3,0,0,100,159500,1333,112
88274,2024,1,1,0,0,100,23000,333,69
88275,2024,1,1,0,0,100,76500,2391,32
88276,2024,6,6,0,0,100,155668,1664,91
88279,2024,1,1,0,0,100,48000,348,138
88281,2024,1,1,0,0,100,31000,360,86
88284,2024,5,5,0,0,100,140800,1797,75
88285,2024,1,1,0,0,100,50000,505,99
88286,2024,1,1,0,0,100,36000,480,75
88289,2024,8,8,0,0,100,46562,699,68
88290,2024,2,2,0,0,100,95000,820,112
88291,2024,2,2,0,0,100,73750,487,130
88292,2024,6,6,0,0,100,115250,950,121
88293,2024,3,3,0,0,100,74333,720,92
88294,2024,4,4,0,0,100,181890,1776,101
88295,2024,2,2,0,0,100,198575,1818,108
88296,2024,2,2,0,0,100,48500,702,70
88297,2024,2,2,0,0,100,129150,1175,116
88298,2024,1,1,0,0,100,120000,6000,20
88299,2024,1,1,0,0,100,78300,967,81
88301,2024,5,5,0,0,100,108570,1197,107
88302,2024,15,14,1,7,93,149983,1841,87
88303,2024,2,2,0,0,100,87638,812,112
88304,2024,42,26,16,38,62,92375,1021,92
88306,2024,1,1,0,0,100,80000,727,110
88308,2024,3,3,0,0,100,126183,1528,83
88309,2024,2,2,0,0,100,149000,1076,139
88310,2024,7,7,0,0,100,81714,882,91
88311,2024,2,2,0,0,100,60100,1164,51
88312,2024,4,4,0,0,100,154265,1481,106
88313,2024,7,7,0,0,100,115431,1151,113
88314,2024,3,3,0,0,100,103017,778,127
88315,2024,2,2,0,0,100,88500,1404,98
88317,2024,7,6,1,14,86,91719,872,101
88319,2024,27,23,4,15,85,110221,1303,86
88320,2024,10,10,0,0,100,243650,2086,120
88321,2024,64,53,11,17,83,114367,1144,99
88322,2024,2,2,0,0,100,153000,1352,114
88324,2024,6,6,0,0,100,92644,1022,85
88326,2024,4,4,0,0,100,143288,1653,82
88327,2024,17,14,3,18,82,140002,1354,108
88328,2024,6,5,1,17,83,182565,1432,118
88331,2024,1,1,0,0,100,100000,1282,78
88332,2024,2,2,0,0,100,59344,542,112
88334,2024,4,2,2,50,50,68250,778,95
88340,2024,2,2,0,0,100,169250,1160,139
88341,2024,7,4,3,43,57,122614,1581,73
88342,2024,1,1,0,0,100,100000,1429,70
88343,2024,1,1,0,0,100,159000,1169,136
88344,2024,2,2,0,0,100,93862,958,95
88345,2024,3,3,0,0,100,183278,1612,118
88346,2024,11,8,3,27,73,98245,892,108
88347,2024,1,1,0,0,100,71000,780,91
88348,2024,1,1,0,0,100,378000,1718,220
88349,2024,20,16,4,20,80,137874,1463,100
88350,2024,1,1,0,0,100,136000,1511,90
88351,2024,26,14,12,46,54,94996,1281,76
88352,2024,2,2,0,0,100,86000,1017,84
88353,2024,3,3,0,0,100,75500,787,85
88354,2024,3,3,0,0,100,108993,1040,106
88355,2024,9,8,1,11,89,86458,1000,82
88356,2024,1,1,0,0,100,350000,3211,109
88357,2024,6,6,0,0,100,110842,1548,83
88358,2024,20,20,0,0,100,165712,1657,101
88359,2024,2,2,0,0,100,213555,1516,140
88361,2024,10,10,0,0,100,132126,1445,93
88362,2024,2,2,0,0,100,119500,1846,64
88363,2024,3,3,0,0,100,137033,1095,124
88364,2024,1,1,0,0,100,82000,745,110
88365,2024,1,1,0,0,100,93500,658,142
88366,2024,3,3,0,0,100,146167,1129,128
88367,2024,42,38,4,10,90,106669,1053,101
88368,2024,2,2,0,0,100,53718,530,102
88369,2024,16,16,0,0,100,146669,1387,106
88371,2024,12,12,0,0,100,199819,1614,141
88372,2024,55,38,17,31,69,103050,1184,87
88375,2024,6,6,0,0,100,200083,2004,101
88376,2024,4,4,0,0,100,81700,1185,67
88377,2024,2,2,0,0,100,63375,410,163
88379,2024,3,3,0,0,100,156333,1172,128
88380,2024,2,2,0,0,100,116065,1092,105
88381,2024,2,2,0,0,100,179000,1461,122
88382,2024,1,1,0,0,100,29900,623,48
88383,2024,141,37,104,74,26,117597,1535,80
88385,2024,5,5,0,0,100,101694,817,126
88386,2024,8,8,0,0,100,158310,1571,100
88387,2024,1,1,0,0,100,63800,638,100
88389,2024,1,1,0,0,100,86000,637,135
88390,2024,1,1,0,0,100,160000,667,240
88391,2024,7,7,0,0,100,214886,2677,87
88393,2024,1,1,0,0,100,120700,1087,111
88394,2024,1,1,0,0,100,153650,1506,102
88395,2024,3,3,0,0,100,103130,822,108
88398,2024,1,1,0,0,100,202000,1519,133
88399,2024,1,1,0,0,100,65000,903,72
88400,2024,2,2,0,0,100,92500,840,111
88401,2024,4,4,0,0,100,91574,863,110
88402,2024,2,2,0,0,100,79250,754,102
88403,2024,2,2,0,0,100,102500,572,168
88404,2024,1,1,0,0,100,51200,512,100
88406,2024,1,1,0,0,100,47500,490,97
88408,2024,38,34,4,11,89,147612,1530,98
88409,2024,32,19,13,41,59,135270,1575,85
88410,2024,6,6,0,0,100,104967,992,103
88412,2024,4,4,0,0,100,105250,1056,96
88413,2024,220,92,128,58,42,116413,1319,88
88415,2024,26,15,11,42,58,179590,1868,99
88416,2024,1,1,0,0,100,33000,508,65
88417,2024,2,2,0,0,100,110000,1094,92
88418,2024,3,3,0,0,100,70917,700,108
88419,2024,1,1,0,0,100,110000,1111,99
88421,2024,1,1,0,0,100,39000,661,59
88423,2024,15,14,1,7,93,162638,1841,97
88424,2024,17,15,2,12,88,165646,1815,93
88426,2024,13,11,2,15,85,131565,2263,75
88427,2024,1,1,0,0,100,100000,1020,98
88428,2024,23,17,6,26,74,154004,1541,95
88429,2024,34,31,3,9,91,169515,1715,100
88430,2024,3,3,0,0,100,65497,673,104
88431,2024,1,1,0,0,100,110000,1009,109
88433,2024,3,3,0,0,100,77250,907,103
88434,2024,2,2,0,0,100,146500,1508,98
88435,2024,4,4,0,0,100,157725,1893,86
88436,2024,2,2,0,0,100,97120,1042,78
88438,2024,9,8,1,11,89,192764,1680,115
88439,2024,2,2,0,0,100,168000,1746,96
88440,2024,1,1,0,0,100,83000,1186,70
88442,2024,6,5,1,17,83,203948,2630,86
88444,2024,5,5,0,0,100,95108,1464,71
88445,2024,23,17,6,26,74,175349,1709,100
88447,2024,26,22,4,15,85,165972,1732,99
88448,2024,1,1,0,0,100,91000,1542,59
88449,2024,3,3,0,0,100,177333,1437,115
88450,2024,3,3,0,0,100,95000,837,124
88451,2024,24,16,8,33,67,78545,861,92
88452,2024,3,3,0,0,100,61667,571,108
88454,2024,1,1,0,0,100,192500,2188,88
88455,2024,1,1,0,0,100,105000,739,142
88457,2024,2,2,0,0,100,107084,822,128
88460,2024,6,6,0,0,100,169075,1340,132
88461,2024,2,2,0,0,100,22500,386,58
88462,2024,14,12,2,14,86,153689,1600,94
88463,2024,8,7,1,12,88,154560,2367,86
88464,2024,3,3,0,0,100,317933,3298,101
88465,2024,83,59,24,29,71,130689,1436,92
88466,2024,1,1,0,0,100,215000,1870,115
88467,2024,5,4,1,20,80,126767,1225,115
88468,2024,20,17,3,15,85,165332,1320,122
88469,2024,1,1,0,0,100,76000,650,117
88470,2024,23,15,8,35,65,164089,2602,75
88471,2024,1,1,0,0,100,42000,350,120
88472,2024,3,3,0,0,100,89333,860,101
88473,2024,1,1,0,0,100,52000,1083,48
88475,2024,2,2,0,0,100,93875,1241,87
88476,2024,3,3,0,0,100,100950,839,107
88478,2024,3,3,0,0,100,40833,430,88
88479,2024,5,5,0,0,100,71269,830,84
88480,2024,3,3,0,0,100,162800,1263,133
88481,2024,10,9,1,10,90,146200,1360,109
88483,2024,11,11,0,0,100,175114,1781,98
88484,2024,10,10,0,0,100,142365,1341,106
88486,2024,32,27,5,16,84,188466,1926,106
88487,2024,26,19,7,27,73,125092,1314,96
88488,2024,1,1,0,0,100,157750,1066,148
88490,2024,2,2,0,0,100,107450,1296,83
88492,2024,2,2,0,0,100,237400,2657,96
88494,2024,1,1,0,0,100,85000,447,190
88495,2024,2,2,0,0,100,240750,1890,124
88496,2024,4,4,0,0,100,155625,1076,132
88497,2024,4,4,0,0,100,125450,1088,118
88498,2024,7,5,2,29,71,103236,1405,73
88499,2024,2,0,2,100,0,56300,533,106
88500,2024,14,10,4,29,71,149831,2228,71
88501,2024,1,1,0,0,100,219146,2259,97
88502,2024,1,1,0,0,100,152000,1600,95
88503,2024,2,2,0,0,100,70500,1044,66
88504,2024,2,2,0,0,100,58125,542,108
88506,2024,3,3,0,0,100,115063,969,128
88507,2024,3,3,0,0,100,107500,1156,102
88508,2024,5,5,0,0,100,192452,1348,148
88510,2024,1,1,0,0,100,79017,622,127
88511,2024,2,2,0,0,100,96000,802,134
88512,2024,3,3,0,0,100,181200,1919,119
88513,2024,16,15,1,6,94,123168,1226,97
88514,2024,1,1,0,0,100,68000,567,120
88515,2024,3,3,0,0,100,97667,982,97
88516,2024,82,36,46,56,44,109471,1411,72
88517,2024,6,6,0,0,100,96480,873,106
88518,2024,1,1,0,0,100,86500,1081,80
88519,2024,6,5,1,17,83,158175,1568,100
88520,2024,4,4,0,0,100,107925,858,126
88524,2024,2,2,0,0,100,47500,502,92
88526,2024,5,4,1,20,80,118256,1512,86
88527,2024,4,4,0,0,100,137618,1208,120
88528,2024,3,2,1,33,67,145333,1496,105
88529,2024,1,1,0,0,100,152000,1567,97
88530,2024,24,24,0,0,100,124948,1213,109
88531,2024,27,15,12,44,56,297113,3394,90
89002,2024,1,1,0,0,100,220000,957,230
89003,2024,35,34,1,3,97,140112,1524,97
89004,2024,3,3,0,0,100,80333,842,86
89005,2024,11,10,1,9,91,66701,980,66
89006,2024,2,2,0,0,100,101500,1097,84
89007,2024,7,7,0,0,100,95764,1261,83
89008,2024,4,4,0,0,100,72000,1132,66
89009,2024,5,5,0,0,100,154381,1494,108
89010,2024,3,3,0,0,100,81974,1042,103
89013,2024,35,34,1,3,97,141264,1615,86
89014,2024,5,5,0,0,100,100991,1069,90
89015,2024,10,10,0,0,100,61890,959,68
89016,2024,4,4,0,0,100,40125,524,76
89017,2024,1,1,0,0,100,76000,1086,70
89018,2024,12,12,0,0,100,117601,1580,74
89019,2024,1,1,0,0,100,37000,385,96
89020,2024,2,2,0,0,100,59000,814,76
89021,2024,7,7,0,0,100,106243,1622,62
89022,2024,1,1,0,0,100,145000,1355,107
89023,2024,10,9,1,10,90,135817,1954,73
89024,2024,479,183,296,62,38,125474,1760,71
89025,2024,67,41,26,39,61,98905,1392,70
89027,2024,7,7,0,0,100,103079,1181,108
89029,2024,11,11,0,0,100,142077,1289,117
89030,2024,4,4,0,0,100,110500,1238,88
89031,2024,5,5,0,0,100,139560,1249,119
89032,2024,1,1,0,0,100,112000,747,150
89033,2024,6,6,0,0,100,145183,1271,120
89034,2024,4,4,0,0,100,140178,1537,92
89035,2024,6,6,0,0,100,132250,1745,76
89036,2024,1,1,0,0,100,212000,1301,163
89037,2024,6,6,0,0,100,155833,1755,107
89038,2024,2,2,0,0,100,91000,1179,78
89039,2024,2,2,0,0,100,50250,572,92
89040,2024,2,2,0,0,100,62000,1704,42
89041,2024,1,1,0,0,100,77000,583,132
89042,2024,2,2,0,0,100,183275,955,185
89043,2024,2,2,0,0,100,158150,2267,67
89044,2024,3,3,0,0,100,35000,747,55
89045,2024,2,2,0,0,100,90000,999,92
89046,2024,19,19,0,0,100,88705,1068,86
89048,2024,5,5,0,0,100,88800,818,119
89049,2024,2,2,0,0,100,37500,655,58
89050,2024,15,13,2,13,87,110307,1532,74
89051,2024,6,6,0,0,100,120667,1342,95
89053,2024,6,6,0,0,100,135903,1702,84
89054,2024,10,10,0,0,100,170431,2168,80
89055,2024,25,23,2,8,92,67350,1126,70
89056,2024,6,6,0,0,100,109500,1413,79
89057,2024,6,6,0,0,100,87667,1037,88
89058,2024,3,3,0,0,100,115417,1186,103
89059,2024,7,7,0,0,100,117857,1260,96
89060,2024,4,4,0,0,100,154625,1282,124
89061,2024,4,4,0,0,100,175695,1304,134
89062,2024,1,1,0,0,100,92000,1415,65
89063,2024,10,10,0,0,100,105035,1237,88
89064,2024,2,2,0,0,100,112500,868,127
89066,2024,8,8,0,0,100,139675,1277,117
89067,2024,13,13,0,0,100,107423,1429,75
89068,2024,31,30,1,3,97,170481,1632,106
89069,2024,8,8,0,0,100,121375,1188,105
89071,2024,3,3,0,0,100,50000,695,77
89072,2024,5,5,0,0,100,58523,716,88
89073,2024,20,19,1,5,95,106085,1272,79
89074,2024,23,22,1,4,96,141612,1767,83
89075,2024,1,1,0,0,100,410000,1814,226
89076,2024,7,7,0,0,100,108571,1163,100
89077,2024,19,19,0,0,100,175724,2188,81
89079,2024,12,12,0,0,100,134825,1507,92
89080,2024,5,5,0,0,100,99600,1098,90
89083,2024,18,18,0,0,100,209386,1596,134
89084,2024,3,3,0,0,100,82000,770,112
89085,2024,19,19,0,0,100,88915,1302,71
89086,2024,87,86,1,1,99,120959,1245,92
89087,2024,3,3,0,0,100,92167,1141,70
89088,2024,2,2,0,0,100,232750,1410,168
89089,2024,2,2,0,0,100,73500,1336,56
89091,2024,14,14,0,0,100,74664,1089,67
89092,2024,3,3,0,0,100,66996,846,66
89093,2024,5,5,0,0,100,128200,2088,61
89094,2024,5,5,0,0,100,183000,1494,114
89095,2024,3,3,0,0,100,141960,1109,121
89096,2024,10,10,0,0,100,157970,1747,91
89099,2024,27,27,0,0,100,124899,1439,93
89100,2024,24,23,1,4,96,146354,1816,84
89101,2024,7,7,0,0,100,92968,795,112
89102,2024,29,29,0,0,100,164971,1616,103
89104,2024,3,3,0,0,100,84967,897,100
89105,2024,4,4,0,0,100,181212,1773,99
89108,2024,4,4,0,0,100,110975,1741,66
89111,2024,6,6,0,0,100,149917,1419,113
89112,2024,1,1,0,0,100,60000,769,78
89113,2024,6,6,0,0,100,169192,1636,106
89115,2024,5,5,0,0,100,151200,1546,97
89116,2024,6,6,0,0,100,182841,1391,132
89117,2024,5,5,0,0,100,111493,1000,114
89118,2024,4,4,0,0,100,71325,741,90
89119,2024,5,5,0,0,100,143000,972,124
89120,2024,3,3,0,0,100,115000,1158,99
89122,2024,7,7,0,0,100,135293,1357,96
89123,2024,1,1,0,0,100,62000,1170,53
89124,2024,16,16,0,0,100,153438,1450,115
89125,2024,8,8,0,0,100,73335,875,81
89126,2024,1,1,0,0,100,110000,1068,103
89127,2024,4,4,0,0,100,229525,1848,126
89128,2024,2,2,0,0,100,77710,742,115
89129,2024,3,3,0,0,100,81737,1114,69
89130,2024,16,16,0,0,100,102256,1160,89
89131,2024,4,4,0,0,100,87500,1610,70
89133,2024,6,6,0,0,100,109983,978,128
89136,2024,6,6,0,0,100,240943,2308,101
89137,2024,1,1,0,0,100,130000,1444,90
89139,2024,9,9,0,0,100,160622,1507,110
89141,2024,2,2,0,0,100,110355,733,151
89142,2024,20,20,0,0,100,129841,1546,86
89143,2024,4,4,0,0,100,137375,1864,76
89144,2024,11,11,0,0,100,137823,1636,90
89145,2024,4,4,0,0,100,131750,1098,119
89146,2024,1,1,0,0,100,15000,536,28
89147,2024,2,2,0,0,100,186500,1120,148
89148,2024,4,4,0,0,100,117000,1068,110
89149,2024,5,5,0,0,100,86026,796,104
89150,2024,6,6,0,0,100,96133,1326,70
89151,2024,23,23,0,0,100,117233,1575,75
89152,2024,8,7,1,12,88,144873,1693,83
89153,2024,10,10,0,0,100,117700,998,111
89154,2024,10,10,0,0,100,142300,1257,107
89155,2024,4,4,0,0,100,189225,1360,150
89156,2024,2,2,0,0,100,116000,817,144
89158,2024,14,13,1,7,93,91895,998,90
89159,2024,6,6,0,0,100,211792,1590,125
89160,2024,10,10,0,0,100,153535,1765,85
89162,2024,2,2,0,0,100,172600,1518,119
89163,2024,7,7,0,0,100,152000,1301,106
89164,2024,1,1,0,0,100,66500,747,89
89165,2024,3,3,0,0,100,67667,1158,69
89167,2024,7,7,0,0,100,206550,1539,130
89168,2024,1,1,0,0,100,89000,989,90
89169,2024,10,10,0,0,100,121040,1215,98
89170,2024,1,1,0,0,100,138050,1534,90
89171,2024,5,4,1,20,80,121160,1561,81
89172,2024,6,6,0,0,100,201458,1678,128
89173,2024,4,4,0,0,100,126750,1194,100
89175,2024,1,1,0,0,100,165000,1179,140
89177,2024,4,4,0,0,100,87875,890,98
89179,2024,5,5,0,0,100,113090,882,109
89180,2024,5,5,0,0,100,159112,1513,111
89181,2024,5,5,0,0,100,102600,1248,93
89182,2024,3,3,0,0,100,52000,594,88
89184,2024,1,1,0,0,100,30000,789,38
89186,2024,3,3,0,0,100,148000,1320,118
89187,2024,1,1,0,0,100,339000,1351,251
89188,2024,2,2,0,0,100,208930,1888,114
89189,2024,9,9,0,0,100,142078,1655,101
89190,2024,4,4,0,0,100,72500,1169,62
89194,2024,1,1,0,0,100,105000,955,110
89195,2024,6,6,0,0,100,213010,2332,92
89196,2024,15,15,0,0,100,167454,1592,108
89197,2024,8,8,0,0,100,109562,1071,98
89198,2024,12,12,0,0,100,171826,1571,112
89199,2024,1,1,0,0,100,142000,1614,88
89200,2024,3,3,0,0,100,156167,1987,77
89201,2024,11,11,0,0,100,177627,1504,112
89202,2024,12,12,0,0,100,102958,1158,90
89203,2024,4,4,0,0,100,137175,1696,80
89204,2024,10,10,0,0,100,91750,1297,74
89205,2024,4,4,0,0,100,106750,1160,104
89206,2024,79,62,17,22,78,102177,1431,76
89207,2024,1,1,0,0,100,40000,571,70
89208,2024,9,8,1,11,89,74267,964,76
89209,2024,3,3,0,0,100,185000,2060,101
89210,2024,4,4,0,0,100,85375,772,120
89211,2024,1,1,0,0,100,28000,431,65
89212,2024,6,6,0,0,100,150955,1264,129
89214,2024,2,2,0,0,100,102500,1148,88
89215,2024,3,3,0,0,100,169137,1163,140
89216,2024,6,6,0,0,100,124623,1560,91
89217,2024,1,1,0,0,100,91000,1110,82
89218,2024,18,17,1,6,94,135106,1384,99
89219,2024,5,5,0,0,100,90400,848,123
89220,2024,8,8,0,0,100,57325,1023,57
89221,2024,5,5,0,0,100,93900,1044,80
89222,2024,1,1,0,0,100,126000,900,140
89223,2024,7,7,0,0,100,74571,870,83
89224,2024,2,2,0,0,100,91000,1102,80
89227,2024,13,13,0,0,100,143949,1379,114
89228,2024,17,17,0,0,100,161935,1672,99
89229,2024,5,5,0,0,100,161765,1182,148
89230,2024,5,5,0,0,100,140700,1497,92
89232,2024,4,4,0,0,100,145250,1521,104
89233,2024,6,6,0,0,100,51500,912,75
89234,2024,1,1,0,0,100,62000,886,70
89235,2024,8,8,0,0,100,171112,1472,117
89236,2024,11,11,0,0,100,183530,2230,89
89237,2024,5,5,0,0,100,79220,930,96
89238,2024,6,6,0,0,100,132083,1144,122
89239,2024,11,11,0,0,100,117806,1649,73
89240,2024,8,8,0,0,100,150992,1641,92
89242,2024,10,8,2,20,80,124165,1341,86
89244,2024,1,1,0,0,100,38000,974,39
89245,2024,7,7,0,0,100,144514,1848,84
89246,2024,5,5,0,0,100,91360,1207,79
89247,2024,3,3,0,0,100,119857,1271,97
89248,2024,1,1,0,0,100,40000,494,81
89250,2024,4,4,0,0,100,136575,1126,124
89251,2024,7,7,0,0,100,102057,1015,106
89252,2024,2,2,0,0,100,68000,877,75
89253,2024,4,4,0,0,100,120625,1377,91
89254,2024,12,12,0,0,100,101081,1332,84
89255,2024,7,7,0,0,100,187929,1725,112
89256,2024,8,8,0,0,100,127168,1332,102
89257,2024,67,55,12,18,82,111895,1514,74
89259,2024,2,2,0,0,100,55500,736,78
89261,2024,2,2,0,0,100,151000,1262,128
89262,2024,3,3,0,0,100,48333,429,114
89263,2024,44,42,2,5,95,150924,1735,87
89264,2024,8,8,0,0,100,184081,1702,113
89265,2024,3,3,0,0,100,139167,948,139
89266,2024,1,1,0,0,100,80000,920,87
89267,2024,4,4,0,0,100,199125,1605,124
89268,2024,8,8,0,0,100,132812,1219,107
89270,2024,1,1,0,0,100,49000,671,73
89271,2024,1,1,0,0,100,139575,1004,139
89272,2024,2,2,0,0,100,174250,1400,125
89273,2024,6,6,0,0,100,56750,817,71
89274,2024,15,15,0,0,100,166400,1620,103
89276,2024,12,12,0,0,100,105507,1039,107
89277,2024,7,7,0,0,100,72071,698,100
89279,2024,8,7,1,12,88,192341,1933,91
89280,2024,5,5,0,0,100,100994,977,105
89281,2024,5,5,0,0,100,159400,1999,82
89282,2024,6,6,0,0,100,95750,1125,88
89283,2024,3,3,0,0,100,186333,1405,146
89284,2024,3,3,0,0,100,61000,1005,60
89285,2024,2,2,0,0,100,177500,1390,130
89286,2024,6,6,0,0,100,191858,1503,133
89287,2024,39,29,10,26,74,143679,1583,93
89288,2024,1,1,0,0,100,255000,2237,114
89289,2024,4,4,0,0,100,101425,1112,100
89291,2024,11,5,6,55,45,122188,999,113
89292,2024,2,2,0,0,100,86245,930,104
89295,2024,12,12,0,0,100,208576,1774,118
89296,2024,3,3,0,0,100,91433,813,95
89297,2024,1,1,0,0,100,70000,1400,50
89298,2024,8,8,0,0,100,135250,1244,107
89303,2024,6,6,0,0,100,71500,889,78
89304,2024,4,4,0,0,100,153125,1286,122
89306,2024,11,11,0,0,100,224972,2335,109
89307,2024,5,5,0,0,100,94088,973,102
89309,2024,34,28,6,18,82,136565,1754,78
89310,2024,1,1,0,0,100,131000,1310,100
89311,2024,13,13,0,0,100,135608,1255,114
89312,2024,5,5,0,0,100,78800,1143,66
89313,2024,4,4,0,0,100,83170,1568,55
89315,2024,5,5,0,0,100,185800,1954,95
89316,2024,3,3,0,0,100,75667,876,85
89318,2024,8,8,0,0,100,93987,1130,94
89319,2024,1,1,0,0,100,190000,1792,106
89321,2024,9,8,1,11,89,57753,726,82
89323,2024,3,3,0,0,100,273333,1940,139
89324,2024,18,18,0,0,100,93233,1260,76
89326,2024,9,9,0,0,100,179622,1535,119
89327,2024,2,2,0,0,100,62000,1084,56
89328,2024,5,5,0,0,100,140748,1314,108
89329,2024,1,1,0,0,100,43000,558,77
89331,2024,5,5,0,0,100,143040,1269,109
89332,2024,10,10,0,0,100,145326,1482,103
89333,2024,1,1,0,0,100,80000,702,114
89334,2024,17,17,0,0,100,144549,1306,114
89335,2024,5,5,0,0,100,98400,1230,89
89336,2024,1,1,0,0,100,75000,636,118
89337,2024,15,14,1,7,93,114787,1091,110
89338,2024,29,23,6,21,79,174803,1781,96
89339,2024,1,1,0,0,100,80580,1046,77
89341,2024,6,6,0,0,100,70917,823,85
89342,2024,2,2,0,0,100,110000,1536,72
89344,2024,24,24,0,0,100,91251,1304,78
89345,2024,44,35,9,20,80,81272,911,87
89346,2024,44,36,8,18,82,157364,1785,88
89347,2024,4,4,0,0,100,105500,1355,90
89348,2024,37,36,1,3,97,117270,1567,82
89349,2024,3,3,0,0,100,185707,1494,128
89350,2024,6,6,0,0,100,163167,1669,115
89351,2024,4,4,0,0,100,117000,1125,106
89352,2024,2,2,0,0,100,177750,1054,168
89353,2024,9,9,0,0,100,166889,1405,125
89354,2024,14,14,0,0,100,176976,2200,86
89355,2024,3,3,0,0,100,175000,1662,115
89359,2024,8,8,0,0,100,111125,1100,96
89360,2024,4,4,0,0,100,250600,2036,115
89361,2024,1,1,0,0,100,270000,1508,179
89362,2024,2,2,0,0,100,156138,1371,114
89363,2024,2,2,0,0,100,157500,1168,138
89364,2024,8,7,1,12,88,108038,1864,66
89365,2024,4,4,0,0,100,101125,1042,91
89367,2024,5,5,0,0,100,111600,1462,81
89368,2024,13,13,0,0,100,105423,1333,80
89369,2024,9,9,0,0,100,173111,1702,110
89370,2024,11,9,2,18,82,145682,1632,92
89371,2024,3,3,0,0,100,120333,1048,110
89373,2024,2,2,0,0,100,137500,1562,88
89375,2024,1,1,0,0,100,74000,1028,72
89376,2024,1,1,0,0,100,23000,411,56
89377,2024,1,1,0,0,100,204420,1043,196
89378,2024,6,6,0,0,100,180358,1608,114
89380,2024,7,5,2,29,71,429853,5012,87
89382,2024,18,17,1,6,94,140114,1338,106
89383,2024,1,1,0,0,100,487000,3607,135
89384,2024,5,5,0,0,100,105240,1302,86
89385,2024,1,1,0,0,100,54000,478,113
89386,2024,1,1,0,0,100,159000,1136,140
89387,2024,282,116,166,59,41,126939,1772,73
89388,2024,2,2,0,0,100,75000,1138,68
89390,2024,8,8,0,0,100,149625,1276,127
89391,2024,11,11,0,0,100,114451,1526,87
89392,2024,3,3,0,0,100,108667,1446,77
89393,2024,2,2,0,0,100,77000,571,124
89394,2024,1,1,0,0,100,95000,1338,71
89395,2024,7,7,0,0,100,131143,1225,108
89397,2024,13,13,0,0,100,122700,1597,86
89398,2024,4,4,0,0,100,91300,1057,112
89399,2024,15,15,0,0,100,176554,1795,104
89400,2024,6,6,0,0,100,81302,1034,80
89402,2024,2,2,0,0,100,90500,1296,70
89404,2024,4,4,0,0,100,207000,1917,110
89405,2024,3,3,0,0,100,170000,1196,118
89406,2024,1,1,0,0,100,55300,1106,50
89407,2024,17,17,0,0,100,89370,1124,82
89408,2024,9,9,0,0,100,101553,1133,87
89409,2024,1,1,0,0,100,90000,818,110
89411,2024,7,7,0,0,100,157294,1560,114
89412,2024,3,3,0,0,100,131333,1235,108
89414,2024,25,19,6,24,76,103433,1315,79
89416,2024,9,9,0,0,100,109479,1115,104
89418,2024,34,31,3,9,91,97862,1174,85
89419,2024,27,25,2,7,93,134272,1500,99
89420,2024,18,18,0,0,100,93026,1066,82
89423,2024,2,2,0,0,100,55000,640,86
89424,2024,3,3,0,0,100,74333,1183,63
89425,2024,5,5,0,0,100,90013,1064,87
89427,2024,7,7,0,0,100,125711,1532,89
89428,2024,10,9,1,10,90,149075,1323,113
89430,2024,7,7,0,0,100,151679,1536,105
89432,2024,3,3,0,0,100,86617,947,85
89434,2024,3,3,0,0,100,137000,1392,102
89436,2024,10,10,0,0,100,108280,1248,99
89437,2024,2,2,0,0,100,70000,770,90
89438,2024,12,12,0,0,100,155136,1762,91
89439,2024,9,9,0,0,100,135548,1329,105
89440,2024,6,6,0,0,100,125500,1444,86
89441,2024,23,23,0,0,100,101524,940,113
89442,2024,5,5,0,0,100,160240,1775,89
89443,2024,15,15,0,0,100,154691,1716,89
89446,2024,7,7,0,0,100,194240,2759,73
89447,2024,2,2,0,0,100,81000,944,82
89449,2024,34,34,0,0,100,196607,2052,101
89450,2024,10,10,0,0,100,153150,1370,121
89451,2024,3,3,0,0,100,121000,1345,88
89452,2024,5,5,0,0,100,131400,1460,86
89453,2024,12,12,0,0,100,183412,1720,106
89456,2024,5,5,0,0,100,141740,1538,92
89458,2024,2,2,0,0,100,145250,1845,80
89459,2024,5,5,0,0,100,182000,1285,144
89460,2024,33,29,4,12,88,139394,1618,88
89461,2024,14,12,2,14,86,95564,868,117
89462,2024,6,6,0,0,100,86862,1106,87
89463,2024,6,6,0,0,100,185150,1652,116
89464,2024,71,65,6,8,92,128823,1550,88
89465,2024,3,3,0,0,100,161333,1433,111
89466,2024,5,5,0,0,100,180000,1770,105
89467,2024,7,7,0,0,100,172500,1771,104
89468,2024,6,6,0,0,100,98833,1015,100
89469,2024,10,10,0,0,100,124554,1208,108
89470,2024,1,1,0,0,100,37000,407,91
89471,2024,3,3,0,0,100,164000,1508,119
89472,2024,9,8,1,11,89,138011,1451,91
89474,2024,5,5,0,0,100,101800,1139,88
89475,2024,1,1,0,0,100,29000,725,40
89477,2024,1,1,0,0,100,75000,833,90
89478,2024,10,9,1,10,90,104140,1575,70
89479,2024,5,5,0,0,100,141820,1328,107
89480,2024,21,21,0,0,100,165610,1905,89
89483,2024,8,8,0,0,100,150865,1425,106
89485,2024,3,3,0,0,100,87667,1254,67
89486,2024,1,1,0,0,100,188000,1709,110
90001,2024,10,10,0,0,100,160228,1662,96
90002,2024,3,3,0,0,100,256033,1982,129
90003,2024,12,11,1,8,92,171031,1727,103
90004,2024,4,3,1,25,75,305838,2388,137
90005,2024,4,4,0,0,100,143299,1082,122
90006,2024,4,4,0,0,100,139975,1256,115
90007,2024,1,1,0,0,100,183000,1220,150
90008,2024,33,22,11,33,67,158531,1578,99
90009,2024,37,27,10,27,73,155550,1592,96
90010,2024,521,73,448,86,14,100028,1373,72
90011,2024,3,3,0,0,100,265233,1595,171
90012,2024,10,8,2,20,80,193040,1748,119
90014,2024,2,2,0,0,100,231500,1832,126
90015,2024,6,5,1,17,83,121117,1536,81
90017,2024,14,11,3,21,79,181030,1728,106
90018,2024,2,2,0,0,100,211500,1506,140
90019,2024,1,1,0,0,100,131000,903,145
90021,2024,1,1,0,0,100,165000,1279,129
90022,2024,24,20,4,17,83,171176,1918,89
90023,2024,9,9,0,0,100,161926,1583,111
90025,2024,3,3,0,0,100,121667,1152,104
90026,2024,11,8,3,27,73,260705,2173,121
90028,2024,1,1,0,0,100,137000,1877,73
90029,2024,21,13,8,38,62,168361,1701,98
90030,2024,1,1,0,0,100,109000,991,110
90031,2024,6,6,0,0,100,251733,2011,126
90032,2024,37,19,18,49,51,158597,1641,92
90033,2024,51,21,30,59,41,129605,1587,81
90034,2024,5,5,0,0,100,595985,4925,125
90035,2024,7,7,0,0,100,214853,1649,130
90036,2024,2,2,0,0,100,188050,1577,119
90037,2024,12,11,1,8,92,254838,1946,138
90039,2024,28,16,12,43,57,178943,1826,100
90041,2024,14,13,1,7,93,178884,1662,111
90042,2024,14,9,5,36,64,209443,1858,118
90043,2024,2,2,0,0,100,169500,1908,97
90044,2024,2,2,0,0,100,156750,1876,88
90045,2024,1,1,0,0,100,115000,1420,81
90046,2024,3,3,0,0,100,195633,1851,100
90047,2024,7,7,0,0,100,219493,1911,121
90048,2024,1,1,0,0,100,65000,586,111
90049,2024,11,11,0,0,100,191905,1527,136
90050,2024,1,1,0,0,100,446790,2234,200
90051,2024,3,2,1,33,67,165290,1685,100
90052,2024,37,25,12,32,68,112031,1235,100
90053,2024,22,17,5,23,77,174591,1692,102
90054,2024,4,4,0,0,100,157785,1693,81
90055,2024,2,2,0,0,100,246500,1996,128
90056,2024,20,20,0,0,100,220882,2106,108
90057,2024,4,3,1,25,75,183125,1876,104
90058,2024,5,4,1,20,80,153630,1320,118
90059,2024,1,1,0,0,100,223700,1748,128
90060,2024,2,1,1,50,50,289000,2872,100
90062,2024,3,3,0,0,100,199450,1434,150
90065,2024,11,10,1,9,91,100823,1278,82
90067,2024,1,1,0,0,100,150000,1667,90
90068,2024,11,9,2,18,82,202618,1853,105
90069,2024,12,8,4,33,67,161130,1711,95
90070,2024,3,3,0,0,100,138200,1042,140
90071,2024,6,5,1,17,83,225767,2202,114
90072,2024,9,4,5,56,44,119769,1527,79
90075,2024,26,22,4,15,85,187348,1662,109
90076,2024,16,14,2,12,88,217029,1749,126
90077,2024,2,2,0,0,100,319600,2216,144
90078,2024,1,1,0,0,100,437000,2681,163
90079,2024,3,3,0,0,100,246000,1742,144
90080,2024,4,4,0,0,100,175650,2022,88
90081,2024,3,3,0,0,100,181667,1443,128
90083,2024,4,4,0,0,100,339775,2356,140
90084,2024,2,2,0,0,100,122250,1150,112
90086,2024,3,3,0,0,100,251167,1725,156
90087,2024,7,6,1,14,86,256241,2103,121
90088,2024,3,3,0,0,100,126233,1524,84
90089,2024,14,9,5,36,64,152131,1508,102
90090,2024,5,5,0,0,100,207470,1603,128
90091,2024,6,5,1,17,83,133240,1032,122
90093,2024,6,4,2,33,67,174458,1463,118
90094,2024,3,2,1,33,67,214833,2403,86
90095,2024,4,4,0,0,100,198450,1507,131
90096,2024,2,2,0,0,100,264050,1854,142
90097,2024,5,3,2,40,60,141947,1401,92
90099,2024,61,31,30,49,51,133267,1493,90
90100,2024,1,1,0,0,100,200000,2817,71
90101,2024,1,1,0,0,100,87000,926,94
90102,2024,5,5,0,0,100,238247,1787,134
90103,2024,4,4,0,0,100,237100,1933,116
90104,2024,8,8,0,0,100,236242,2184,106
90105,2024,2,2,0,0,100,165000,1782,93
91001,2024,2,2,0,0,100,234500,1242,172
91016,2024,49,44,5,10,90,200259,2205,93
91017,2024,8,8,0,0,100,456150,3238,133
91021,2024,129,32,97,75,25,187159,3247,58
91027,2024,254,103,151,59,41,229079,3579,66
91035,2024,1,1,0,0,100,318330,2920,109
91037,2024,3,2,1,33,67,342867,3214,123
91038,2024,4,3,1,25,75,282475,2867,95
91041,2024,5,4,1,20,80,304600,2717,108
91044,2024,47,29,18,38,62,308597,3357,92
91045,2024,75,58,17,23,77,248313,2951,87
91047,2024,22,17,5,23,77,214826,2852,81
91064,2024,36,15,21,58,42,378433,4738,78
91067,2024,2,2,0,0,100,208750,1725,122
91069,2024,5,5,0,0,100,170627,1967,90
91075,2024,1,1,0,0,100,80000,2424,33
91079,2024,8,8,0,0,100,230838,2483,98
91080,2024,17,13,4,24,76,246359,2908,88
91081,2024,3,3,0,0,100,247750,2969,94
91085,2024,47,37,10,21,79,272720,3246,90
91086,2024,106,56,50,47,53,231057,3049,79
91093,2024,3,3,0,0,100,333333,3628,99
91095,2024,17,13,4,24,76,239629,2917,83
91097,2024,66,26,40,61,39,215970,2769,78
91098,2024,4,4,0,0,100,269325,2258,128
91099,2024,28,24,4,14,86,233166,2863,84
91100,2024,3,3,0,0,100,278333,2712,108
91103,2024,212,83,129,61,39,215810,3306,69
91105,2024,65,58,7,11,89,281050,3086,98
91106,2024,17,16,1,6,94,312792,2891,115
91109,2024,8,8,0,0,100,288295,3128,109
91111,2024,35,30,5,14,86,307029,3394,99
91112,2024,3,3,0,0,100,203333,3687,70
91114,2024,235,113,122,52,48,280900,3586,80
91115,2024,32,22,10,31,69,247298,3062,83
91121,2024,5,5,0,0,100,289252,3538,92
91122,2024,60,37,23,38,62,338208,4382,82
91129,2024,41,40,1,2,98,255967,2698,103
91130,2024,10,9,1,10,90,249625,2347,104
91131,2024,4,4,0,0,100,409130,3128,175
91132,2024,16,12,4,25,75,215075,2539,86
91135,2024,28,28,0,0,100,256389,2789,92
91136,2024,16,12,4,25,75,274041,3780,74
91137,2024,4,4,0,0,100,200625,1880,118
91156,2024,20,16,4,20,80,257825,3150,85
91159,2024,22,13,9,41,59,272186,3741,79
91161,2024,206,29,177,86,14,185549,2848,68
91174,2024,521,117,404,78,22,151157,2610,60
91175,2024,15,10,5,33,67,220697,3539,74
91179,2024,44,24,20,45,55,249132,2993,85
91186,2024,1,1,0,0,100,267200,1979,135
91191,2024,109,43,66,61,39,244318,3596,70
91195,2024,12,10,2,17,83,356449,3153,120
91198,2024,18,16,2,11,89,257098,3199,84
91200,2024,103,60,43,42,58,232228,2910,82
91201,2024,249,155,94,38,62,276777,3509,81
91204,2024,2,2,0,0,100,352000,2660,132
91207,2024,46,37,9,20,80,268233,3131,88
91215,2024,63,17,46,73,27,153116,2149,71
91216,2024,93,58,35,38,62,287038,3646,80
91223,2024,273,95,178,65,35,158139,2454,68
91225,2024,29,21,8,28,72,425693,3853,114
91226,2024,88,61,27,31,69,234056,3072,78
91228,2024,459,84,375,82,18,162951,2437,70
91232,2024,35,23,12,34,66,212137,2744,78
91235,2024,41,9,32,78,22,178108,2860,64
91240,2024,1,0,1,100,0,155835,2195,71
91243,2024,20,18,2,10,90,311448,3172,100
91244,2024,11,7,4,36,64,231955,3085,79
91247,2024,2,2,0,0,100,322000,3178,95
91248,2024,3,2,1,33,67,153500,1696,92
91249,2024,46,38,8,17,83,343523,3042,119
91272,2024,187,90,97,52,48,374692,4050,96
91273,2024,10,10,0,0,100,197000,2098,97
91274,2024,9,8,1,11,89,381274,4088,98
91275,2024,14,11,3,21,79,333636,3967,92
91284,2024,10,10,0,0,100,273040,2717,101
91286,2024,158,18,140,89,11,88866,1439,59
91292,2024,8,8,0,0,100,340984,3409,101
91293,2024,10,7,3,30,70,269830,2400,118
91294,2024,8,8,0,0,100,281874,2654,108
91312,2024,85,58,27,32,68,422175,4538,96
91315,2024,57,55,2,4,96,277278,3344,90
91318,2024,21,20,1,5,95,322707,3397,100
91319,2024,9,8,1,11,89,330474,3623,98
91326,2024,214,44,170,79,21,227545,3860,62
91330,2024,48,33,15,31,69,251150,3051,87
91332,2024,13,11,2,15,85,335603,2936,117
91333,2024,52,39,13,25,75,260014,3126,88
91338,2024,62,49,13,21,79,346951,3399,106
91339,2024,72,42,30,42,58,261670,3287,82
91340,2024,61,46,15,25,75,248210,3127,84
91345,2024,195,54,141,72,28,212190,3027,71
91347,2024,55,43,12,22,78,295922,3337,91
91359,2024,35,32,3,9,91,211438,2534,88
91363,2024,68,51,17,25,75,291518,3320,92
91374,2024,4,4,0,0,100,254528,2550,106
91376,2024,46,28,18,39,61,258941,3356,82
91377,2024,490,62,428,87,13,259568,4021,67
91378,2024,4,4,0,0,100,314882,3089,102
91386,2024,173,103,70,40,60,267942,3113,90
91390,2024,38,35,3,8,92,194755,2292,89
91393,2024,4,4,0,0,100,245905,1920,128
91399,2024,2,2,0,0,100,151750,1658,92
91405,2024,40,33,7,18,82,314551,3468,95
91408,2024,8,7,1,12,88,309316,3442,94
91411,2024,15,14,1,7,93,311061,3436,95
91412,2024,6,5,1,17,83,252340,2999,86
91414,2024,4,4,0,0,100,163238,1544,108
91421,2024,192,117,75,39,61,284864,3867,77
91425,2024,80,45,35,44,56,277630,3426,84
91432,2024,119,78,41,34,66,269398,3637,78
91433,2024,36,26,10,28,72,251764,2841,93
91434,2024,187,114,73,39,61,246153,3408,76
91435,2024,5,5,0,0,100,398150,2812,173
91441,2024,4,4,0,0,100,316800,2912,110
91457,2024,37,32,5,14,86,281317,3176,91
91458,2024,37,20,17,46,54,277493,3341,85
91461,2024,48,41,7,15,85,284632,3102,93
91463,2024,13,10,3,23,77,286846,3075,97
91468,2024,24,19,5,21,79,250732,2940,89
91469,2024,3,3,0,0,100,293333,2187,136
91471,2024,147,77,70,48,52,338474,4365,81
91477,2024,300,88,212,71,29,292853,4136,73
91479,2024,67,54,13,19,81,308406,4046,80
91482,2024,6,2,4,67,33,188230,2454,81
91494,2024,34,28,6,18,82,282138,3244,88
91495,2024,5,5,0,0,100,194300,2064,97
91507,2024,3,3,0,0,100,321233,2974,108
91508,2024,2,2,0,0,100,257335,3204,93
91511,2024,33,20,13,39,61,148188,2078,71
91514,2024,79,48,31,39,61,258471,3383,81
91519,2024,1,1,0,0,100,442200,2457,180
91521,2024,238,59,179,75,25,169731,2511,68
91525,2024,8,6,2,25,75,201912,3318,68
91526,2024,1,1,0,0,100,290000,1801,161
91533,2024,20,16,4,20,80,180208,2262,81
91534,2024,27,18,9,33,67,402547,4687,91
91538,2024,4,3,1,25,75,347852,3160,110
91540,2024,41,30,11,27,73,257173,3019,88
91544,2024,6,4,2,33,67,240996,2104,131
91546,2024,14,13,1,7,93,400268,3131,131
91547,2024,11,11,0,0,100,193795,1634,114
91549,2024,308,177,131,43,57,261325,3451,78
91552,2024,82,56,26,32,68,263026,3180,83
91553,2024,81,62,19,23,77,302817,3338,93
91556,2024,3,2,1,33,67,392967,2935,127
91560,2024,2,2,0,0,100,372500,3862,100
91568,2024,9,7,2,22,78,289456,3206,92
91570,2024,148,63,85,57,43,217148,2773,79
91573,2024,98,46,52,53,47,233845,3348,72
91577,2024,67,57,10,15,85,319998,3167,105
91578,2024,3,3,0,0,100,463569,3025,151
91579,2024,30,24,6,20,80,239421,3160,77
91581,2024,7,7,0,0,100,293831,3242,90
91587,2024,65,39,26,40,60,282693,3416,89
91589,2024,383,217,166,43,57,245779,3506,72
91593,2024,21,19,2,10,90,284416,2977,103
91599,2024,18,17,1,6,94,271535,3273,87
91600,2024,56,38,18,32,68,323321,3451,98
91602,2024,5,5,0,0,100,212500,2839,76
91613,2024,3,3,0,0,100,263667,2004,131
91617,2024,30,20,10,33,67,287240,3408,86
91619,2024,1,1,0,0,100,370000,3458,107
91629,2024,9,9,0,0,100,312388,2705,119
91630,2024,16,16,0,0,100,331944,3007,112
91631,2024,12,12,0,0,100,358624,3642,107
91634,2024,13,10,3,23,77,273728,2923,100
91635,2024,20,17,3,15,85,410100,4796,91
91639,2024,8,8,0,0,100,230091,2996,82
91645,2024,128,67,61,48,52,441364,4690,94
91648,2024,20,14,6,30,70,243791,3248,80
91649,2024,24,17,7,29,71,213286,2552,86
91654,2024,9,9,0,0,100,346233,2763,129
91657,2024,212,119,93,44,56,217603,3325,68
91659,2024,38,26,12,32,68,246028,2974,84
91661,2024,94,47,47,50,50,295880,3615,84
91662,2024,5,5,0,0,100,813990,4729,132
91665,2024,57,48,9,16,84,315461,3575,91
91666,2024,27,22,5,19,81,345687,3799,94
91667,2024,52,37,15,29,71,304408,3673,85
91671,2024,4,4,0,0,100,304600,2050,153
91679,2024,6,6,0,0,100,534167,6569,86
91685,2024,50,33,17,34,66,276778,3480,81
91687,2024,254,86,168,66,34,209910,3242,66
91689,2024,75,30,45,60,40,295616,4102,77
91691,2024,293,136,157,54,46,283044,3657,79
91692,2024,153,16,137,90,10,179321,2524,73
92002,2024,544,169,375,69,31,405675,5316,77
92004,2024,1001,89,912,91,9,384222,6364,59
92007,2024,203,47,156,77,23,340702,5261,66
92009,2024,332,65,267,80,20,435122,6674,64
92012,2024,1323,22,1301,98,2,501138,8313,59
92014,2024,210,32,178,85,15,373036,5582,67
92019,2024,296,25,271,92,8,325758,4742,70
92020,2024,333,47,286,86,14,344832,5745,61
92022,2024,200,34,166,83,17,376401,5957,63
92023,2024,465,122,343,74,26,438973,6035,71
92024,2024,529,6,523,99,1,330345,6700,50
92025,2024,694,215,479,69,31,373374,5544,65
92026,2024,884,28,856,97,3,381427,6684,58
92032,2024,167,24,143,86,14,310987,4818,66
92033,2024,170,32,138,81,19,535730,6303,82
92035,2024,321,36,285,89,11,425750,6731,62
92036,2024,132,23,109,83,17,264663,4504,60
92040,2024,611,44,567,93,7,434333,7438,58
92044,2024,729,8,721,99,1,499760,8940,55
92046,2024,205,31,174,85,15,353827,6715,53
92047,2024,17,15,2,12,88,1393926,7189,174
92048,2024,359,47,312,87,13,473111,6060,76
92049,2024,540,22,518,96,4,390123,7100,55
92050,2024,376,86,290,77,23,334698,5412,62
92051,2024,779,11,768,99,1,838150,10339,79
92060,2024,288,32,256,89,11,372948,5556,68
92062,2024,441,14,427,97,3,402184,6936,58
92063,2024,812,192,620,76,24,468382,6043,74
92064,2024,327,50,277,85,15,599677,6911,83
92071,2024,202,35,167,83,17,523219,6294,80
92072,2024,195,33,162,83,17,464996,6156,75
92073,2024,452,61,391,87,13,461190,6920,66
92075,2024,313,23,290,93,7,363399,6310,58
92076,2024,97,24,73,75,25,602288,5727,102
92077,2024,73,13,60,82,18,506199,5701,89
92078,2024,96,14,82,85,15,202182,3411,62
93001,2024,363,30,333,92,8,191093,3983,49
93005,2024,499,271,228,46,54,249318,3638,73
93006,2024,193,39,154,80,20,327675,5593,59
93007,2024,243,150,93,38,62,292822,4305,73
93008,2024,157,60,97,62,38,222597,3497,68
93010,2024,288,115,173,60,40,200449,3236,64
93013,2024,104,20,84,81,19,235349,4245,58
93014,2024,121,42,79,65,35,170934,2452,72
93015,2024,46,31,15,33,67,250595,3014,90
93027,2024,111,33,78,70,30,196915,3235,63
93029,2024,433,223,210,48,52,220577,3848,61
93030,2024,25,8,17,68,32,192169,2736,70
93031,2024,289,66,223,77,23,188859,2982,65
93032,2024,336,186,150,45,55,255844,3548,74
93033,2024,62,40,22,35,65,329940,4319,83
93039,2024,35,3,32,91,9,273499,4214,63
93045,2024,165,17,148,90,10,351087,6613,54
93046,2024,446,166,280,63,37,208279,3217,67
93047,2024,190,145,45,24,76,276581,3765,79
93048,2024,883,159,724,82,18,333516,5871,58
93049,2024,202,79,123,61,39,278655,4162,69
93050,2024,198,55,143,72,28,229725,3418,69
93051,2024,564,154,410,73,27,280484,4333,68
93053,2024,235,68,167,71,29,236534,3791,64
93055,2024,462,22,440,95,5,294275,5849,50
93057,2024,213,83,130,61,39,223559,3695,62
93059,2024,43,18,25,58,42,188604,3363,59
93061,2024,124,10,114,92,8,324001,6194,51
93062,2024,169,62,107,63,37,353752,4345,81
93063,2024,210,54,156,74,26,330854,5382,62
93064,2024,378,65,313,83,17,231497,3897,62
93066,2024,564,55,509,90,10,200778,3982,52
93070,2024,472,28,444,94,6,336400,6254,54
93071,2024,259,140,119,46,54,209514,2927,73
93072,2024,149,66,83,56,44,193078,3201,63
93073,2024,269,178,91,34,66,248083,3363,77
93074,2024,96,49,47,49,51,245356,3561,72
93077,2024,256,109,147,57,43,275980,3918,72
93078,2024,265,133,132,50,50,215591,2990,74
93079,2024,26,13,13,50,50,220388,3311,67
94001,2024,48,19,29,60,40,230702,3762,63
94002,2024,339,45,294,87,13,271507,4934,56
94003,2024,137,37,100,73,27,341877,5604,61
94004,2024,127,28,99,78,22,223703,3338,71
94011,2024,66,27,39,59,41,276725,4075,70
94015,2024,179,53,126,70,30,399231,5088,78
94016,2024,233,44,189,81,19,283364,4908,59
94017,2024,507,208,299,59,41,275587,4096,70
94018,2024,297,7,290,98,2,439836,7338,60
94019,2024,178,53,125,70,30,269211,3742,73
94021,2024,115,12,103,90,10,243931,3762,66
94022,2024,367,67,300,82,18,212890,3647,61
94028,2024,496,49,447,90,10,252035,3871,67
94033,2024,431,117,314,73,27,402915,6008,68
94034,2024,219,22,197,90,10,227803,3493,67
94037,2024,93,11,82,88,12,328934,6088,56
94038,2024,238,77,161,68,32,320295,4471,72
94041,2024,395,19,376,95,5,237944,4992,49
94042,2024,210,47,163,78,22,384472,6037,63
94043,2024,139,5,134,96,4,293891,5673,54
94044,2024,206,67,139,67,33,233437,3494,69
94046,2024,501,80,421,84,16,340774,5608,61
94047,2024,36,28,8,22,78,334780,3667,96
94048,2024,43,32,11,26,74,363481,3653,107
94052,2024,413,49,364,88,12,420409,6107,67
94053,2024,35,22,13,37,63,347161,4404,87
94054,2024,109,47,62,57,43,245789,3801,67
94055,2024,104,99,5,5,95,389327,4240,99
94056,2024,40,33,7,18,82,303644,3346,95
94058,2024,400,122,278,70,30,429513,5828,72
94059,2024,187,48,139,74,26,279439,3956,71
94060,2024,99,80,19,19,81,295559,3366,91
94065,2024,48,15,33,69,31,352060,4147,85
94067,2024,259,5,254,98,2,555857,8599,62
94068,2024,963,320,643,67,33,453739,6048,73
94069,2024,116,4,112,97,3,370417,5673,62
94070,2024,30,19,11,37,63,464074,3982,112
94071,2024,202,112,90,45,55,335949,4089,84
94073,2024,269,53,216,80,20,263743,3862,71
94074,2024,34,16,18,53,47,241306,3613,70
94075,2024,88,56,32,36,64,309741,3737,87
94076,2024,353,78,275,78,22,301136,5090,61
94077,2024,171,99,72,42,58,249854,3844,68
94078,2024,153,49,104,68,32,159758,3103,54
94079,2024,271,83,188,69,31,266068,3979,68
94080,2024,674,26,648,96,4,485752,8671,55
94081,2024,480,129,351,73,27,262132,4393,61
95002,2024,17,13,4,24,76,312125,2983,107
95008,2024,11,9,2,18,82,213746,2425,91
95011,2024,10,10,0,0,100,224474,3298,70
95012,2024,3,3,0,0,100,145333,1588,98
95014,2024,19,14,5,26,74,508146,4173,125
95018,2024,788,334,454,58,42,226533,3552,66
95019,2024,84,54,30,36,64,227185,3672,73
95023,2024,4,4,0,0,100,263625,2696,99
95024,2024,2,2,0,0,100,257025,3328,77
95026,2024,25,22,3,12,88,275763,3200,91
95028,2024,18,15,3,17,83,332259,3567,96
95039,2024,71,52,19,27,73,282882,3594,83
95040,2024,11,11,0,0,100,317475,2628,134
95042,2024,22,19,3,14,86,298166,3676,83
95046,2024,2,2,0,0,100,172323,1478,108
95051,2024,79,51,28,35,65,306901,3927,83
95052,2024,112,46,66,59,41,191017,3114,65
95054,2024,6,6,0,0,100,286739,2977,92
95055,2024,6,6,0,0,100,264333,3345,80
95056,2024,16,15,1,6,94,276945,3180,90
95058,2024,36,27,9,25,75,258176,3452,82
95059,2024,2,2,0,0,100,303925,2192,138
95060,2024,86,46,40,47,53,286717,3662,84
95061,2024,3,3,0,0,100,412067,3449,123
95063,2024,241,85,156,65,35,296262,4319,68
95074,2024,7,6,1,14,86,421236,3928,120
95078,2024,18,16,2,11,89,318841,3004,108
95088,2024,7,1,6,86,14,254806,4174,63
95091,2024,49,41,8,16,84,306596,3400,91
95094,2024,3,2,1,33,67,278333,3441,80
95101,2024,11,11,0,0,100,220155,2489,89
95102,2024,6,6,0,0,100,345417,3764,93
95110,2024,2,2,0,0,100,271750,3642,86
95116,2024,31,27,4,13,87,255350,2759,96
95119,2024,1,1,0,0,100,278000,2550,109
95120,2024,21,21,0,0,100,330969,3145,110
95127,2024,527,113,414,79,21,200224,3269,66
95134,2024,46,44,2,4,96,314687,3222,102
95139,2024,1,1,0,0,100,150000,2500,60
95142,2024,22,18,4,18,82,209542,2818,81
95149,2024,44,34,10,23,77,314566,3787,90
95150,2024,5,5,0,0,100,253450,2718,91
95151,2024,3,3,0,0,100,256102,2843,106
95154,2024,3,3,0,0,100,309333,2744,119
95157,2024,2,2,0,0,100,258015,1926,144
95166,2024,4,4,0,0,100,264914,2302,124
95169,2024,5,5,0,0,100,303964,2072,144
95170,2024,5,3,2,40,60,219980,2797,75
95176,2024,261,152,109,42,58,343131,4378,80
95177,2024,13,13,0,0,100,308715,3664,84
95183,2024,58,28,30,52,48,247876,3488,73
95197,2024,214,77,137,64,36,299595,3932,76
95199,2024,146,67,79,54,46,246538,3171,80
95203,2024,217,100,117,54,46,311012,4074,78
95205,2024,48,23,25,52,48,252282,3400,75
95210,2024,143,26,117,82,18,365454,5193,72
95211,2024,20,18,2,10,90,348019,3766,103
95213,2024,5,5,0,0,100,583100,3166,217
95214,2024,1,1,0,0,100,160000,1928,83
95218,2024,135,60,75,56,44,251621,3204,82
95219,2024,221,75,146,66,34,291101,4003,74
95229,2024,91,40,51,56,44,241702,3222,77
95241,2024,10,8,2,20,80,229640,3172,74
95250,2024,71,67,4,6,94,259442,3265,83
95252,2024,389,91,298,77,23,223491,3297,69
95253,2024,7,7,0,0,100,392450,3551,107
95254,2024,3,3,0,0,100,328850,2083,160
95256,2024,27,22,5,19,81,316363,3304,100
95257,2024,54,40,14,26,74,343723,4248,85
95258,2024,2,2,0,0,100,619250,2768,186
95268,2024,165,42,123,75,25,169413,2598,67
95270,2024,7,4,3,43,57,246613,2318,110
95271,2024,2,2,0,0,100,257000,3450,74
95277,2024,143,58,85,59,41,220528,3142,73
95280,2024,161,125,36,22,78,223237,3483,69
95287,2024,4,3,1,25,75,202475,3511,57
95288,2024,70,37,33,47,53,285159,3458,85
95295,2024,1,1,0,0,100,315000,4038,78
95298,2024,7,7,0,0,100,290092,2861,104
95301,2024,4,4,0,0,100,236055,2320,102
95303,2024,2,1,1,50,50,194000,2717,72
95304,2024,2,2,0,0,100,434425,3004,148
95306,2024,247,137,110,45,55,291018,3831,78
95308,2024,5,2,3,60,40,233800,5300,37
95309,2024,1,1,0,0,100,333000,2664,125
95313,2024,169,77,92,54,46,349584,4345,82
95316,2024,5,5,0,0,100,339240,3266,107
95323,2024,142,113,29,20,80,273281,3084,91
95328,2024,10,6,4,40,60,307376,3496,92
95331,2024,1,1,0,0,100,302919,2681,113
95341,2024,3,2,1,33,67,270333,2633,100
95348,2024,11,11,0,0,100,277032,3218,94
95351,2024,84,46,38,45,55,232878,3416,71
95352,2024,58,42,16,28,72,352211,3784,94
95353,2024,17,9,8,47,53,223165,3793,61
95355,2024,41,30,11,27,73,211856,3127,73
95365,2024,2,2,0,0,100,287500,5682,74
95369,2024,21,11,10,48,52,322252,3829,85
95370,2024,32,31,1,3,97,315556,3489,97
95371,2024,56,46,10,18,82,254545,3236,83
95379,2024,5,5,0,0,100,279578,2048,140
95388,2024,66,48,18,27,73,251205,2926,87
95392,2024,66,50,16,24,76,277543,3754,79
95394,2024,91,60,31,34,66,306961,3444,91
95395,2024,8,7,1,12,88,250875,2857,85
95409,2024,13,6,7,54,46,222336,3291,70
95422,2024,4,4,0,0,100,258975,2819,95
95424,2024,127,66,61,48,52,249748,3359,78
95426,2024,24,14,10,42,58,351598,3748,92
95427,2024,98,42,56,57,43,232645,3248,76
95428,2024,234,73,161,69,31,338495,4159,82
95429,2024,2,2,0,0,100,185000,3057,68
95430,2024,49,32,17,35,65,264359,3112,87
95436,2024,5,2,3,60,40,223273,2627,81
95445,2024,9,6,3,33,67,324578,3173,102
95446,2024,18,18,0,0,100,411076,4199,104
95447,2024,3,3,0,0,100,195400,1988,106
95450,2024,12,10,2,17,83,395418,4030,100
95452,2024,10,7,3,30,70,255420,3279,80
95456,2024,4,2,2,50,50,168656,3126,67
95459,2024,8,8,0,0,100,343378,2968,120
95462,2024,5,5,0,0,100,208560,2337,85
95476,2024,122,88,34,28,72,293999,3453,89
95480,2024,36,32,4,11,89,286587,3351,88
95483,2024,5,5,0,0,100,301180,3834,87
95487,2024,94,33,61,65,35,174661,2899,62
95488,2024,55,35,20,36,64,273738,3843,76
95489,2024,7,7,0,0,100,571770,4442,137
95491,2024,100,44,56,56,44,272759,3776,75
95500,2024,280,79,201,72,28,218918,3258,71
95504,2024,65,51,14,22,78,290380,3718,83
95509,2024,35,30,5,14,86,259054,3477,80
95510,2024,3,3,0,0,100,304283,3224,95
95523,2024,5,4,1,20,80,182568,2884,67
95527,2024,16,5,11,69,31,271692,4331,64
95529,2024,6,6,0,0,100,268367,2526,115
95535,2024,8,8,0,0,100,287712,3197,114
95539,2024,111,48,63,57,43,265586,3574,74
95541,2024,8,7,1,12,88,190200,2076,89
95543,2024,3,3,0,0,100,368667,2835,125
95554,2024,12,12,0,0,100,312797,2894,110
95555,2024,154,47,107,69,31,287117,3882,73
95563,2024,151,79,72,48,52,301513,3998,79
95566,2024,32,32,0,0,100,252329,2925,89
95572,2024,193,79,114,59,41,219103,3191,70
95574,2024,56,41,15,27,73,366264,3995,97
95580,2024,15,14,1,7,93,425183,3538,121
95582,2024,187,67,120,64,36,251414,3695,70
95584,2024,10,9,1,10,90,285347,3322,96
95585,2024,251,51,200,80,20,173926,2383,74
95592,2024,10,9,1,10,90,263259,3714,76
95594,2024,13,10,3,23,77,312834,3719,95
95598,2024,158,81,77,49,51,333112,3936,84
95604,2024,42,20,22,52,48,216659,2594,82
95607,2024,245,117,128,52,48,263061,3322,80
95610,2024,5,5,0,0,100,328140,3444,99
95612,2024,36,27,9,25,75,237581,3466,76
95625,2024,20,19,1,5,95,265859,3176,85
95627,2024,10,9,1,10,90,361967,3561,109
95628,2024,18,14,4,22,78,345118,3757,99
95637,2024,124,71,53,43,57,269539,3535,79
95641,2024,30,16,14,47,53,299249,3488,83
95651,2024,5,5,0,0,100,269800,3402,81
95652,2024,46,37,9,20,80,282023,3115,94
95656,2024,3,3,0,0,100,224000,2908,79
95658,2024,8,8,0,0,100,266281,3156,94
95660,2024,5,5,0,0,100,263200,3572,82
95675,2024,20,11,9,45,55,294992,3427,93
95676,2024,8,8,0,0,100,229316,2874,83
95678,2024,10,8,2,20,80,262480,3336,79
95680,2024,132,38,94,71,29,170920,2535,69
95682,2024,1,1,0,0,100,313750,2905,108
95690,2024,5,5,0,0,100,313520,2529,124
NA,2024,7922,NA,NA,NA,NA,225314,3171,73
